"GameID","Date","Competition","HomeTeam","AwayTeam","FTHG","FTAG","FTR","HS","AS","HST","AST","HF","AF","HC","AC","HY","AY","HR","AR","ModerateMistakes","Corner_Mistakes","Yellow_Mistakes","Total_Goals","Total_Shots","Total_Shots_On_Target","Total_Fouls","Total_Corners","Total_Yellow_Cards","Total_Red_Cards"
"20220101ARSMAN",2022-01-01,"England Premier League","Arsenal","Man City",1,2,"A",7,15,2,2,13,5,5,5,3,2,1,0,0,0,0,3,22,4,18,10,5,1
"20220101WATTOT",2022-01-01,"England Premier League","Watford","Tottenham",0,1,"A",6,21,4,9,6,9,3,7,0,1,0,0,0,0,0,1,27,13,15,10,1,0
"20220101CRYWES",2022-01-01,"England Premier League","Crystal Palace","West Ham",2,3,"A",22,10,6,5,6,16,9,1,0,2,0,0,0,0,0,5,32,11,22,10,2,0
"20220102BREAST",2022-01-02,"England Premier League","Brentford","Aston Villa",2,1,"H",10,16,4,5,17,11,3,7,2,2,0,0,0,0,0,3,26,9,28,10,4,0
"20220102EVEBRI",2022-01-02,"England Premier League","Everton","Brighton",2,3,"A",17,12,6,5,5,12,8,5,1,1,0,0,0,0,0,5,29,11,17,13,2,0
"20220102LEEBUR",2022-01-02,"England Premier League","Leeds","Burnley",3,1,"H",22,8,7,2,11,7,9,3,2,1,0,0,0,0,0,4,30,9,18,12,3,0
"20220102CHELIV",2022-01-02,"England Premier League","Chelsea","Liverpool",2,2,"D",15,10,6,6,5,13,6,7,1,2,0,0,0,0,0,4,25,12,18,13,3,0
"20220103MANWOL",2022-01-03,"England Premier League","Man United","Wolves",0,1,"A",9,19,2,6,9,8,3,8,3,1,0,0,0,0,0,1,28,8,17,11,4,0
"20220111SOUBRE",2022-01-11,"England Premier League","Southampton","Brentford",4,1,"H",12,5,6,4,9,8,5,2,0,1,0,0,0,0,0,5,17,10,17,7,1,0
"20220112WESNOR",2022-01-12,"England Premier League","West Ham","Norwich",2,0,"H",13,7,5,3,9,8,11,2,0,0,0,0,0,0,0,2,20,8,17,13,0,0
"20220114BRICRY",2022-01-14,"England Premier League","Brighton","Crystal Palace",1,1,"D",19,3,4,1,11,7,9,0,0,2,0,0,0,0,0,2,22,5,18,9,2,0
"20220115MANCHE",2022-01-15,"England Premier League","Man City","Chelsea",1,0,"H",11,4,6,1,11,6,9,1,0,2,0,0,0,0,0,1,15,7,17,10,2,0
"20220115NEWWAT",2022-01-15,"England Premier League","Newcastle","Watford",1,1,"D",12,18,1,5,13,13,4,6,3,2,0,0,0,0,0,2,30,6,26,10,5,0
"20220115NOREVE",2022-01-15,"England Premier League","Norwich","Everton",2,1,"H",14,12,3,5,12,14,8,8,3,1,0,0,0,0,0,3,26,8,26,16,4,0
"20220115WOLSOU",2022-01-15,"England Premier League","Wolves","Southampton",3,1,"H",9,13,5,10,13,14,2,10,2,3,0,0,0,0,0,4,22,15,27,12,5,0
"20220115ASTMAN",2022-01-15,"England Premier League","Aston Villa","Man United",2,2,"D",13,13,9,6,8,13,3,6,1,2,0,0,0,0,0,4,26,15,21,9,3,0
"20220116LIVBRE",2022-01-16,"England Premier League","Liverpool","Brentford",3,0,"H",27,6,13,1,6,6,9,0,0,1,0,0,0,0,0,3,33,14,12,9,1,0
"20220116WESLEE",2022-01-16,"England Premier League","West Ham","Leeds",2,3,"A",15,18,5,5,6,9,4,3,3,2,0,0,0,0,0,5,33,10,15,7,5,0
"20220118BRICHE",2022-01-18,"England Premier League","Brighton","Chelsea",1,1,"D",10,15,2,3,8,5,5,7,1,2,0,0,0,0,0,2,25,5,13,12,3,0
"20220119LEITOT",2022-01-19,"England Premier League","Leicester","Tottenham",2,3,"A",14,27,4,10,6,12,3,8,1,2,0,0,0,0,0,5,41,14,18,11,3,0
"20220119BREMAN",2022-01-19,"England Premier League","Brentford","Man United",1,3,"A",18,13,8,5,7,9,6,9,0,0,0,0,0,0,0,4,31,13,16,15,0,0
"20220121WATNOR",2022-01-21,"England Premier League","Watford","Norwich",0,3,"A",15,7,4,2,16,11,5,1,0,1,1,0,0,0,0,3,22,6,27,6,1,1
"20220122EVEAST",2022-01-22,"England Premier League","Everton","Aston Villa",0,1,"A",15,8,1,3,14,16,9,2,5,3,0,0,0,0,0,1,23,4,30,11,8,0
"20220122BREWOL",2022-01-22,"England Premier League","Brentford","Wolves",1,2,"A",11,7,1,2,6,7,6,3,2,3,0,0,0,0,0,3,18,3,13,9,5,0
"20220122LEENEW",2022-01-22,"England Premier League","Leeds","Newcastle",0,1,"A",13,15,4,3,9,9,6,7,4,2,0,0,0,0,0,1,28,7,18,13,6,0
"20220122MANWES",2022-01-22,"England Premier League","Man United","West Ham",1,0,"H",18,6,3,1,9,8,3,3,1,1,0,0,0,0,0,1,24,4,17,6,2,0
"20220122SOUMAN",2022-01-22,"England Premier League","Southampton","Man City",1,1,"D",7,20,3,5,13,5,2,11,3,0,0,0,0,0,0,2,27,8,18,13,3,0
"20220123ARSBUR",2022-01-23,"England Premier League","Arsenal","Burnley",0,0,"D",20,10,5,1,9,13,12,4,0,2,0,0,0,0,0,0,30,6,22,16,2,0
"20220123CRYLIV",2022-01-23,"England Premier League","Crystal Palace","Liverpool",1,3,"A",8,15,5,7,12,10,2,5,4,1,0,0,0,0,0,4,23,12,22,7,5,0
"20220123LEIBRI",2022-01-23,"England Premier League","Leicester","Brighton",1,1,"D",15,14,5,5,6,8,4,5,0,1,0,0,0,0,0,2,29,10,14,9,1,0
"20220123CHETOT",2022-01-23,"England Premier League","Chelsea","Tottenham",2,0,"H",15,6,7,3,17,14,10,3,2,1,0,0,0,0,0,2,21,10,31,13,3,0
"20220205BURWAT",2022-02-05,"England Premier League","Burnley","Watford",0,0,"D",13,11,2,5,16,9,4,7,1,2,0,0,0,0,0,0,24,7,25,11,3,0
"20220208NEWEVE",2022-02-08,"England Premier League","Newcastle","Everton",3,1,"H",20,11,9,3,13,13,6,2,2,3,0,0,0,0,0,4,31,12,26,8,5,0
"20220208WESWAT",2022-02-08,"England Premier League","West Ham","Watford",1,0,"H",9,6,3,1,1,6,5,6,1,0,0,0,0,0,0,1,15,4,7,11,1,0
"20220208BURMAN",2022-02-08,"England Premier League","Burnley","Man United",1,1,"D",9,22,3,5,11,10,2,10,2,1,0,0,0,0,0,2,31,8,21,12,3,0
"20220209MANBRE",2022-02-09,"England Premier League","Man City","Brentford",2,0,"H",15,6,7,2,7,13,9,3,0,0,0,0,0,0,0,2,21,9,20,12,0,0
"20220209NORCRY",2022-02-09,"England Premier League","Norwich","Crystal Palace",1,1,"D",5,13,1,5,11,15,4,6,1,2,0,0,0,0,0,2,18,6,26,10,3,0
"20220209TOTSOU",2022-02-09,"England Premier League","Tottenham","Southampton",2,3,"A",8,23,3,10,7,13,2,8,2,3,0,0,0,0,0,5,31,13,20,10,5,0
"20220209ASTLEE",2022-02-09,"England Premier League","Aston Villa","Leeds",3,3,"D",12,16,4,8,11,9,6,11,1,3,1,0,0,0,0,6,28,12,20,17,4,1
"20220210LIVLEI",2022-02-10,"England Premier League","Liverpool","Leicester",2,0,"H",22,5,11,1,11,7,7,6,1,0,0,0,0,0,0,2,27,12,18,13,1,0
"20220210WOLARS",2022-02-10,"England Premier League","Wolves","Arsenal",0,1,"A",15,12,4,2,12,13,7,4,2,3,0,1,0,0,0,1,27,6,25,11,5,1
"20220212MANSOU",2022-02-12,"England Premier League","Man United","Southampton",1,1,"D",12,13,8,4,12,13,1,4,4,0,0,0,0,0,0,2,25,12,25,5,4,0
"20220212BRECRY",2022-02-12,"England Premier League","Brentford","Crystal Palace",0,0,"D",9,6,2,3,10,10,3,9,1,0,0,0,0,0,0,0,15,5,20,12,1,0
"20220212EVELEE",2022-02-12,"England Premier League","Everton","Leeds",3,0,"H",21,7,10,0,8,9,5,3,1,1,0,0,0,0,0,3,28,10,17,8,2,0
"20220212WATBRI",2022-02-12,"England Premier League","Watford","Brighton",0,2,"A",9,11,1,6,16,9,4,5,3,2,0,0,0,0,0,2,20,7,25,9,5,0
"20220212NORMAN",2022-02-12,"England Premier League","Norwich","Man City",0,4,"A",8,22,3,9,7,8,4,12,0,2,0,0,0,0,0,4,30,12,15,16,2,0
"20220213BURLIV",2022-02-13,"England Premier League","Burnley","Liverpool",0,1,"A",8,12,5,4,7,6,5,8,0,1,0,0,0,0,0,1,20,9,13,13,1,0
"20220213NEWAST",2022-02-13,"England Premier League","Newcastle","Aston Villa",1,0,"H",10,11,2,1,22,15,3,6,3,4,0,0,0,0,0,1,21,3,37,9,7,0
"20220213TOTWOL",2022-02-13,"England Premier League","Tottenham","Wolves",0,2,"A",17,11,7,7,13,13,7,3,3,1,0,0,0,0,0,2,28,14,26,10,4,0
"20220213LEIWES",2022-02-13,"England Premier League","Leicester","West Ham",2,2,"D",13,8,2,3,10,9,5,4,1,2,0,0,0,0,0,4,21,5,19,9,3,0
"20220215MANBRI",2022-02-15,"England Premier League","Man United","Brighton",2,0,"H",19,10,7,3,8,10,10,2,3,1,0,1,0,0,0,2,29,10,18,12,4,1
"20220219WESNEW",2022-02-19,"England Premier League","West Ham","Newcastle",1,1,"D",11,14,3,3,3,7,3,7,3,3,0,0,0,0,0,2,25,6,10,10,6,0
"20220219ARSBRE",2022-02-19,"England Premier League","Arsenal","Brentford",2,1,"H",24,6,8,2,10,5,14,0,1,1,0,0,0,0,0,3,30,10,15,14,2,0
"20220219ASTWAT",2022-02-19,"England Premier League","Aston Villa","Watford",0,1,"A",20,8,1,4,12,7,10,5,1,2,0,0,0,0,0,1,28,5,19,15,3,0
"20220219BRIBUR",2022-02-19,"England Premier League","Brighton","Burnley",0,3,"A",11,10,1,4,12,12,4,4,1,4,0,0,0,0,0,3,21,5,24,8,5,0
"20220219CRYCHE",2022-02-19,"England Premier League","Crystal Palace","Chelsea",0,1,"A",7,9,0,3,4,20,4,4,1,3,0,0,0,0,0,1,16,3,24,8,4,0
"20220219LIVNOR",2022-02-19,"England Premier League","Liverpool","Norwich",3,1,"H",29,6,8,1,7,8,9,4,0,1,0,0,0,0,0,4,35,9,15,13,1,0
"20220219SOUEVE",2022-02-19,"England Premier League","Southampton","Everton",2,0,"H",19,9,11,0,6,9,4,4,0,2,0,0,0,0,0,2,28,11,15,8,2,0
"20220219MANTOT",2022-02-19,"England Premier League","Man City","Tottenham",2,3,"A",21,6,4,5,5,7,10,0,0,3,0,0,0,0,0,5,27,9,12,10,3,0
"20220220LEEMAN",2022-02-20,"England Premier League","Leeds","Man United",2,4,"A",16,15,6,9,13,19,3,3,6,3,0,0,0,0,0,6,31,15,32,6,9,0
"20220220WOLLEI",2022-02-20,"England Premier League","Wolves","Leicester",2,1,"H",11,17,3,7,12,9,7,10,4,4,0,0,0,0,0,3,28,10,21,17,8,0
"20220223BURTOT",2022-02-23,"England Premier League","Burnley","Tottenham",1,0,"H",15,12,4,2,8,8,3,7,0,0,0,0,0,0,0,1,27,6,16,10,0,0
"20220223WATCRY",2022-02-23,"England Premier League","Watford","Crystal Palace",1,4,"A",8,7,1,5,12,9,6,4,2,1,0,0,0,0,0,5,15,6,21,10,3,0
"20220223LIVLEE",2022-02-23,"England Premier League","Liverpool","Leeds",6,0,"H",23,3,15,2,5,11,4,0,0,3,0,0,0,0,0,6,26,17,16,4,3,0
"20220224ARSWOL",2022-02-24,"England Premier League","Arsenal","Wolves",2,1,"H",26,6,5,2,8,9,5,4,1,1,0,0,0,0,0,3,32,7,17,9,2,0
"20220225SOUNOR",2022-02-25,"England Premier League","Southampton","Norwich",2,0,"H",27,8,9,1,12,9,13,6,1,2,0,0,0,0,0,2,35,10,21,19,3,0
"20220226LEETOT",2022-02-26,"England Premier League","Leeds","Tottenham",0,4,"A",19,15,3,11,16,11,3,6,4,2,0,0,0,0,0,4,34,14,27,9,6,0
"20220226BRENEW",2022-02-26,"England Premier League","Brentford","Newcastle",0,2,"A",6,26,1,11,9,7,6,6,3,1,1,0,0,0,0,2,32,12,16,12,4,1
"20220226CRYBUR",2022-02-26,"England Premier League","Crystal Palace","Burnley",1,1,"D",11,5,4,1,5,17,5,4,0,2,0,0,0,0,0,2,16,5,22,9,2,0
"20220226MANWAT",2022-02-26,"England Premier League","Man United","Watford",0,0,"D",22,10,3,2,2,7,4,3,0,0,0,0,0,0,0,0,32,5,9,7,0,0
"20220226BRIAST",2022-02-26,"England Premier League","Brighton","Aston Villa",0,2,"A",12,9,1,4,17,11,7,2,4,5,0,0,0,0,0,2,21,5,28,9,9,0
"20220226EVEMAN",2022-02-26,"England Premier League","Everton","Man City",0,1,"A",6,13,2,8,7,14,3,4,3,2,0,0,0,0,0,1,19,10,21,7,5,0
"20220227WESWOL",2022-02-27,"England Premier League","West Ham","Wolves",1,0,"H",13,14,4,1,8,2,3,5,1,0,0,0,0,0,0,1,27,5,10,8,1,0
"20220301BURLEI",2022-03-01,"England Premier League","Burnley","Leicester",0,2,"A",9,22,2,6,10,13,6,8,1,1,0,0,0,0,0,2,31,8,23,14,2,0
"20220305LEILEE",2022-03-05,"England Premier League","Leicester","Leeds",1,0,"H",7,19,4,4,9,12,5,10,1,2,0,0,0,0,0,1,26,8,21,15,3,0
"20220305ASTSOU",2022-03-05,"England Premier League","Aston Villa","Southampton",4,0,"H",14,11,9,1,10,8,4,7,1,1,0,0,0,0,0,4,25,10,18,11,2,0
"20220305BURCHE",2022-03-05,"England Premier League","Burnley","Chelsea",0,4,"A",6,11,1,5,12,7,5,2,2,0,0,0,0,0,0,4,17,6,19,7,2,0
"20220305NEWCBRI",2022-03-05,"England Premier League","Newcastle","Brighton",2,1,"H",10,15,4,4,8,10,4,7,1,1,0,0,0,0,0,3,25,8,18,11,2,0
"20220305NORBRE",2022-03-05,"England Premier League","Norwich","Brentford",1,3,"A",15,10,7,6,13,18,5,5,2,5,0,0,0,0,0,4,25,13,31,10,7,0
"20220305WOLCRY",2022-03-05,"England Premier League","Wolves","Crystal Palace",0,2,"A",12,12,5,8,13,8,7,7,0,3,0,0,0,0,0,2,24,13,21,14,3,0
"20220305LIVWES",2022-03-05,"England Premier League","Liverpool","West Ham",1,0,"H",22,13,5,5,7,7,4,6,2,1,0,0,0,0,0,1,35,10,14,10,3,0
"20220306WATARS",2022-03-06,"England Premier League","Watford","Arsenal",2,3,"A",13,16,7,4,5,11,1,5,1,2,0,0,0,0,0,5,29,11,16,6,3,0
"20220306MANMAN",2022-03-06,"England Premier League","Man City","Man United",4,1,"H",24,5,10,2,10,14,9,3,0,1,0,0,0,0,0,5,29,12,24,12,1,0
"20220307TOTEVE",2022-03-07,"England Premier League","Tottenham","Everton",5,0,"H",14,6,7,0,15,10,5,2,2,0,0,0,0,0,0,5,20,7,25,7,2,0
"20220310NORCHE",2022-03-10,"England Premier League","Norwich","Chelsea",1,3,"A",9,15,3,7,8,15,3,8,0,2,0,0,0,0,0,4,24,10,23,11,2,0
"20220310SOUNEW",2022-03-10,"England Premier League","Southampton","Newcastle",1,2,"A",14,8,5,4,6,7,12,5,1,1,0,0,0,0,0,3,22,9,13,17,2,0
"20220310WOLWAT",2022-03-10,"England Premier League","Wolves","Watford",4,0,"H",10,9,5,0,11,10,5,2,2,2,0,0,0,0,0,4,19,5,21,7,4,0
"20220310LEEAST",2022-03-10,"England Premier League","Leeds","Aston Villa",0,3,"A",4,15,1,9,17,11,3,5,5,3,0,0,0,0,0,3,19,10,28,8,8,0
"20220312BRILIV",2022-03-12,"England Premier League","Brighton","Liverpool",0,2,"A",8,18,3,9,12,15,7,6,3,1,0,0,0,0,0,2,26,12,27,13,4,0
"20220312BREBUR",2022-03-12,"England Premier League","Brentford","Burnley",2,0,"H",13,7,4,1,6,10,2,9,1,1,0,1,0,0,0,2,20,5,16,11,2,1
"20220312MANTOT",2022-03-12,"England Premier League","Man United","Tottenham",3,2,"H",10,10,6,3,8,7,4,5,2,1,0,0,0,0,0,5,20,9,15,9,3,0
"20220313CHENEW",2022-03-13,"England Premier League","Chelsea","Newcastle",1,0,"H",8,7,3,2,17,16,7,2,4,3,0,0,0,0,0,1,15,5,33,9,7,0
"20220313EVEWOL",2022-03-13,"England Premier League","Everton","Wolves",0,1,"A",8,14,2,3,13,11,5,2,2,1,1,0,0,0,0,1,22,5,24,7,3,1
"20220313LEENOR",2022-03-13,"England Premier League","Leeds","Norwich",2,1,"H",13,12,7,4,18,8,6,2,3,1,0,0,0,0,0,3,25,11,26,8,4,0
"20220313SOUWAT",2022-03-13,"England Premier League","Southampton","Watford",1,2,"A",13,9,7,5,8,12,11,3,3,2,0,0,0,0,0,3,22,12,20,14,5,0
"20220313WESAST",2022-03-13,"England Premier League","West Ham","Aston Villa",2,1,"H",11,13,4,7,9,3,5,7,1,0,0,0,0,0,0,3,24,11,12,12,1,0
"20220313ARSLEI",2022-03-13,"England Premier League","Arsenal","Leicester",2,0,"H",21,6,8,3,8,10,2,6,0,3,0,0,0,0,0,2,27,11,18,8,3,0
"20220314CRYMAN",2022-03-14,"England Premier League","Crystal Palace","Man City",0,0,"D",7,18,1,4,6,11,2,6,3,1,0,0,0,0,0,0,25,5,17,8,4,0
"20220316BRITOT",2022-03-16,"England Premier League","Brighton","Tottenham",0,2,"A",15,17,0,7,11,9,6,3,2,2,0,0,0,0,0,2,32,7,20,9,4,0
"20220316ARSLIV",2022-03-16,"England Premier League","Arsenal","Liverpool",0,2,"A",9,9,2,3,9,9,1,6,0,1,0,0,0,0,0,2,18,5,18,7,1,0
"20220317EVENEW",2022-03-17,"England Premier League","Everton","Newcastle",1,0,"H",9,17,3,6,13,11,5,7,2,1,1,0,1,0,1,1,26,9,24,12,3,1
"20220318WOLLEE",2022-03-18,"England Premier League","Wolves","Leeds",2,3,"A",14,15,8,6,13,14,2,5,1,4,1,0,0,0,0,5,29,14,27,7,5,1
"20220319ASTARS",2022-03-19,"England Premier League","Aston Villa","Arsenal",0,1,"A",8,10,1,3,13,14,6,5,3,3,0,0,0,0,0,1,18,4,27,11,6,0
"20220320LEIBRE",2022-03-20,"England Premier League","Leicester","Brentford",2,1,"H",12,15,4,6,10,10,2,5,1,2,0,0,0,0,0,3,27,10,20,7,3,0
"20220320TOTWES",2022-03-20,"England Premier League","Tottenham","West Ham",3,1,"H",17,6,4,1,7,7,5,3,0,1,0,0,0,0,0,4,23,5,14,8,1,0
"20220402LIVWAT",2022-04-02,"England Premier League","Liverpool","Watford",2,0,"H",20,5,3,2,9,8,9,3,1,1,0,0,0,0,0,2,25,5,17,12,2,0
"20220402BRINOR",2022-04-02,"England Premier League","Brighton","Norwich",0,0,"D",31,6,4,0,12,11,11,2,1,1,0,0,0,0,0,0,37,4,23,13,2,0
"20220402BURMAN",2022-04-02,"England Premier League","Burnley","Man City",0,2,"A",3,18,1,6,11,6,1,8,1,0,0,0,0,0,0,2,21,7,17,9,1,0
"20220402CHEBRE",2022-04-02,"England Premier League","Chelsea","Brentford",1,4,"A",21,17,8,6,11,7,12,7,0,0,0,0,0,0,0,5,38,14,18,19,0,0
"20220402LEESOU",2022-04-02,"England Premier League","Leeds","Southampton",1,1,"D",12,14,3,6,14,7,4,7,1,1,0,0,0,0,0,2,26,9,21,11,2,0
"20220402WOLAST",2022-04-02,"England Premier League","Wolves","Aston Villa",2,1,"H",11,15,5,5,15,8,4,9,4,3,0,0,0,0,0,3,26,10,23,13,7,0
"20220402MANLEI",2022-04-02,"England Premier League","Man United","Leicester",1,1,"D",11,11,5,3,13,6,6,5,2,2,0,0,0,0,0,2,22,8,19,11,4,0
"20220403WESEVE",2022-04-03,"England Premier League","West Ham","Everton",2,1,"H",11,13,5,2,9,12,2,4,1,1,0,1,0,0,0,3,24,7,21,6,2,1
"20220403TOTNEW",2022-04-03,"England Premier League","Tottenham","Newcastle",5,1,"H",19,8,6,1,10,7,2,3,2,3,0,0,0,0,0,6,27,7,17,5,5,0
"20220404CRYARS",2022-04-04,"England Premier League","Crystal Palace","Arsenal",3,0,"H",6,12,5,3,11,15,0,2,0,2,0,0,0,0,0,3,18,8,26,2,2,0
"20220406BUREVE",2022-04-06,"England Premier League","Burnley","Everton",3,2,"H",13,16,4,4,11,16,9,6,2,2,0,0,0,0,0,5,29,8,27,15,4,0
"20220408NEWWOL",2022-04-08,"England Premier League","Newcastle","Wolves",1,0,"H",12,5,4,2,6,13,1,2,1,1,0,0,0,0,0,1,17,6,19,3,2,0
"20220409EVEMAN",2022-04-09,"England Premier League","Everton","Man United",1,0,"H",7,12,3,4,4,10,5,7,2,2,0,0,0,0,0,1,19,7,14,12,4,0
"20220409ARSBRI",2022-04-09,"England Premier League","Arsenal","Brighton",1,2,"A",20,8,4,3,12,19,11,2,3,4,0,0,0,0,0,3,28,7,31,13,7,0
"20220409SOUCHE",2022-04-09,"England Premier League","Southampton","Chelsea",0,6,"A",4,24,1,14,11,10,3,3,1,0,0,0,0,0,0,6,28,15,21,6,1,0
"20220409WATLEE",2022-04-09,"England Premier League","Watford","Leeds",0,3,"A",8,10,1,5,8,12,3,8,2,0,0,0,0,0,0,3,18,6,20,11,2,0
"20220409ASTTOT",2022-04-09,"England Premier League","Aston Villa","Tottenham",0,4,"A",9,11,8,5,12,14,9,3,2,3,0,0,0,0,0,4,20,13,26,12,5,0
"20220410BREWES",2022-04-10,"England Premier League","Brentford","West Ham",2,0,"H",15,5,7,1,2,6,4,6,0,1,0,0,0,0,0,2,20,8,8,10,1,0
"20220410LEICRY",2022-04-10,"England Premier League","Leicester","Crystal Palace",2,1,"H",12,11,3,3,11,12,3,4,1,1,0,0,0,0,0,3,23,6,23,7,2,0
"20220410NORBUR",2022-04-10,"England Premier League","Norwich","Burnley",2,0,"H",17,18,6,4,12,10,6,7,1,1,0,0,3,1,2,2,35,10,22,13,2,0
"20220410MANLIV",2022-04-10,"England Premier League","Man City","Liverpool",2,2,"D",11,6,5,4,9,11,4,1,1,4,0,0,0,0,0,4,17,9,20,5,5,0
"20220416TOTBRI",2022-04-16,"England Premier League","Tottenham","Brighton",0,1,"A",5,12,0,5,14,10,4,4,3,3,0,0,1,0,1,1,17,5,24,8,6,0
"20220416MANNOR",2022-04-16,"England Premier League","Man United","Norwich",3,2,"H",20,15,9,4,7,6,6,7,0,0,0,0,0,0,0,5,35,13,13,13,0,0
"20220416SOUARS",2022-04-16,"England Premier League","Southampton","Arsenal",1,0,"H",9,23,3,6,6,6,6,8,2,1,0,0,0,0,0,1,32,9,12,14,3,0
"20220416WATBRE",2022-04-16,"England Premier League","Watford","Brentford",1,2,"A",17,16,4,5,11,9,6,5,2,1,0,0,0,0,0,3,33,9,20,11,3,0
"20220417NEWLEI",2022-04-17,"England Premier League","Newcastle","Leicester",2,1,"H",16,8,7,2,10,10,3,5,2,2,0,0,0,0,0,3,24,9,20,8,4,0
"20220417WESBUR",2022-04-17,"England Premier League","West Ham","Burnley",1,1,"D",21,9,8,1,9,10,13,4,2,2,0,0,0,0,0,2,30,9,19,17,4,0
"20220419LIVMAN",2022-04-19,"England Premier League","Liverpool","Man United",4,0,"H",14,2,5,1,3,6,10,2,1,2,0,0,0,0,0,4,16,6,9,12,3,0
"20220420CHEARS",2022-04-20,"England Premier League","Chelsea","Arsenal",2,4,"A",11,14,2,4,7,6,6,1,3,1,0,0,0,0,0,6,25,6,13,7,4,0
"20220420EVELEI",2022-04-20,"England Premier League","Everton","Leicester",1,1,"D",13,11,3,3,8,17,5,4,3,1,0,0,0,0,0,2,24,6,25,9,4,0
"20220420NEWCRY",2022-04-20,"England Premier League","Newcastle","Crystal Palace",1,0,"H",13,10,4,2,12,12,2,5,1,1,0,0,0,0,0,1,23,6,24,7,2,0
"20220420MANBRI",2022-04-20,"England Premier League","Man City","Brighton",3,0,"H",17,2,5,1,12,7,7,4,0,3,0,0,0,0,0,3,19,6,19,11,3,0
"20220421BURSOU",2022-04-21,"England Premier League","Burnley","Southampton",2,0,"H",16,11,6,3,7,7,10,10,2,2,0,0,0,0,0,2,27,9,14,20,4,0
"20220423ARSMAN",2022-04-23,"England Premier League","Arsenal","Man United",3,1,"H",14,14,7,5,9,12,1,7,3,4,0,0,1,1,0,4,28,12,21,8,7,0
"20220423LEIAST",2022-04-23,"England Premier League","Leicester","Aston Villa",0,0,"D",5,11,2,3,15,16,7,6,3,2,0,0,0,0,0,0,16,5,31,13,5,0
"20220423MANWAT",2022-04-23,"England Premier League","Man City","Watford",5,1,"H",21,5,8,2,9,7,11,4,1,0,0,0,0,0,0,6,26,10,16,15,1,0
"20220423NORNEW",2022-04-23,"England Premier League","Norwich","Newcastle",0,3,"A",5,13,2,7,11,10,2,3,0,2,0,0,0,0,0,3,18,9,21,5,2,0
"20220423BRETOT",2022-04-23,"England Premier League","Brentford","Tottenham",0,0,"D",15,9,2,0,8,7,12,8,2,1,0,0,0,0,0,0,24,2,15,20,3,0
"20220424BRISOU",2022-04-24,"England Premier League","Brighton","Southampton",2,2,"D",8,18,5,5,12,7,6,6,1,0,0,0,0,0,0,4,26,10,19,12,1,0
"20220424BURWOL",2022-04-24,"England Premier League","Burnley","Wolves",1,0,"H",14,10,5,4,8,7,3,6,3,1,0,0,0,0,0,1,24,9,15,9,4,0
"20220424CHEWES",2022-04-24,"England Premier League","Chelsea","West Ham",1,0,"H",26,6,5,2,11,9,3,1,1,0,0,1,0,0,0,1,32,7,20,4,1,1
"20220424LIVEVE",2022-04-24,"England Premier League","Liverpool","Everton",2,0,"H",18,9,4,1,8,8,13,1,2,5,0,0,0,0,0,2,27,5,16,14,7,0
"20220425CRYLEE",2022-04-25,"England Premier League","Crystal Palace","Leeds",0,0,"D",17,9,7,2,12,13,6,3,2,2,0,0,0,0,0,0,26,9,25,9,4,0
"20220428MANCHE",2022-04-28,"England Premier League","Man United","Chelsea",1,1,"D",6,21,3,6,9,12,2,9,0,1,0,0,0,0,0,2,27,9,21,11,1,0
"20220430NEWLIV",2022-04-30,"England Premier League","Newcastle","Liverpool",0,1,"A",4,24,2,10,11,11,0,6,1,3,0,0,0,0,0,1,28,12,22,6,4,0
"20220430ASTNOR",2022-04-30,"England Premier League","Aston Villa","Norwich",2,0,"H",21,9,6,3,16,8,2,3,4,1,0,0,0,0,0,2,30,9,24,5,5,0
"20220430SOUCRY",2022-04-30,"England Premier League","Southampton","Crystal Palace",1,2,"A",8,14,3,5,13,11,6,7,1,3,0,0,0,0,0,3,22,8,24,13,4,0
"20220430WATBUR",2022-04-30,"England Premier League","Watford","Burnley",1,2,"A",13,17,1,6,13,9,5,6,1,2,0,0,0,0,0,3,30,7,22,11,3,0
"20220430WOLBRI",2022-04-30,"England Premier League","Wolves","Brighton",0,3,"A",11,17,1,9,6,4,7,3,2,1,0,0,0,0,0,3,28,10,10,10,3,0
"20220430LEEMAN",2022-04-30,"England Premier League","Leeds","Man City",0,4,"A",7,19,2,6,13,3,3,6,1,2,0,0,0,0,0,4,26,8,16,9,3,0
"20220501EVECHE",2022-05-01,"England Premier League","Everton","Chelsea",1,0,"H",9,17,4,5,9,12,3,8,3,5,0,0,0,0,0,1,26,9,21,11,8,0
"20220501TOTLEI",2022-05-01,"England Premier League","Tottenham","Leicester",3,1,"H",13,6,7,2,13,8,7,3,2,3,0,0,0,0,0,4,19,9,21,10,5,0
"20220501WESARS",2022-05-01,"England Premier League","West Ham","Arsenal",1,2,"A",8,13,3,7,8,9,3,7,2,2,0,0,1,0,1,3,21,10,17,10,4,0
"20220502MANBRE",2022-05-02,"England Premier League","Man United","Brentford",3,0,"H",9,12,5,4,4,6,3,8,1,0,0,0,0,0,0,3,21,9,10,11,1,0
"20220507BRESOU",2022-05-07,"England Premier League","Brentford","Southampton",3,0,"H",18,19,5,4,12,9,4,7,0,1,0,0,0,0,0,3,37,9,21,11,1,0
"20220507BURAST",2022-05-07,"England Premier League","Burnley","Aston Villa",1,3,"A",14,12,6,7,13,11,4,5,1,2,0,0,0,0,0,4,26,13,24,9,3,0
"20220507CHEWOL",2022-05-07,"England Premier League","Chelsea","Wolves",2,2,"D",19,14,6,4,7,11,9,3,1,3,0,0,0,0,0,4,33,10,18,12,4,0
"20220507CRYWAT",2022-05-07,"England Premier League","Crystal Palace","Watford",1,0,"H",15,6,7,1,11,18,8,5,2,1,0,1,0,0,0,1,21,8,29,13,3,1
"20220507BRIMAN",2022-05-07,"England Premier League","Brighton","Man United",4,0,"H",17,15,6,5,13,9,7,6,0,2,0,0,0,0,0,4,32,11,22,13,2,0
"20220507LIVTOT",2022-05-07,"England Premier League","Liverpool","Tottenham",1,1,"D",22,8,3,3,12,8,11,5,3,2,0,0,0,0,0,2,30,6,20,16,5,0
"20220508ARSLEE",2022-05-08,"England Premier League","Arsenal","Leeds",2,1,"H",19,3,9,2,13,15,8,2,2,2,0,1,0,0,0,3,22,11,28,10,4,1
"20220508LEIEVE",2022-05-08,"England Premier League","Leicester","Everton",1,2,"A",16,10,9,4,11,6,6,1,3,0,0,0,0,0,0,3,26,13,17,7,3,0
"20220508NORWES",2022-05-08,"England Premier League","Norwich","West Ham",0,4,"A",8,13,2,5,7,7,9,5,1,1,0,0,0,0,0,4,21,7,14,14,2,0
"20220508MANNEW",2022-05-08,"England Premier League","Man City","Newcastle",5,0,"H",21,7,9,3,6,11,8,2,1,3,0,0,0,0,0,5,28,12,17,10,4,0
"20220510ASTLIV",2022-05-10,"England Premier League","Aston Villa","Liverpool",1,2,"A",9,17,4,6,10,12,2,3,0,0,0,0,0,0,0,3,26,10,22,5,0,0
"20220511LEECHE",2022-05-11,"England Premier League","Leeds","Chelsea",0,3,"A",5,17,0,4,10,14,1,5,1,0,1,0,0,0,0,3,22,4,24,6,1,1
"20220511LEINOR",2022-05-11,"England Premier League","Leicester","Norwich",3,0,"H",20,9,8,5,10,5,10,2,0,0,0,0,0,0,0,3,29,13,15,12,0,0
"20220511WATEVE",2022-05-11,"England Premier League","Watford","Everton",0,0,"D",6,16,0,5,5,12,1,13,1,2,0,0,0,0,0,0,22,5,17,14,3,0
"20220511WOLMAN",2022-05-11,"England Premier League","Wolves","Man City",1,5,"A",7,16,3,5,2,10,6,2,0,1,0,0,0,0,0,6,23,8,12,8,1,0
"20220512TOTARS",2022-05-12,"England Premier League","Tottenham","Arsenal",3,0,"H",16,8,6,4,8,15,2,2,1,3,0,1,0,0,0,3,24,10,23,4,4,1
"20220515TOTBUR",2022-05-15,"England Premier League","Tottenham","Burnley",1,0,"H",21,8,8,1,12,8,8,2,3,2,0,0,0,0,0,1,29,9,20,10,5,0
"20220515ASTCRY",2022-05-15,"England Premier League","Aston Villa","Crystal Palace",1,1,"D",13,16,4,4,11,15,1,5,1,3,0,0,0,0,0,2,29,8,26,6,4,0
"20220515LEEBRI",2022-05-15,"England Premier League","Leeds","Brighton",1,1,"D",19,16,5,6,16,8,8,1,3,2,0,0,0,0,0,2,35,11,24,9,5,0
"20220515WATLEI",2022-05-15,"England Premier League","Watford","Leicester",1,5,"A",13,13,5,7,4,6,7,3,0,1,0,0,0,0,0,6,26,12,10,10,1,0
"20220515WESMAN",2022-05-15,"England Premier League","West Ham","Man City",2,2,"D",6,31,2,8,9,5,4,9,3,1,0,0,0,0,0,4,37,10,14,13,4,0
"20220515WOLNOR",2022-05-15,"England Premier League","Wolves","Norwich",1,1,"D",17,11,4,2,5,10,5,3,0,3,0,0,0,0,0,2,28,6,15,8,3,0
"20220515EVEBRE",2022-05-15,"England Premier League","Everton","Brentford",2,3,"A",10,18,5,7,8,8,5,2,0,3,2,0,0,0,0,5,28,12,16,7,3,2
"20220516NEWARS",2022-05-16,"England Premier League","Newcastle","Arsenal",2,0,"H",16,11,4,2,11,8,12,8,0,3,0,0,0,0,0,2,27,6,19,20,3,0
"20220517SOULIV",2022-05-17,"England Premier League","Southampton","Liverpool",1,2,"A",4,24,2,5,6,6,1,9,2,0,0,0,0,0,0,3,28,7,12,10,2,0
"20220519EVECRY",2022-05-19,"England Premier League","Everton","Crystal Palace",3,2,"H",12,7,6,5,9,13,4,5,2,3,0,0,0,0,0,5,19,11,22,9,5,0
"20220519ASTBUR",2022-05-19,"England Premier League","Aston Villa","Burnley",1,1,"D",22,10,9,5,11,20,13,6,0,1,0,1,0,0,0,2,32,14,31,19,1,1
"20220519CHELEI",2022-05-19,"England Premier League","Chelsea","Leicester",1,1,"D",20,2,7,1,13,7,6,0,4,1,0,0,0,0,0,2,22,8,20,6,5,0
"20220522ARSEVE",2022-05-22,"England Premier League","Arsenal","Everton",5,1,"H",26,6,9,2,8,9,12,2,0,1,0,0,0,0,0,6,32,11,17,14,1,0
"20220522BRELEE",2022-05-22,"England Premier League","Brentford","Leeds",1,2,"A",14,14,5,6,11,13,3,2,2,1,1,0,0,0,0,3,28,11,24,5,3,1
"20220522BRIWES",2022-05-22,"England Premier League","Brighton","West Ham",3,1,"H",18,7,7,2,9,9,5,6,1,1,0,0,0,0,0,4,25,9,18,11,2,0
"20220522BURNEW",2022-05-22,"England Premier League","Burnley","Newcastle",1,2,"A",12,8,5,6,8,9,8,2,1,0,0,0,0,0,0,3,20,11,17,10,1,0
"20220522CHEWAT",2022-05-22,"England Premier League","Chelsea","Watford",2,1,"H",19,8,8,3,9,9,3,3,0,0,0,0,0,0,0,3,27,11,18,6,0,0
"20220522CRYMAN",2022-05-22,"England Premier League","Crystal Palace","Man United",1,0,"H",6,10,3,4,12,22,3,6,2,4,0,0,0,0,0,1,16,7,34,9,6,0
"20220522LEISOU",2022-05-22,"England Premier League","Leicester","Southampton",4,1,"H",12,7,6,2,10,5,3,3,0,1,0,0,0,0,0,5,19,8,15,6,1,0
"20220522LIVWOL",2022-05-22,"England Premier League","Liverpool","Wolves",3,1,"H",29,7,8,5,6,3,5,3,1,0,0,0,0,0,0,4,36,13,9,8,1,0
"20220522MANAST",2022-05-22,"England Premier League","Man City","Aston Villa",3,2,"H",24,4,5,2,5,11,13,1,0,1,0,0,0,0,0,5,28,7,16,14,1,0
"20220522NORTOT",2022-05-22,"England Premier League","Norwich","Tottenham",0,5,"A",9,19,0,13,13,7,3,2,3,1,0,0,0,0,0,5,28,13,20,5,4,0
"20220805CRYARS",2022-08-05,"England Premier League","Crystal Palace","Arsenal",0,2,"A",10,10,2,2,16,11,3,5,1,2,0,0,0,0,0,2,20,4,27,8,3,0
"20220806FULLIV",2022-08-06,"England Premier League","Fulham","Liverpool",2,2,"D",9,11,3,4,7,9,4,4,2,0,0,0,0,0,0,4,20,7,16,8,2,0
"20220806BOUAST",2022-08-06,"England Premier League","Bournemouth","Aston Villa",2,0,"H",7,15,3,2,18,16,5,5,3,3,0,0,0,0,0,2,22,5,34,10,6,0
"20220806LEEWOL",2022-08-06,"England Premier League","Leeds","Wolves",2,1,"H",12,15,4,6,13,9,6,4,2,0,0,0,0,0,0,3,27,10,22,10,2,0
"20220806NEWNOT",2022-08-06,"England Premier League","Newcastle","Nott'm Forest",2,0,"H",23,5,10,0,9,14,11,1,0,3,0,0,0,0,0,2,28,10,23,12,3,0
"20220806TOTSOU",2022-08-06,"England Premier League","Tottenham","Southampton",4,1,"H",18,10,8,2,11,6,10,2,3,0,0,0,0,0,0,5,28,10,17,12,3,0
"20220806EVECHE",2022-08-06,"England Premier League","Everton","Chelsea",0,1,"A",8,15,4,6,14,11,4,16,3,2,0,0,0,0,0,1,23,10,25,20,5,0
"20220807LEIBRE",2022-08-07,"England Premier League","Leicester","Brentford",2,2,"D",14,8,5,3,6,5,5,6,0,0,0,0,0,0,0,4,22,8,11,11,0,0
"20220807MANBRI",2022-08-07,"England Premier League","Man United","Brighton",1,2,"A",17,15,5,4,7,12,6,2,4,1,0,0,0,0,0,3,32,9,19,8,5,0
"20220807WESMAN",2022-08-07,"England Premier League","West Ham","Man City",0,2,"A",6,14,1,2,8,4,1,4,0,1,0,0,0,0,0,2,20,3,12,5,1,0
"20220813ASTEVE",2022-08-13,"England Premier League","Aston Villa","Everton",2,1,"H",12,15,4,4,9,7,5,8,4,1,0,0,0,0,0,3,27,8,16,13,5,0
"20220813ARSLEI",2022-08-13,"England Premier League","Arsenal","Leicester",4,2,"H",19,6,7,2,15,9,6,2,1,1,0,0,0,0,0,6,25,9,24,8,2,0
"20220813BRINEW",2022-08-13,"England Premier League","Brighton","Newcastle",0,0,"D",13,4,7,1,8,6,7,3,2,3,0,0,0,0,0,0,17,8,14,10,5,0
"20220813MANBOU",2022-08-13,"England Premier League","Man City","Bournemouth",4,0,"H",19,3,7,1,9,9,11,1,0,3,0,0,0,0,0,4,22,8,18,12,3,0
"20220813SOULEE",2022-08-13,"England Premier League","Southampton","Leeds",2,2,"D",14,13,4,5,10,12,2,5,1,3,0,0,0,0,0,4,27,9,22,7,4,0
"20220813WOLFUL",2022-08-13,"England Premier League","Wolves","Fulham",0,0,"D",7,9,1,3,7,14,5,3,3,3,0,0,0,0,0,0,16,4,21,8,6,0
"20220813BREMAN",2022-08-13,"England Premier League","Brentford","Man United",4,0,"H",13,15,7,4,6,15,8,2,0,4,0,0,0,0,0,4,28,11,21,10,4,0
"20220814NOTWES",2022-08-14,"England Premier League","Nott'm Forest","West Ham",1,0,"H",13,19,6,5,10,11,6,7,4,1,0,0,0,0,0,1,32,11,21,13,5,0
"20220814CHETOT",2022-08-14,"England Premier League","Chelsea","Tottenham",2,2,"D",16,10,3,5,9,9,8,5,3,0,0,0,0,0,0,4,26,8,18,13,3,0
"20220815LIVCRY",2022-08-15,"England Premier League","Liverpool","Crystal Palace",1,1,"D",24,7,4,3,7,8,4,2,2,4,1,0,0,0,0,2,31,7,15,6,6,1
"20220820TOTWOL",2022-08-20,"England Premier League","Tottenham","Wolves",1,0,"H",11,20,4,3,10,8,8,6,2,2,0,0,0,0,0,1,31,7,18,14,4,0
"20220820CRYAST",2022-08-20,"England Premier League","Crystal Palace","Aston Villa",3,1,"H",17,13,9,5,16,14,4,2,2,1,0,0,0,0,0,4,30,14,30,6,3,0
"20220820EVENOT",2022-08-20,"England Premier League","Everton","Nott'm Forest",1,1,"D",19,14,8,5,6,9,6,2,3,2,0,0,0,0,0,2,33,13,15,8,5,0
"20220820FULBRE",2022-08-20,"England Premier League","Fulham","Brentford",3,2,"H",18,13,9,5,13,7,6,3,3,2,0,0,0,0,0,5,31,14,20,9,5,0
"20220820LEISOU",2022-08-20,"England Premier League","Leicester","Southampton",1,2,"A",6,9,1,3,11,15,2,5,2,3,0,0,0,0,0,3,15,4,26,7,5,0
"20220820BOUARS",2022-08-20,"England Premier League","Bournemouth","Arsenal",0,3,"A",6,14,1,6,12,10,3,4,2,1,0,0,0,0,0,3,20,7,22,7,3,0
"20220821LEECHE",2022-08-21,"England Premier League","Leeds","Chelsea",3,0,"H",12,14,6,3,16,15,4,6,0,1,0,1,0,0,0,3,26,9,31,10,1,1
"20220821WESBRI",2022-08-21,"England Premier League","West Ham","Brighton",0,2,"A",13,11,3,2,10,7,5,4,2,0,0,0,0,0,0,2,24,5,17,9,2,0
"20220821NEWMAN",2022-08-21,"England Premier League","Newcastle","Man City",3,3,"D",12,21,6,10,14,7,5,5,4,2,0,0,0,0,0,6,33,16,21,10,6,0
"20220822MANLIV",2022-08-22,"England Premier League","Man United","Liverpool",2,1,"H",12,17,4,5,11,7,6,8,3,1,0,0,0,0,0,3,29,9,18,14,4,0
"20220827SOUMAN",2022-08-27,"England Premier League","Southampton","Man United",0,1,"A",17,11,5,6,4,14,5,3,0,3,0,0,0,0,0,1,28,11,18,8,3,0
"20220827BREEVE",2022-08-27,"England Premier League","Brentford","Everton",1,1,"D",19,14,5,7,8,8,8,5,2,2,0,0,0,0,0,2,33,12,16,13,4,0
"20220827BRILEE",2022-08-27,"England Premier League","Brighton","Leeds",1,0,"H",13,10,4,2,10,14,5,3,2,3,0,0,0,0,0,1,23,6,24,8,5,0
"20220827CHELEI",2022-08-27,"England Premier League","Chelsea","Leicester",2,1,"H",7,17,3,5,10,7,3,11,1,2,1,0,0,0,0,3,24,8,17,14,3,1
"20220827LIVBOU",2022-08-27,"England Premier League","Liverpool","Bournemouth",9,0,"H",19,5,12,2,6,5,8,1,0,1,0,0,0,0,0,9,24,14,11,9,1,0
"20220827MANCRY",2022-08-27,"England Premier League","Man City","Crystal Palace",4,2,"H",18,2,5,2,14,8,6,1,1,2,0,0,1,0,1,6,20,7,22,7,3,0
"20220827ARSFUL",2022-08-27,"England Premier League","Arsenal","Fulham",2,1,"H",22,11,8,3,6,12,9,2,2,3,0,0,0,0,0,3,33,11,18,11,5,0
"20220828ASTWES",2022-08-28,"England Premier League","Aston Villa","West Ham",0,1,"A",9,7,3,2,10,10,3,2,2,0,0,0,0,0,0,1,16,5,20,5,2,0
"20220828WOLNEW",2022-08-28,"England Premier League","Wolves","Newcastle",1,1,"D",10,21,4,6,10,11,4,13,2,1,0,0,0,0,0,2,31,10,21,17,3,0
"20220828NOTTOT",2022-08-28,"England Premier League","Nott'm Forest","Tottenham",0,2,"A",17,18,1,7,11,13,6,1,6,1,0,0,0,0,0,2,35,8,24,7,7,0
"20220830CRYBRE",2022-08-30,"England Premier League","Crystal Palace","Brentford",1,1,"D",13,9,4,3,11,8,4,6,1,2,0,0,0,0,0,2,22,7,19,10,3,0
"20220830FULBRI",2022-08-30,"England Premier League","Fulham","Brighton",2,1,"H",10,7,3,4,9,11,3,3,2,1,0,0,0,0,0,3,17,7,20,6,3,0
"20220830SOUCHE",2022-08-30,"England Premier League","Southampton","Chelsea",2,1,"H",9,10,7,4,15,10,5,3,2,1,0,0,0,0,0,3,19,11,25,8,3,0
"20220830LEEEVE",2022-08-30,"England Premier League","Leeds","Everton",1,1,"D",14,7,5,2,10,9,10,2,3,3,0,0,0,0,0,2,21,7,19,12,6,0
"20220831ARSAST",2022-08-31,"England Premier League","Arsenal","Aston Villa",2,1,"H",22,4,9,3,10,14,10,3,2,3,0,0,0,0,0,3,26,12,24,13,5,0
"20220831BOUWOL",2022-08-31,"England Premier League","Bournemouth","Wolves",0,0,"D",5,17,2,4,12,12,2,5,2,1,0,0,0,0,0,0,22,6,24,7,3,0
"20220831MANNOT",2022-08-31,"England Premier League","Man City","Nott'm Forest",6,0,"H",17,8,9,1,9,7,10,1,0,1,0,0,0,0,0,6,25,10,16,11,1,0
"20220831WESTOT",2022-08-31,"England Premier League","West Ham","Tottenham",1,1,"D",14,13,4,4,10,9,3,4,2,5,0,0,0,0,0,2,27,8,19,7,7,0
"20220831LIVNEW",2022-08-31,"England Premier League","Liverpool","Newcastle",2,1,"H",23,5,6,2,9,10,13,0,0,2,0,0,0,0,0,3,28,8,19,13,2,0
"20220901LEIMAN",2022-09-01,"England Premier League","Leicester","Man United",0,1,"A",10,9,2,2,7,15,1,3,1,3,0,0,0,0,0,1,19,4,22,4,4,0
"20220903EVELIV",2022-09-03,"England Premier League","Everton","Liverpool",0,0,"D",14,23,3,8,7,11,7,9,2,2,0,0,0,0,0,0,37,11,18,16,4,0
"20220903BRELEE",2022-09-03,"England Premier League","Brentford","Leeds",5,2,"H",14,17,8,6,8,9,2,6,2,2,0,0,0,0,0,7,31,14,17,8,4,0
"20220903CHEWES",2022-09-03,"England Premier League","Chelsea","West Ham",2,1,"H",8,6,3,3,6,11,10,3,4,2,0,0,0,0,0,3,14,6,17,13,6,0
"20220903NEWCRY",2022-09-03,"England Premier League","Newcastle","Crystal Palace",0,0,"D",23,19,6,9,19,12,13,5,2,1,0,0,0,0,0,0,42,15,31,18,3,0
"20220903NOTBOU",2022-09-03,"England Premier League","Nott'm Forest","Bournemouth",2,3,"A",11,8,3,3,13,10,4,6,2,1,0,0,0,0,0,5,19,6,23,10,3,0
"20220903TOTFUL",2022-09-03,"England Premier League","Tottenham","Fulham",2,1,"H",23,9,10,3,9,6,10,3,3,4,0,0,0,0,0,3,32,13,15,13,7,0
"20220903WOLSOU",2022-09-03,"England Premier League","Wolves","Southampton",1,0,"H",7,12,2,1,10,14,5,6,4,2,0,0,0,0,0,1,19,3,24,11,6,0
"20220903ASTMAN",2022-09-03,"England Premier League","Aston Villa","Man City",1,1,"D",3,13,1,4,7,6,1,4,2,0,0,0,0,0,0,2,16,5,13,5,2,0
"20220904BRILEI",2022-09-04,"England Premier League","Brighton","Leicester",5,2,"H",23,6,11,4,6,8,10,1,1,1,0,0,0,0,0,7,29,15,14,11,2,0
"20220904MANARS",2022-09-04,"England Premier League","Man United","Arsenal",3,1,"H",10,16,6,3,13,9,2,5,3,3,0,0,0,0,0,4,26,9,22,7,6,0
"20220916ASTSOU",2022-09-16,"England Premier League","Aston Villa","Southampton",1,0,"H",11,7,3,1,13,13,6,3,3,1,0,0,0,0,0,1,18,4,26,9,4,0
"20220916NOTFUL",2022-09-16,"England Premier League","Nott'm Forest","Fulham",2,3,"A",11,15,3,7,11,10,2,10,2,4,0,0,0,0,0,5,26,10,21,12,6,0
"20220917WOLMAN",2022-09-17,"England Premier League","Wolves","Man City",0,3,"A",6,16,1,7,7,9,5,7,2,1,1,0,0,0,0,3,22,8,16,12,3,1
"20220917NEWBOU",2022-09-17,"England Premier League","Newcastle","Bournemouth",1,1,"D",20,10,7,3,10,11,8,1,2,2,0,0,0,0,0,2,30,10,21,9,4,0
"20220917TOTLEI",2022-09-17,"England Premier League","Tottenham","Leicester",6,2,"H",16,19,11,7,9,9,6,1,1,2,0,0,0,0,0,8,35,18,18,7,3,0
"20220918BREARS",2022-09-18,"England Premier League","Brentford","Arsenal",0,3,"A",5,13,2,7,10,10,3,3,0,2,0,0,0,0,0,3,18,9,20,6,2,0
"20220918EVEWES",2022-09-18,"England Premier League","Everton","West Ham",1,0,"H",7,14,2,4,8,11,5,14,3,1,0,0,0,0,0,1,21,6,19,19,4,0
"20221001ARSTOT",2022-10-01,"England Premier League","Arsenal","Tottenham",3,1,"H",22,7,9,3,10,10,5,2,2,1,0,1,0,0,0,4,29,12,20,7,3,1
"20221001BOUBRE",2022-10-01,"England Premier League","Bournemouth","Brentford",0,0,"D",7,13,1,4,11,10,7,8,1,2,0,0,0,0,0,0,20,5,21,15,3,0
"20221001CRYCHE",2022-10-01,"England Premier League","Crystal Palace","Chelsea",1,2,"A",7,13,3,3,11,13,5,2,1,3,0,0,0,0,0,3,20,6,24,7,4,0
"20221001FULNEW",2022-10-01,"England Premier League","Fulham","Newcastle",1,4,"A",3,19,1,10,9,10,1,8,2,0,1,0,0,0,0,5,22,11,19,9,2,1
"20221001LIVBRI",2022-10-01,"England Premier League","Liverpool","Brighton",3,3,"D",15,6,7,6,9,13,9,2,1,1,0,0,0,0,0,6,21,13,22,11,2,0
"20221001SOUEVE",2022-10-01,"England Premier League","Southampton","Everton",1,2,"A",22,12,6,5,11,10,7,6,2,2,0,0,0,0,0,3,34,11,21,13,4,0
"20221001WESWOL",2022-10-01,"England Premier League","West Ham","Wolves",2,0,"H",18,15,5,4,8,6,1,6,2,2,0,0,0,0,0,2,33,9,14,7,4,0
"20221002MANMAN",2022-10-02,"England Premier League","Man City","Man United",6,3,"H",22,12,10,8,3,9,5,1,0,3,0,0,0,0,0,9,34,18,12,6,3,0
"20221002LEEAST",2022-10-02,"England Premier League","Leeds","Aston Villa",0,0,"D",9,19,1,7,23,12,2,9,3,2,1,0,0,0,0,0,28,8,35,11,5,1
"20221003LEINOT",2022-10-03,"England Premier League","Leicester","Nott'm Forest",4,0,"H",17,10,7,3,13,12,6,6,2,4,0,0,0,0,0,4,27,10,25,12,6,0
"20221008BOULEI",2022-10-08,"England Premier League","Bournemouth","Leicester",2,1,"H",10,9,4,5,8,16,7,2,1,2,0,0,0,0,0,3,19,9,24,9,3,0
"20221008CHEWOL",2022-10-08,"England Premier League","Chelsea","Wolves",3,0,"H",20,8,7,2,8,8,4,2,2,0,0,0,0,0,0,3,28,9,16,6,2,0
"20221008MANSOU",2022-10-08,"England Premier League","Man City","Southampton",4,0,"H",21,5,8,0,4,8,9,1,0,1,0,0,0,0,0,4,26,8,12,10,1,0
"20221008NEWBRE",2022-10-08,"England Premier League","Newcastle","Brentford",5,1,"H",16,6,6,3,14,9,9,5,0,1,0,0,0,0,0,6,22,9,23,14,1,0
"20221008BRITOT",2022-10-08,"England Premier League","Brighton","Tottenham",0,1,"A",14,8,4,3,9,14,6,2,1,2,0,0,0,0,0,1,22,7,23,8,3,0
"20221009CRYLEE",2022-10-09,"England Premier League","Crystal Palace","Leeds",2,1,"H",13,10,5,4,13,23,5,3,3,3,0,0,0,0,0,3,23,9,36,8,6,0
"20221009WESFUL",2022-10-09,"England Premier League","West Ham","Fulham",3,1,"H",17,8,8,2,9,7,4,2,1,3,0,0,0,0,0,4,25,10,16,6,4,0
"20221009ARSLIV",2022-10-09,"England Premier League","Arsenal","Liverpool",3,2,"H",11,8,7,3,11,11,4,3,1,2,0,0,0,0,0,5,19,10,22,7,3,0
"20221009EVEMAN",2022-10-09,"England Premier League","Everton","Man United",1,2,"A",11,12,2,4,7,13,5,4,2,1,0,0,0,0,0,3,23,6,20,9,3,0
"20221010NOTAST",2022-10-10,"England Premier League","Nott'm Forest","Aston Villa",1,1,"D",6,12,3,2,13,19,1,4,3,3,0,0,0,0,0,2,18,5,32,5,6,0
"20221014BREBRI",2022-10-14,"England Premier League","Brentford","Brighton",2,0,"H",7,21,3,7,12,15,2,11,3,1,0,0,0,0,0,2,28,10,27,13,4,0
"20221015LEICRY",2022-10-15,"England Premier League","Leicester","Crystal Palace",0,0,"D",14,8,5,1,18,13,9,2,2,2,0,0,0,0,0,0,22,6,31,11,4,0
"20221015FULBOU",2022-10-15,"England Premier League","Fulham","Bournemouth",2,2,"D",19,10,4,6,9,11,5,6,2,0,0,0,0,0,0,4,29,10,20,11,2,0
"20221015WOLNOT",2022-10-15,"England Premier League","Wolves","Nott'm Forest",1,0,"H",9,10,2,2,17,13,4,5,2,2,0,0,0,0,0,1,19,4,30,9,4,0
"20221015TOTEVE",2022-10-15,"England Premier League","Tottenham","Everton",2,0,"H",21,4,7,0,12,13,7,1,1,4,0,0,0,0,0,2,25,7,25,8,5,0
"20221016ASTCHE",2022-10-16,"England Premier League","Aston Villa","Chelsea",0,2,"A",18,8,7,4,12,11,7,1,0,3,0,0,0,0,0,2,26,11,23,8,3,0
"20221016LEEARS",2022-10-16,"England Premier League","Leeds","Arsenal",0,1,"A",16,9,4,4,10,11,6,3,0,2,0,0,0,0,0,1,25,8,21,9,2,0
"20221016MANNEW",2022-10-16,"England Premier League","Man United","Newcastle",0,0,"D",15,9,2,2,13,11,4,4,3,1,0,0,0,0,0,0,24,4,24,8,4,0
"20221016SOUWES",2022-10-16,"England Premier League","Southampton","West Ham",1,1,"D",10,25,8,4,7,3,4,14,1,1,0,0,0,0,0,2,35,12,10,18,2,0
"20221016LIVMAN",2022-10-16,"England Premier League","Liverpool","Man City",1,0,"H",13,16,2,6,10,7,5,6,3,1,0,0,0,0,0,1,29,8,17,11,4,0
"20221018BRINOT",2022-10-18,"England Premier League","Brighton","Nott'm Forest",0,0,"D",19,3,7,0,10,14,9,1,3,1,0,0,0,0,0,0,22,7,24,10,4,0
"20221018CRYWOL",2022-10-18,"England Premier League","Crystal Palace","Wolves",2,1,"H",14,10,4,4,14,18,4,3,3,1,0,0,0,0,0,3,24,8,32,7,4,0
"20221019BOUSOU",2022-10-19,"England Premier League","Bournemouth","Southampton",0,1,"A",15,9,3,3,8,13,7,3,1,3,0,0,0,0,0,1,24,6,21,10,4,0
"20221019BRECHE",2022-10-19,"England Premier League","Brentford","Chelsea",0,0,"D",8,14,5,5,7,7,6,2,0,0,0,0,0,0,0,0,22,10,14,8,0,0
"20221019LIVWES",2022-10-19,"England Premier League","Liverpool","West Ham",1,0,"H",22,8,7,3,9,8,8,3,0,0,0,0,0,0,0,1,30,10,17,11,0,0
"20221019NEWEVE",2022-10-19,"England Premier League","Newcastle","Everton",1,0,"H",16,1,4,0,9,12,8,2,2,4,0,0,0,0,0,1,17,4,21,10,6,0
"20221019MANTOT",2022-10-19,"England Premier League","Man United","Tottenham",2,0,"H",28,9,10,2,7,7,8,3,1,0,0,0,0,0,0,2,37,12,14,11,1,0
"20221020FULAST",2022-10-20,"England Premier League","Fulham","Aston Villa",3,0,"H",18,12,8,6,11,11,9,7,0,2,0,1,0,0,0,3,30,14,22,16,2,1
"20221020LEILEE",2022-10-20,"England Premier League","Leicester","Leeds",2,0,"H",5,14,1,2,15,11,2,9,2,1,0,0,0,0,0,2,19,3,26,11,3,0
"20221022NOTLIV",2022-10-22,"England Premier League","Nott'm Forest","Liverpool",1,0,"H",10,15,7,7,14,8,2,11,2,1,0,0,0,0,0,1,25,14,22,13,3,0
"20221022EVECRY",2022-10-22,"England Premier League","Everton","Crystal Palace",3,0,"H",9,9,6,2,16,14,3,4,3,4,0,0,0,0,0,3,18,8,30,7,7,0
"20221022MANBRI",2022-10-22,"England Premier League","Man City","Brighton",3,1,"H",10,8,4,2,11,12,7,3,1,3,0,0,0,0,0,4,18,6,23,10,4,0
"20221022CHEMAN",2022-10-22,"England Premier League","Chelsea","Man United",1,1,"D",6,13,2,6,8,10,6,4,1,4,0,0,0,0,0,2,19,8,18,10,5,0
"20221023ASTBRE",2022-10-23,"England Premier League","Aston Villa","Brentford",4,0,"H",19,12,11,3,14,11,7,6,1,0,0,0,0,0,0,4,31,14,25,13,1,0
"20221023LEEFUL",2022-10-23,"England Premier League","Leeds","Fulham",2,3,"A",14,11,5,5,12,8,3,6,1,1,0,0,0,0,0,5,25,10,20,9,2,0
"20221023SOUARS",2022-10-23,"England Premier League","Southampton","Arsenal",1,1,"D",10,12,3,3,11,8,9,4,2,1,0,0,0,0,0,2,22,6,19,13,3,0
"20221023WOLLEI",2022-10-23,"England Premier League","Wolves","Leicester",0,4,"A",21,5,5,4,10,13,9,2,2,1,0,0,0,0,0,4,26,9,23,11,3,0
"20221023TOTNEW",2022-10-23,"England Premier League","Tottenham","Newcastle",1,2,"A",17,13,5,5,12,6,6,7,4,2,0,0,0,0,0,3,30,10,18,13,6,0
"20221024WESBOU",2022-10-24,"England Premier League","West Ham","Bournemouth",2,0,"H",20,5,4,3,9,11,5,0,0,2,0,0,0,0,0,2,25,7,20,5,2,0
"20221029LEIMAN",2022-10-29,"England Premier League","Leicester","Man City",0,1,"A",10,15,5,5,5,10,3,10,0,0,0,0,0,0,0,1,25,10,15,13,0,0
"20221029BOUTOT",2022-10-29,"England Premier League","Bournemouth","Tottenham",2,3,"A",6,23,4,7,10,5,2,19,1,2,0,0,0,0,0,5,29,11,15,21,3,0
"20221029BREWOL",2022-10-29,"England Premier League","Brentford","Wolves",1,1,"D",12,14,3,4,10,17,3,6,3,3,0,1,0,0,0,2,26,7,27,9,6,1
"20221029BRICHE",2022-10-29,"England Premier League","Brighton","Chelsea",4,1,"H",19,15,9,7,16,6,8,7,1,2,0,0,0,0,0,5,34,16,22,15,3,0
"20221029CRYSOU",2022-10-29,"England Premier League","Crystal Palace","Southampton",1,0,"H",12,14,3,4,13,12,8,4,3,3,0,0,0,0,0,1,26,7,25,12,6,0
"20221029NEWAST",2022-10-29,"England Premier League","Newcastle","Aston Villa",4,0,"H",20,3,7,0,11,11,3,0,1,1,0,0,0,0,0,4,23,7,22,3,2,0
"20221029FULEVE",2022-10-29,"England Premier League","Fulham","Everton",0,0,"D",24,9,6,4,10,8,13,4,2,1,0,0,0,0,0,0,33,10,18,17,3,0
"20221029LIVLEE",2022-10-29,"England Premier League","Liverpool","Leeds",1,2,"A",22,14,10,6,9,3,14,5,0,1,0,0,0,0,0,3,36,16,12,19,1,0
"20221030ARSNOT",2022-10-30,"England Premier League","Arsenal","Nott'm Forest",5,0,"H",24,5,10,2,9,8,9,4,0,1,0,0,0,0,0,5,29,12,17,13,1,0
"20221030MANWES",2022-10-30,"England Premier League","Man United","West Ham",1,0,"H",16,13,3,5,12,10,5,10,1,3,0,0,0,0,0,1,29,8,22,15,4,0
"20221105LEEBOU",2022-11-05,"England Premier League","Leeds","Bournemouth",4,3,"H",18,9,4,6,16,10,13,3,2,2,0,0,0,0,0,7,27,10,26,16,4,0
"20221105MANFUL",2022-11-05,"England Premier League","Man City","Fulham",2,1,"H",16,4,5,2,6,11,9,0,2,4,1,0,0,0,0,3,20,7,17,9,6,1
"20221105NOTBRE",2022-11-05,"England Premier League","Nott'm Forest","Brentford",2,2,"D",15,6,7,2,10,11,3,3,2,2,0,0,0,0,0,4,21,9,21,6,4,0
"20221105WOLBRI",2022-11-05,"England Premier League","Wolves","Brighton",2,3,"A",8,19,5,8,15,11,4,9,2,0,1,0,0,0,0,5,27,13,26,13,2,1
"20221105EVELEI",2022-11-05,"England Premier League","Everton","Leicester",0,2,"A",12,22,2,8,9,5,8,3,0,0,0,0,0,0,0,2,34,10,14,11,0,0
"20221106CHEARS",2022-11-06,"England Premier League","Chelsea","Arsenal",0,1,"A",5,14,1,2,20,13,4,6,5,2,0,0,0,0,0,1,19,3,33,10,7,0
"20221106ASTMAN",2022-11-06,"England Premier League","Aston Villa","Man United",3,1,"H",6,8,4,3,6,12,3,5,3,3,0,0,0,0,0,4,14,7,18,8,6,0
"20221106SOUNEW",2022-11-06,"England Premier League","Southampton","Newcastle",1,4,"A",16,7,5,4,7,10,8,2,1,0,0,0,0,0,0,5,23,9,17,10,1,0
"20221106WESCRY",2022-11-06,"England Premier League","West Ham","Crystal Palace",1,2,"A",5,15,2,6,10,7,2,5,1,1,0,0,0,0,0,3,20,8,17,7,2,0
"20221106TOTLIV",2022-11-06,"England Premier League","Tottenham","Liverpool",1,2,"A",14,13,5,6,10,8,5,3,0,0,0,0,0,0,0,3,27,11,18,8,0,0
"20221112MANBRE",2022-11-12,"England Premier League","Man City","Brentford",1,2,"A",29,10,6,8,9,7,10,2,2,2,0,0,0,0,0,3,39,14,16,12,4,0
"20221112BOUEVE",2022-11-12,"England Premier League","Bournemouth","Everton",3,0,"H",16,15,9,3,12,8,3,5,2,0,0,0,0,0,0,3,31,12,20,8,2,0
"20221112LIVSOU",2022-11-12,"England Premier League","Liverpool","Southampton",3,1,"H",15,9,7,5,8,8,6,0,0,2,0,0,0,0,0,4,24,12,16,6,2,0
"20221112NOTCRY",2022-11-12,"England Premier League","Nott'm Forest","Crystal Palace",1,0,"H",9,8,2,0,11,13,1,5,1,4,0,0,0,0,0,1,17,2,24,6,5,0
"20221112TOTLEE",2022-11-12,"England Premier League","Tottenham","Leeds",4,3,"H",14,12,8,5,8,7,9,2,1,1,0,1,0,0,0,7,26,13,15,11,2,1
"20221112WESLEI",2022-11-12,"England Premier League","West Ham","Leicester",0,2,"A",18,9,6,6,9,8,7,2,3,1,0,0,0,0,0,2,27,12,17,9,4,0
"20221112NEWCHE",2022-11-12,"England Premier League","Newcastle","Chelsea",1,0,"H",10,5,3,2,14,11,5,3,3,2,0,0,1,0,1,1,15,5,25,8,5,0
"20221112WOLARS",2022-11-12,"England Premier League","Wolves","Arsenal",0,2,"A",11,14,2,4,5,6,6,4,3,2,0,0,0,0,0,2,25,6,11,10,5,0
"20221113BRIAST",2022-11-13,"England Premier League","Brighton","Aston Villa",1,2,"A",7,8,2,2,14,11,11,4,2,7,0,0,0,0,0,3,15,4,25,15,9,0
"20221113FULMAN",2022-11-13,"England Premier League","Fulham","Man United",1,2,"A",14,14,7,9,9,10,10,3,1,1,0,0,0,0,0,3,28,16,19,13,2,0
"20221226BRETOT",2022-12-26,"England Premier League","Brentford","Tottenham",2,2,"D",9,16,5,8,11,10,6,5,3,1,0,0,0,0,0,4,25,13,21,11,4,0
"20221226CRYFUL",2022-12-26,"England Premier League","Crystal Palace","Fulham",0,3,"A",4,23,0,11,12,15,1,8,0,0,2,0,0,0,0,3,27,11,27,9,0,2
"20221226EVEWOL",2022-12-26,"England Premier League","Everton","Wolves",1,2,"A",12,7,6,4,9,22,2,2,1,6,0,0,0,0,0,3,19,10,31,4,7,0
"20221226LEINEW",2022-12-26,"England Premier League","Leicester","Newcastle",0,3,"A",8,12,2,5,9,6,5,5,0,0,0,0,0,0,0,3,20,7,15,10,0,0
"20221226SOUBRI",2022-12-26,"England Premier League","Southampton","Brighton",1,3,"A",14,7,4,4,9,10,4,2,1,2,0,0,0,0,0,4,21,8,19,6,3,0
"20221226ASTLIV",2022-12-26,"England Premier League","Aston Villa","Liverpool",1,3,"A",12,16,6,9,7,12,0,6,0,0,0,0,0,0,0,4,28,15,19,6,0,0
"20221226ARSWES",2022-12-26,"England Premier League","Arsenal","West Ham",3,1,"H",16,8,5,4,13,17,7,5,0,2,0,0,0,0,0,4,24,9,30,12,2,0
"20221227CHEBOU",2022-12-27,"England Premier League","Chelsea","Bournemouth",2,0,"H",15,9,5,4,8,10,6,8,0,0,0,0,0,0,0,2,24,9,18,14,0,0
"20221227MANNOT",2022-12-27,"England Premier League","Man United","Nott'm Forest",3,0,"H",17,8,8,3,13,4,9,9,3,1,0,0,0,0,0,3,25,11,17,18,4,0
"20221228LEEMAN",2022-12-28,"England Premier League","Leeds","Man City",1,3,"A",9,26,1,9,11,14,3,5,3,3,0,0,0,0,0,4,35,10,25,8,6,0
"20221230WESBRE",2022-12-30,"England Premier League","West Ham","Brentford",0,2,"A",20,9,5,6,9,5,8,1,1,0,0,0,0,0,0,2,29,11,14,9,1,0
"20221230LIVLEI",2022-12-30,"England Premier League","Liverpool","Leicester",2,1,"H",21,7,5,2,8,15,4,5,0,1,0,0,0,0,0,3,28,7,23,9,1,0
"20221231WOLMAN",2022-12-31,"England Premier League","Wolves","Man United",0,1,"A",10,16,3,6,11,11,7,5,1,3,0,0,0,0,0,1,26,9,22,12,4,0
"20221231BOUCRY",2022-12-31,"England Premier League","Bournemouth","Crystal Palace",0,2,"A",6,15,2,6,17,11,2,7,4,1,0,0,0,0,0,2,21,8,28,9,5,0
"20221231FULSOU",2022-12-31,"England Premier League","Fulham","Southampton",2,1,"H",8,9,2,3,8,13,4,4,0,1,0,0,0,0,0,3,17,5,21,8,1,0
"20221231MANEVE",2022-12-31,"England Premier League","Man City","Everton",1,1,"D",16,2,3,1,13,14,7,1,3,4,0,0,0,0,0,2,18,4,27,8,7,0
"20221231NEWLEE",2022-12-31,"England Premier League","Newcastle","Leeds",0,0,"D",16,8,5,1,13,19,9,3,3,5,0,0,0,0,0,0,24,6,32,12,8,0
"20221231BRIARS",2022-12-31,"England Premier League","Brighton","Arsenal",2,4,"A",9,14,5,7,7,11,7,4,3,3,0,0,0,0,0,6,23,12,18,11,6,0
"20230101TOTAST",2023-01-01,"England Premier League","Tottenham","Aston Villa",0,2,"A",6,13,2,4,15,10,5,3,4,3,0,0,0,0,0,2,19,6,25,8,7,0
"20230101NOTCHE",2023-01-01,"England Premier League","Nott'm Forest","Chelsea",1,1,"D",12,7,5,2,16,14,1,2,2,2,0,0,0,0,0,2,19,7,30,3,4,0
"20230102BRELIV",2023-01-02,"England Premier League","Brentford","Liverpool",3,1,"H",10,16,7,6,5,8,4,9,1,3,0,0,0,0,0,4,26,13,13,13,4,0
"20230103ARSNEW",2023-01-03,"England Premier League","Arsenal","Newcastle",0,0,"D",17,8,4,1,10,16,5,5,4,4,0,0,0,0,0,0,25,5,26,10,8,0
"20230103EVEBRI",2023-01-03,"England Premier League","Everton","Brighton",1,4,"A",10,19,4,8,8,10,5,2,3,1,0,0,0,0,0,5,29,12,18,7,4,0
"20230103LEIFUL",2023-01-03,"England Premier League","Leicester","Fulham",0,1,"A",15,11,6,2,12,11,6,3,2,6,0,0,0,0,0,1,26,8,23,9,8,0
"20230103MANBOU",2023-01-03,"England Premier League","Man United","Bournemouth",3,0,"H",18,7,6,4,13,7,6,5,0,3,0,0,0,0,0,3,25,10,20,11,3,0
"20230104SOUNOT",2023-01-04,"England Premier League","Southampton","Nott'm Forest",0,1,"A",8,11,0,1,14,17,6,2,2,2,0,0,0,0,0,1,19,1,31,8,4,0
"20230104LEEWES",2023-01-04,"England Premier League","Leeds","West Ham",2,2,"D",14,15,6,2,11,18,8,1,3,1,0,0,0,0,0,4,29,8,29,9,4,0
"20230104ASTWOL",2023-01-04,"England Premier League","Aston Villa","Wolves",1,1,"D",13,10,4,3,6,12,7,8,1,3,0,0,0,0,0,2,23,7,18,15,4,0
"20230104CRYTOT",2023-01-04,"England Premier League","Crystal Palace","Tottenham",0,4,"A",19,14,4,6,11,8,10,4,1,2,0,0,0,0,0,4,33,10,19,14,3,0
"20230105CHEMAN",2023-01-05,"England Premier League","Chelsea","Man City",0,1,"A",8,12,2,3,9,9,3,2,2,0,0,0,0,0,0,1,20,5,18,5,2,0
"20230112FULCHE",2023-01-12,"England Premier League","Fulham","Chelsea",2,1,"H",8,20,3,10,12,16,5,7,4,3,0,1,0,0,0,3,28,13,28,12,7,1
"20230113ASTLEE",2023-01-13,"England Premier League","Aston Villa","Leeds",2,1,"H",11,16,5,4,12,8,0,11,2,2,0,0,0,0,0,3,27,9,20,11,4,0
"20230114MANMAN",2023-01-14,"England Premier League","Man United","Man City",2,1,"H",8,5,4,1,15,5,1,2,3,0,0,0,0,0,0,3,13,5,20,3,3,0
"20230114BRILIV",2023-01-14,"England Premier League","Brighton","Liverpool",3,0,"H",16,6,9,2,8,15,7,1,1,3,0,0,0,0,0,3,22,11,23,8,4,0
"20230114EVESOU",2023-01-14,"England Premier League","Everton","Southampton",1,2,"A",12,13,4,5,7,19,6,4,0,3,0,0,0,0,0,3,25,9,26,10,3,0
"20230114NOTLEI",2023-01-14,"England Premier League","Nott'm Forest","Leicester",2,0,"H",15,6,5,1,11,12,3,5,1,2,0,0,0,0,0,2,21,6,23,8,3,0
"20230114WOLWES",2023-01-14,"England Premier League","Wolves","West Ham",1,0,"H",17,16,4,4,10,7,4,3,0,2,0,0,0,0,0,1,33,8,17,7,2,0
"20230114BREBOU",2023-01-14,"England Premier League","Brentford","Bournemouth",2,0,"H",12,7,4,2,5,9,5,3,1,1,0,0,0,0,0,2,19,6,14,8,2,0
"20230115CHECRY",2023-01-15,"England Premier League","Chelsea","Crystal Palace",1,0,"H",15,10,5,5,10,17,11,7,2,5,0,0,0,0,0,1,25,10,27,18,7,0
"20230115NEWFUL",2023-01-15,"England Premier League","Newcastle","Fulham",1,0,"H",20,5,5,0,6,14,10,5,1,3,0,0,0,0,0,1,25,5,20,15,4,0
"20230115TOTARS",2023-01-15,"England Premier League","Tottenham","Arsenal",0,2,"A",17,14,7,5,16,15,4,3,4,2,0,0,0,0,0,2,31,12,31,7,6,0
"20230118CRYMAN",2023-01-18,"England Premier League","Crystal Palace","Man United",1,1,"D",10,15,5,4,9,10,3,3,1,2,0,0,0,0,0,2,25,9,19,6,3,0
"20230119MANTOT",2023-01-19,"England Premier League","Man City","Tottenham",4,2,"H",16,9,6,3,10,14,8,3,1,2,0,0,0,0,0,6,25,9,24,11,3,0
"20230121LIVCHE",2023-01-21,"England Premier League","Liverpool","Chelsea",0,0,"D",15,11,3,2,16,9,5,5,3,1,0,0,0,0,0,0,26,5,25,10,4,0
"20230121BOUNOT",2023-01-21,"England Premier League","Bournemouth","Nott'm Forest",1,1,"D",16,20,4,5,10,7,4,6,1,2,0,0,1,1,0,2,36,9,17,10,3,0
"20230121LEIBRI",2023-01-21,"England Premier League","Leicester","Brighton",2,2,"D",9,13,2,4,9,9,5,6,0,1,0,0,0,0,0,4,22,6,18,11,1,0
"20230121SOUAST",2023-01-21,"England Premier League","Southampton","Aston Villa",0,1,"A",8,16,5,5,19,9,2,2,1,2,0,0,0,0,0,1,24,10,28,4,3,0
"20230121WESEVE",2023-01-21,"England Premier League","West Ham","Everton",2,0,"H",11,5,4,2,9,6,4,9,1,1,0,0,0,0,0,2,16,6,15,13,2,0
"20230121CRYNEW",2023-01-21,"England Premier League","Crystal Palace","Newcastle",0,0,"D",6,16,1,7,13,7,3,15,4,2,0,0,0,0,0,0,22,8,20,18,6,0
"20230122LEEBRE",2023-01-22,"England Premier League","Leeds","Brentford",0,0,"D",9,6,5,0,10,18,2,3,2,2,0,0,0,0,0,0,15,5,28,5,4,0
"20230122MANWOL",2023-01-22,"England Premier League","Man City","Wolves",3,0,"H",13,10,7,1,10,10,5,7,1,2,0,0,0,0,0,3,23,8,20,12,3,0
"20230122ARSMAN",2023-01-22,"England Premier League","Arsenal","Man United",3,2,"H",25,6,5,4,8,9,12,4,1,2,0,0,0,0,0,5,31,9,17,16,3,0
"20230123FULTOT",2023-01-23,"England Premier League","Fulham","Tottenham",0,1,"A",10,10,5,3,10,10,3,8,1,3,0,0,0,0,0,1,20,8,20,11,4,0
"20230203CHEFUL",2023-02-03,"England Premier League","Chelsea","Fulham",0,0,"D",12,10,3,4,16,12,6,2,1,4,0,0,0,0,0,0,22,7,28,8,5,0
"20230204EVEARS",2023-02-04,"England Premier League","Everton","Arsenal",1,0,"H",12,15,4,3,13,8,7,5,4,1,0,0,0,0,0,1,27,7,21,12,5,0
"20230204ASTLEI",2023-02-04,"England Premier League","Aston Villa","Leicester",2,4,"A",19,9,4,5,10,10,11,3,0,2,0,0,0,0,0,6,28,9,20,14,2,0
"20230204BRESOU",2023-02-04,"England Premier League","Brentford","Southampton",3,0,"H",14,14,4,6,10,9,4,4,1,2,0,0,0,0,0,3,28,10,19,8,3,0
"20230204BRIBOU",2023-02-04,"England Premier League","Brighton","Bournemouth",1,0,"H",20,12,6,2,14,7,7,3,3,1,0,0,0,0,0,1,32,8,21,10,4,0
"20230204MANCRY",2023-02-04,"England Premier League","Man United","Crystal Palace",2,1,"H",14,10,5,3,9,9,5,5,1,2,1,0,0,0,0,3,24,8,18,10,3,1
"20230204WOLLIV",2023-02-04,"England Premier League","Wolves","Liverpool",3,0,"H",12,22,6,4,9,7,2,7,1,1,0,0,0,0,0,3,34,10,16,9,2,0
"20230204NEWWES",2023-02-04,"England Premier League","Newcastle","West Ham",1,1,"D",8,10,2,1,11,13,4,2,2,1,0,0,0,0,0,2,18,3,24,6,3,0
"20230205NOTLEE",2023-02-05,"England Premier League","Nott'm Forest","Leeds",1,0,"H",6,10,2,4,15,14,0,2,4,2,0,0,0,0,0,1,16,6,29,2,6,0
"20230205TOTMAN",2023-02-05,"England Premier League","Tottenham","Man City",1,0,"H",12,15,3,5,19,14,4,6,2,3,1,0,0,0,0,1,27,8,33,10,5,1
"20230208MANLEE",2023-02-08,"England Premier League","Man United","Leeds",2,2,"D",24,8,7,2,7,11,6,5,1,3,0,0,0,0,0,4,32,9,18,11,4,0
"20230211WESCHE",2023-02-11,"England Premier League","West Ham","Chelsea",1,1,"D",10,12,2,4,9,11,5,6,1,1,0,0,0,0,0,2,22,6,20,11,2,0
"20230211ARSBRE",2023-02-11,"England Premier League","Arsenal","Brentford",1,1,"D",23,9,7,2,9,9,7,4,0,2,0,0,0,0,0,2,32,9,18,11,2,0
"20230211CRYBRI",2023-02-11,"England Premier League","Crystal Palace","Brighton",1,1,"D",6,17,1,7,10,11,1,6,4,1,0,0,0,0,0,2,23,8,21,7,5,0
"20230211FULNOT",2023-02-11,"England Premier League","Fulham","Nott'm Forest",2,0,"H",16,10,3,1,9,11,5,4,0,1,0,0,0,0,0,2,26,4,20,9,1,0
"20230211LEITOT",2023-02-11,"England Premier League","Leicester","Tottenham",4,1,"H",15,11,7,4,14,9,1,5,5,2,0,0,0,0,0,5,26,11,23,6,7,0
"20230211SOUWOL",2023-02-11,"England Premier League","Southampton","Wolves",1,2,"A",17,11,2,2,12,14,5,2,2,2,0,1,1,0,1,3,28,4,26,7,4,1
"20230211BOUNEW",2023-02-11,"England Premier League","Bournemouth","Newcastle",1,1,"D",11,15,5,7,8,10,4,6,2,3,0,0,0,0,0,2,26,12,18,10,5,0
"20230212LEEMAN",2023-02-12,"England Premier League","Leeds","Man United",0,2,"A",16,11,6,5,10,13,7,3,2,1,0,0,0,0,0,2,27,11,23,10,3,0
"20230212MANAST",2023-02-12,"England Premier League","Man City","Aston Villa",3,1,"H",17,6,9,2,13,14,8,4,1,2,0,0,0,0,0,4,23,11,27,12,3,0
"20230213LIVEVE",2023-02-13,"England Premier League","Liverpool","Everton",2,0,"H",15,6,6,1,8,16,3,3,1,3,0,0,0,0,0,2,21,7,24,6,4,0
"20230215ARSMAN",2023-02-15,"England Premier League","Arsenal","Man City",1,3,"A",10,9,1,6,11,15,1,3,2,3,0,0,0,0,0,4,19,7,26,4,5,0
"20230218ASTARS",2023-02-18,"England Premier League","Aston Villa","Arsenal",2,4,"A",7,20,5,5,13,4,2,9,2,1,0,0,0,0,0,6,27,10,17,11,3,0
"20230218BRECRY",2023-02-18,"England Premier League","Brentford","Crystal Palace",1,1,"D",12,10,5,4,10,8,2,6,2,2,0,0,0,0,0,2,22,9,18,8,4,0
"20230218BRIFUL",2023-02-18,"England Premier League","Brighton","Fulham",0,1,"A",21,5,7,2,12,14,10,2,0,5,0,0,0,0,0,1,26,9,26,12,5,0
"20230218CHESOU",2023-02-18,"England Premier League","Chelsea","Southampton",0,1,"A",17,8,5,5,16,24,8,2,3,6,0,0,0,0,0,1,25,10,40,10,9,0
"20230218EVELEE",2023-02-18,"England Premier League","Everton","Leeds",1,0,"H",15,8,6,0,8,6,6,4,2,3,0,0,0,0,0,1,23,6,14,10,5,0
"20230218NOTMAN",2023-02-18,"England Premier League","Nott'm Forest","Man City",1,1,"D",4,26,1,6,8,6,0,10,1,0,0,0,0,0,0,2,30,7,14,10,1,0
"20230218WOLBOU",2023-02-18,"England Premier League","Wolves","Bournemouth",0,1,"A",15,5,4,1,12,10,12,2,3,3,0,0,0,0,0,1,20,5,22,14,6,0
"20230218NEWLIV",2023-02-18,"England Premier League","Newcastle","Liverpool",0,2,"A",14,13,4,7,3,8,6,7,1,1,1,0,0,0,0,2,27,11,11,13,2,1
"20230219MANLEI",2023-02-19,"England Premier League","Man United","Leicester",3,0,"H",26,19,8,3,9,9,6,6,0,2,0,0,0,0,0,3,45,11,18,12,2,0
"20230219TOTWES",2023-02-19,"England Premier League","Tottenham","West Ham",2,0,"H",16,6,6,1,16,10,4,7,2,1,0,0,0,0,0,2,22,7,26,11,3,0
"20230224FULWOL",2023-02-24,"England Premier League","Fulham","Wolves",1,1,"D",10,8,5,2,12,17,4,3,2,0,0,0,0,0,0,2,18,7,29,7,2,0
"20230225EVEAST",2023-02-25,"England Premier League","Everton","Aston Villa",0,2,"A",15,9,5,5,12,12,5,1,2,1,0,0,0,0,0,2,24,10,24,6,3,0
"20230225LEESOU",2023-02-25,"England Premier League","Leeds","Southampton",1,0,"H",14,8,4,2,15,13,9,2,2,4,0,0,0,0,0,1,22,6,28,11,6,0
"20230225LEIARS",2023-02-25,"England Premier League","Leicester","Arsenal",0,1,"A",1,10,0,2,14,9,0,8,0,1,0,0,0,0,0,1,11,2,23,8,1,0
"20230225WESNOT",2023-02-25,"England Premier League","West Ham","Nott'm Forest",4,0,"H",18,8,5,3,8,5,12,3,0,0,0,0,0,0,0,4,26,8,13,15,0,0
"20230225BOUMAN",2023-02-25,"England Premier League","Bournemouth","Man City",1,4,"A",13,20,2,5,10,9,4,6,2,2,0,0,1,0,1,5,33,7,19,10,4,0
"20230225CRYLIV",2023-02-25,"England Premier League","Crystal Palace","Liverpool",0,0,"D",6,12,0,4,11,14,5,3,2,5,0,0,0,0,0,0,18,4,25,8,7,0
"20230226TOTCHE",2023-02-26,"England Premier League","Tottenham","Chelsea",2,0,"H",8,10,3,2,10,10,4,4,2,3,0,0,0,0,0,2,18,5,20,8,5,0
"20230301ARSEVE",2023-03-01,"England Premier League","Arsenal","Everton",4,0,"H",15,8,5,5,5,12,5,1,0,2,0,0,0,0,0,4,23,10,17,6,2,0
"20230301LIVWOL",2023-03-01,"England Premier League","Liverpool","Wolves",2,0,"H",15,4,6,1,13,14,5,2,2,3,0,0,0,0,0,2,19,7,27,7,5,0
"20230304MANNEW",2023-03-04,"England Premier League","Man City","Newcastle",2,0,"H",11,5,3,2,8,13,8,4,2,4,0,0,0,0,0,2,16,5,21,12,6,0
"20230304ARSBOU",2023-03-04,"England Premier League","Arsenal","Bournemouth",3,2,"H",31,4,9,4,6,8,17,1,0,2,0,0,0,0,0,5,35,13,14,18,2,0
"20230304ASTCRY",2023-03-04,"England Premier League","Aston Villa","Crystal Palace",1,0,"H",8,3,1,0,14,17,2,4,2,3,0,1,0,0,0,1,11,1,31,6,5,1
"20230304BRIWES",2023-03-04,"England Premier League","Brighton","West Ham",4,0,"H",20,3,9,2,6,8,7,3,0,3,0,0,0,0,0,4,23,11,14,10,3,0
"20230304CHELEE",2023-03-04,"England Premier League","Chelsea","Leeds",1,0,"H",13,11,3,2,10,7,5,7,2,0,0,0,0,0,0,1,24,5,17,12,2,0
"20230304WOLTOT",2023-03-04,"England Premier League","Wolves","Tottenham",1,0,"H",8,21,5,6,11,18,4,8,1,1,0,0,0,0,0,1,29,11,29,12,2,0
"20230304SOULEI",2023-03-04,"England Premier League","Southampton","Leicester",1,0,"H",11,11,5,0,12,11,3,4,4,2,0,0,0,0,0,1,22,5,23,7,6,0
"20230305NOTEVE",2023-03-05,"England Premier League","Nott'm Forest","Everton",2,2,"D",10,10,4,3,11,17,3,3,3,5,0,0,0,0,0,4,20,7,28,6,8,0
"20230305LIVMAN",2023-03-05,"England Premier League","Liverpool","Man United",7,0,"H",18,8,8,4,13,14,4,3,2,3,0,0,0,0,0,7,26,12,27,7,5,0
"20230306BREFUL",2023-03-06,"England Premier League","Brentford","Fulham",3,2,"H",14,9,6,5,12,17,2,3,0,3,0,0,0,0,0,5,23,11,29,5,3,0
"20230311BOULIV",2023-03-11,"England Premier League","Bournemouth","Liverpool",1,0,"H",5,15,2,6,7,9,3,8,2,1,0,0,0,0,0,1,20,8,16,11,3,0
"20230311EVEBRE",2023-03-11,"England Premier League","Everton","Brentford",1,0,"H",13,12,6,4,11,12,5,8,2,1,0,0,0,0,0,1,25,10,23,13,3,0
"20230311LEEBRI",2023-03-11,"England Premier League","Leeds","Brighton",2,2,"D",12,14,4,2,12,9,4,7,1,1,0,0,0,0,0,4,26,6,21,11,2,0
"20230311LEICHE",2023-03-11,"England Premier League","Leicester","Chelsea",1,3,"A",17,12,7,6,10,11,2,5,1,2,1,0,0,0,0,4,29,13,21,7,3,1
"20230311TOTNOT",2023-03-11,"England Premier League","Tottenham","Nott'm Forest",3,1,"H",15,9,7,5,13,13,2,10,3,1,0,0,0,0,0,4,24,12,26,12,4,0
"20230311CRYMAN",2023-03-11,"England Premier League","Crystal Palace","Man City",0,1,"A",4,14,0,4,11,17,2,6,2,2,0,0,0,0,0,1,18,4,28,8,4,0
"20230312FULARS",2023-03-12,"England Premier League","Fulham","Arsenal",0,3,"A",12,15,2,7,10,9,4,8,0,1,0,0,0,0,0,3,27,9,19,12,1,0
"20230312MANSOU",2023-03-12,"England Premier League","Man United","Southampton",0,0,"D",10,17,4,4,12,9,7,8,2,0,0,0,0,0,0,0,27,8,21,15,2,0
"20230312WESAST",2023-03-12,"England Premier League","West Ham","Aston Villa",1,1,"D",17,12,6,4,8,6,13,2,1,0,0,0,0,0,0,2,29,10,14,15,1,0
"20230312NEWWOL",2023-03-12,"England Premier League","Newcastle","Wolves",2,1,"H",19,7,8,4,11,10,10,3,1,2,0,0,0,0,0,3,26,12,21,13,3,0
"20230315BRICRY",2023-03-15,"England Premier League","Brighton","Crystal Palace",1,0,"H",11,11,5,3,13,20,1,4,1,2,0,0,0,0,0,1,22,8,33,5,3,0
"20230315SOUBRE",2023-03-15,"England Premier League","Southampton","Brentford",0,2,"A",7,11,1,5,14,10,3,3,1,2,0,0,0,0,0,2,18,6,24,6,3,0
"20230317NOTNEW",2023-03-17,"England Premier League","Nott'm Forest","Newcastle",1,2,"A",5,15,3,4,17,9,3,7,5,1,0,0,0,0,0,3,20,7,26,10,6,0
"20230318ASTBOU",2023-03-18,"England Premier League","Aston Villa","Bournemouth",3,0,"H",20,10,9,3,8,13,9,6,1,4,0,0,0,0,0,3,30,12,21,15,5,0
"20230318BRELEI",2023-03-18,"England Premier League","Brentford","Leicester",1,1,"D",11,14,2,1,10,11,8,4,1,2,1,0,0,0,0,2,25,3,21,12,3,1
"20230318SOUTOT",2023-03-18,"England Premier League","Southampton","Tottenham",3,3,"D",19,17,7,3,13,8,10,3,1,1,0,0,0,0,0,6,36,10,21,13,2,0
"20230318WOLLEE",2023-03-18,"England Premier League","Wolves","Leeds",2,4,"A",23,11,8,4,15,9,5,4,3,5,1,0,0,0,0,6,34,12,24,9,8,1
"20230318CHEEVE",2023-03-18,"England Premier League","Chelsea","Everton",2,2,"D",20,12,7,3,8,12,8,2,2,2,0,0,0,0,0,4,32,10,20,10,4,0
"20230319ARSCRY",2023-03-19,"England Premier League","Arsenal","Crystal Palace",4,1,"H",15,8,5,4,8,10,5,4,0,1,0,0,0,0,0,5,23,9,18,9,1,0
"20230401MANLIV",2023-04-01,"England Premier League","Man City","Liverpool",4,1,"H",17,4,8,1,9,12,7,1,1,1,0,0,0,0,0,5,21,9,21,8,2,0
"20230401ARSLEE",2023-04-01,"England Premier League","Arsenal","Leeds",4,1,"H",13,7,6,5,11,13,4,3,0,2,0,0,0,0,0,5,20,11,24,7,2,0
"20230401BOUFUL",2023-04-01,"England Premier League","Bournemouth","Fulham",2,1,"H",12,10,7,2,15,13,4,3,1,4,0,0,0,0,0,3,22,9,28,7,5,0
"20230401BRIBRE",2023-04-01,"England Premier League","Brighton","Brentford",3,3,"D",33,7,15,5,16,10,14,0,2,1,0,0,0,0,0,6,40,20,26,14,3,0
"20230401CRYLEI",2023-04-01,"England Premier League","Crystal Palace","Leicester",2,1,"H",31,3,9,2,12,16,10,1,3,4,0,0,0,0,0,3,34,11,28,11,7,0
"20230401NOTWOL",2023-04-01,"England Premier League","Nott'm Forest","Wolves",1,1,"D",17,8,7,1,14,13,4,3,3,5,0,0,0,0,0,2,25,8,27,7,8,0
"20230401CHEAST",2023-04-01,"England Premier League","Chelsea","Aston Villa",0,2,"A",27,5,8,2,14,16,13,2,3,3,0,0,0,0,0,2,32,10,30,15,6,0
"20230402WESSOU",2023-04-02,"England Premier League","West Ham","Southampton",1,0,"H",12,9,2,3,10,11,5,3,0,2,0,0,0,0,0,1,21,5,21,8,2,0
"20230402NEWMAN",2023-04-02,"England Premier League","Newcastle","Man United",2,0,"H",22,6,6,1,8,12,7,4,0,0,0,0,0,0,0,2,28,7,20,11,0,0
"20230403EVETOT",2023-04-03,"England Premier League","Everton","Tottenham",1,1,"D",15,8,6,2,10,14,3,3,0,3,1,1,0,0,0,2,23,8,24,6,3,2
"20230404BOUBRI",2023-04-04,"England Premier League","Bournemouth","Brighton",0,2,"A",14,16,3,6,11,5,5,5,1,1,0,0,0,0,0,2,30,9,16,10,2,0
"20230404LEENOT",2023-04-04,"England Premier League","Leeds","Nott'm Forest",2,1,"H",21,13,6,1,11,13,11,4,1,4,0,0,0,0,0,3,34,7,24,15,5,0
"20230404LEIAST",2023-04-04,"England Premier League","Leicester","Aston Villa",1,2,"A",9,15,4,5,10,14,4,8,2,0,1,0,0,0,0,3,24,9,24,12,2,1
"20230404CHELIV",2023-04-04,"England Premier League","Chelsea","Liverpool",0,0,"D",12,7,3,4,6,17,3,5,1,4,0,0,0,0,0,0,19,7,23,8,5,0
"20230405MANBRE",2023-04-05,"England Premier League","Man United","Brentford",1,0,"H",18,6,3,1,8,13,12,3,3,2,0,0,0,0,0,1,24,4,21,15,5,0
"20230405WESNEW",2023-04-05,"England Premier League","West Ham","Newcastle",1,5,"A",7,15,2,8,11,12,7,6,2,1,0,0,0,0,0,6,22,10,23,13,3,0
"20230408MANEVE",2023-04-08,"England Premier League","Man United","Everton",2,0,"H",29,15,11,1,10,9,10,4,0,0,0,0,0,0,0,2,44,12,19,14,0,0
"20230408ASTNOT",2023-04-08,"England Premier League","Aston Villa","Nott'm Forest",2,0,"H",8,6,3,2,7,17,1,8,3,4,0,0,0,0,0,2,14,5,24,9,7,0
"20230408BRENEW",2023-04-08,"England Premier League","Brentford","Newcastle",1,2,"A",12,10,6,4,10,15,6,5,0,0,0,0,0,0,0,3,22,10,25,11,0,0
"20230408FULWES",2023-04-08,"England Premier League","Fulham","West Ham",0,1,"A",16,9,3,5,10,12,11,4,1,1,0,0,0,0,0,1,25,8,22,15,2,0
"20230408LEIBOU",2023-04-08,"England Premier League","Leicester","Bournemouth",0,1,"A",14,19,4,7,10,13,6,6,0,3,0,0,0,0,0,1,33,11,23,12,3,0
"20230408TOTBRI",2023-04-08,"England Premier League","Tottenham","Brighton",2,1,"H",9,17,3,4,15,15,3,7,3,1,0,0,0,0,0,3,26,7,30,10,4,0
"20230408WOLCHE",2023-04-08,"England Premier League","Wolves","Chelsea",1,0,"H",9,13,4,1,14,10,8,8,2,5,0,0,0,0,0,1,22,5,24,16,7,0
"20230408SOUMAN",2023-04-08,"England Premier League","Southampton","Man City",1,4,"A",4,13,1,8,6,10,0,10,0,2,0,0,0,0,0,5,17,9,16,10,2,0
"20230409LEECRY",2023-04-09,"England Premier League","Leeds","Crystal Palace",1,5,"A",11,16,7,8,11,8,2,4,3,1,0,0,0,0,0,6,27,15,19,6,4,0
"20230409LIVARS",2023-04-09,"England Premier League","Liverpool","Arsenal",2,2,"D",21,9,6,5,11,11,5,4,4,4,0,0,0,0,0,4,30,11,22,9,8,0
"20230415ASTNEW",2023-04-15,"England Premier League","Aston Villa","Newcastle",3,0,"H",16,8,6,2,13,15,7,2,1,1,0,0,0,0,0,3,24,8,28,9,2,0
"20230415CHEBRI",2023-04-15,"England Premier League","Chelsea","Brighton",1,2,"A",8,26,2,10,11,11,2,8,2,2,0,0,0,0,0,3,34,12,22,10,4,0
"20230415EVEFUL",2023-04-15,"England Premier League","Everton","Fulham",1,3,"A",15,21,7,7,10,6,4,8,3,2,0,0,0,0,0,4,36,14,16,12,5,0
"20230415SOUCRY",2023-04-15,"England Premier League","Southampton","Crystal Palace",0,2,"A",11,9,4,2,6,13,6,2,3,1,0,0,0,0,0,2,20,6,19,8,4,0
"20230415TOTBOU",2023-04-15,"England Premier League","Tottenham","Bournemouth",2,3,"A",24,6,8,6,8,9,8,1,1,2,0,0,0,0,0,5,30,14,17,9,3,0
"20230415WOLBRE",2023-04-15,"England Premier League","Wolves","Brentford",2,0,"H",11,10,9,3,12,8,5,2,1,1,0,0,0,0,0,2,21,12,20,7,2,0
"20230415MANLEI",2023-04-15,"England Premier League","Man City","Leicester",3,1,"H",12,10,4,4,8,8,6,2,1,1,0,0,0,0,0,4,22,8,16,8,2,0
"20230416WESARS",2023-04-16,"England Premier League","West Ham","Arsenal",2,2,"D",16,11,3,5,11,8,7,2,1,2,0,0,0,0,0,4,27,8,19,9,3,0
"20230416NOTMAN",2023-04-16,"England Premier League","Nott'm Forest","Man United",0,2,"A",6,22,0,8,9,9,4,9,2,2,0,0,0,0,0,2,28,8,18,13,4,0
"20230417LEELIV",2023-04-17,"England Premier League","Leeds","Liverpool",1,6,"A",13,13,3,7,6,12,4,2,0,1,0,0,0,0,0,7,26,10,18,6,1,0
"20230421ARSSOU",2023-04-21,"England Premier League","Arsenal","Southampton",3,3,"D",25,8,6,6,10,14,7,2,1,5,0,0,0,0,0,6,33,12,24,9,6,0
"20230422FULLEE",2023-04-22,"England Premier League","Fulham","Leeds",2,1,"H",12,10,5,2,10,15,8,6,1,4,0,0,0,0,0,3,22,7,25,14,5,0
"20230422BREAST",2023-04-22,"England Premier League","Brentford","Aston Villa",1,1,"D",6,14,5,2,12,8,8,4,3,2,0,0,0,0,0,2,20,7,20,12,5,0
"20230422CRYEVE",2023-04-22,"England Premier League","Crystal Palace","Everton",0,0,"D",12,10,2,5,12,14,8,1,1,1,0,1,0,0,0,0,22,7,26,9,2,1
"20230422LEIWOL",2023-04-22,"England Premier League","Leicester","Wolves",2,1,"H",15,16,8,3,17,16,1,7,1,3,0,0,0,0,0,3,31,11,33,8,4,0
"20230422LIVNOT",2023-04-22,"England Premier League","Liverpool","Nott'm Forest",3,2,"H",18,11,6,5,9,12,9,3,0,1,0,0,0,0,0,5,29,11,21,12,1,0
"20230423BOUWES",2023-04-23,"England Premier League","Bournemouth","West Ham",0,4,"A",17,18,5,10,7,8,8,5,1,2,0,0,0,0,0,4,35,15,15,13,3,0
"20230423NEWTOT",2023-04-23,"England Premier League","Newcastle","Tottenham",6,1,"H",25,11,8,3,7,13,9,3,0,3,0,0,0,0,0,7,36,11,20,12,3,0
"20230425WOLCRY",2023-04-25,"England Premier League","Wolves","Crystal Palace",2,0,"H",9,14,3,4,13,14,6,11,5,4,0,0,0,0,0,2,23,7,27,17,9,0
"20230425ASTFUL",2023-04-25,"England Premier League","Aston Villa","Fulham",1,0,"H",14,1,3,0,6,18,8,2,3,2,0,0,0,0,0,1,15,3,24,10,5,0
"20230425LEELEI",2023-04-25,"England Premier League","Leeds","Leicester",1,1,"D",13,15,3,3,14,15,3,6,4,2,0,0,0,0,0,2,28,6,29,9,6,0
"20230426NOTBRI",2023-04-26,"England Premier League","Nott'm Forest","Brighton",3,1,"H",12,17,5,7,7,8,2,7,2,0,0,0,0,0,0,4,29,12,15,9,2,0
"20230426CHEBRE",2023-04-26,"England Premier League","Chelsea","Brentford",0,2,"A",15,7,4,1,5,13,5,2,1,2,0,0,0,0,0,2,22,5,18,7,3,0
"20230426WESLIV",2023-04-26,"England Premier League","West Ham","Liverpool",1,2,"A",7,20,2,4,6,8,3,6,0,0,0,0,0,0,0,3,27,6,14,9,0,0
"20230426MANARS",2023-04-26,"England Premier League","Man City","Arsenal",4,1,"H",14,8,9,2,13,13,1,3,3,1,0,0,1,1,0,5,22,11,26,4,4,0
"20230427EVENEW",2023-04-27,"England Premier League","Everton","Newcastle",1,4,"A",13,15,5,8,8,6,3,14,2,1,0,0,0,0,0,5,28,13,14,17,3,0
"20230427SOUBOU",2023-04-27,"England Premier League","Southampton","Bournemouth",0,1,"A",11,16,2,2,9,11,6,4,0,3,0,0,0,0,0,1,27,4,20,10,3,0
"20230427TOTMAN",2023-04-27,"England Premier League","Tottenham","Man United",2,2,"D",18,17,7,8,8,7,6,8,1,2,0,0,0,0,0,4,35,15,15,14,3,0
"20230429CRYWES",2023-04-29,"England Premier League","Crystal Palace","West Ham",4,3,"H",16,8,6,4,9,17,8,5,1,2,0,0,0,0,0,7,24,10,26,13,3,0
"20230429BRENOT",2023-04-29,"England Premier League","Brentford","Nott'm Forest",2,1,"H",14,5,8,3,6,13,6,0,1,2,0,0,0,0,0,3,19,11,19,6,3,0
"20230429BRIWOL",2023-04-29,"England Premier League","Brighton","Wolves",6,0,"H",22,10,8,2,14,11,2,5,1,1,0,0,0,0,0,6,32,10,25,7,2,0
"20230430BOULEE",2023-04-30,"England Premier League","Bournemouth","Leeds",4,1,"H",12,15,7,6,12,14,2,6,1,0,0,0,0,0,0,5,27,13,26,8,1,0
"20230430FULMAN",2023-04-30,"England Premier League","Fulham","Man City",1,2,"A",4,12,1,9,9,10,2,5,1,3,0,0,0,0,0,3,16,10,19,7,4,0
"20230430MANAST",2023-04-30,"England Premier League","Man United","Aston Villa",1,0,"H",14,7,6,1,16,7,1,4,2,0,0,0,1,0,1,1,21,7,23,5,2,0
"20230430NEWSOU",2023-04-30,"England Premier League","Newcastle","Southampton",3,1,"H",22,4,5,3,7,10,11,2,1,4,0,0,0,0,0,4,26,8,17,13,5,0
"20230430LIVTOT",2023-04-30,"England Premier League","Liverpool","Tottenham",4,3,"H",12,10,4,7,12,6,5,2,3,2,0,0,0,0,0,7,22,11,18,7,5,0
"20230501LEIEVE",2023-05-01,"England Premier League","Leicester","Everton",2,2,"D",15,23,6,8,10,12,2,9,4,1,0,0,0,0,0,4,38,14,22,11,5,0
"20230502ARSCHE",2023-05-02,"England Premier League","Arsenal","Chelsea",3,1,"H",16,7,10,4,10,10,7,2,0,2,0,0,0,0,0,4,23,14,20,9,2,0
"20230503LIVFUL",2023-05-03,"England Premier League","Liverpool","Fulham",1,0,"H",15,9,3,3,10,8,7,5,0,0,0,0,0,0,0,1,24,6,18,12,0,0
"20230503MANWES",2023-05-03,"England Premier League","Man City","West Ham",3,0,"H",16,6,7,2,8,8,6,3,0,1,0,0,0,0,0,3,22,9,16,9,1,0
"20230504BRIMAN",2023-05-04,"England Premier League","Brighton","Man United",1,0,"H",22,16,6,5,10,14,8,6,4,4,0,0,0,0,0,1,38,11,24,14,8,0
"20230506BOUCHE",2023-05-06,"England Premier League","Bournemouth","Chelsea",1,3,"A",10,11,4,5,9,11,7,7,1,3,0,0,0,0,0,4,21,9,20,14,4,0
"20230506MANLEE",2023-05-06,"England Premier League","Man City","Leeds",2,1,"H",18,4,6,2,3,16,10,1,0,3,0,0,0,0,0,3,22,8,19,11,3,0
"20230506TOTCRY",2023-05-06,"England Premier League","Tottenham","Crystal Palace",1,0,"H",8,7,3,2,15,14,8,4,3,5,0,0,0,0,0,1,15,5,29,12,8,0
"20230506WOLAST",2023-05-06,"England Premier League","Wolves","Aston Villa",1,0,"H",6,16,2,3,20,9,5,6,3,3,0,0,0,0,0,1,22,5,29,11,6,0
"20230506LIVBRE",2023-05-06,"England Premier League","Liverpool","Brentford",1,0,"H",15,5,5,1,19,10,7,3,4,2,0,0,0,0,0,1,20,6,29,10,6,0
"20230507NEWARS",2023-05-07,"England Premier League","Newcastle","Arsenal",0,2,"A",12,10,5,6,16,12,9,4,2,1,0,0,0,0,0,2,22,11,28,13,3,0
"20230507WESMAN",2023-05-07,"England Premier League","West Ham","Man United",1,0,"H",15,19,4,4,4,9,5,6,0,2,0,0,0,0,0,1,34,8,13,11,2,0
"20230508FULLEI",2023-05-08,"England Premier League","Fulham","Leicester",5,3,"H",17,18,7,9,13,15,2,7,0,3,0,0,0,0,0,8,35,16,28,9,3,0
"20230508BRIEVE",2023-05-08,"England Premier League","Brighton","Everton",1,5,"A",23,10,5,5,11,13,15,1,1,5,0,0,0,0,0,6,33,10,24,16,6,0
"20230508NOTSOU",2023-05-08,"England Premier League","Nott'm Forest","Southampton",4,3,"H",9,19,4,5,16,10,2,11,1,0,0,0,0,0,0,7,28,9,26,13,1,0
"20230513LEENEW",2023-05-13,"England Premier League","Leeds","Newcastle",2,2,"D",9,18,4,5,16,14,2,6,3,2,1,0,0,0,0,4,27,9,30,8,5,1
"20230513ASTTOT",2023-05-13,"England Premier League","Aston Villa","Tottenham",2,1,"H",8,5,4,2,9,14,8,3,3,3,0,0,0,0,0,3,13,6,23,11,6,0
"20230513CHENOT",2023-05-13,"England Premier League","Chelsea","Nott'm Forest",2,2,"D",14,11,6,2,13,15,2,5,3,1,0,0,0,0,0,4,25,8,28,7,4,0
"20230513CRYBOU",2023-05-13,"England Premier League","Crystal Palace","Bournemouth",2,0,"H",17,5,5,0,5,12,11,2,0,2,0,0,0,0,0,2,22,5,17,13,2,0
"20230513MANWOL",2023-05-13,"England Premier League","Man United","Wolves",2,0,"H",27,5,9,0,9,9,11,7,3,2,0,0,0,0,0,2,32,9,18,18,5,0
"20230513SOUFUL",2023-05-13,"England Premier League","Southampton","Fulham",0,2,"A",5,9,1,4,17,12,1,8,2,0,0,0,0,0,0,2,14,5,29,9,2,0
"20230514BREWES",2023-05-14,"England Premier League","Brentford","West Ham",2,0,"H",24,4,10,4,5,5,7,5,1,0,0,0,0,0,0,2,28,14,10,12,1,0
"20230514EVEMAN",2023-05-14,"England Premier League","Everton","Man City",0,3,"A",7,9,3,4,12,4,8,6,1,0,0,0,0,0,0,3,16,7,16,14,1,0
"20230514ARSBRI",2023-05-14,"England Premier League","Arsenal","Brighton",0,3,"A",14,12,2,6,13,17,5,2,1,2,0,0,0,0,0,3,26,8,30,7,3,0
"20230515LEILIV",2023-05-15,"England Premier League","Leicester","Liverpool",0,3,"A",4,16,4,5,11,17,4,4,2,1,0,0,0,0,0,3,20,9,28,8,3,0
"20230518NEWBRI",2023-05-18,"England Premier League","Newcastle","Brighton",4,1,"H",22,8,9,2,17,16,6,1,2,4,0,0,0,0,0,5,30,11,33,7,6,0
"20230520TOTBRE",2023-05-20,"England Premier League","Tottenham","Brentford",1,3,"A",22,11,8,4,11,9,8,2,1,1,0,0,0,0,0,4,33,12,20,10,2,0
"20230520BOUMAN",2023-05-20,"England Premier League","Bournemouth","Man United",0,1,"A",10,20,4,5,6,7,3,6,1,0,0,0,0,0,0,1,30,9,13,9,1,0
"20230520FULCRY",2023-05-20,"England Premier League","Fulham","Crystal Palace",2,2,"D",11,11,4,5,13,12,7,4,3,0,0,0,0,0,0,4,22,9,25,11,3,0
"20230520LIVAST",2023-05-20,"England Premier League","Liverpool","Aston Villa",1,1,"D",10,6,5,3,16,13,9,4,3,5,0,0,0,0,0,2,16,8,29,13,8,0
"20230520WOLEVE",2023-05-20,"England Premier League","Wolves","Everton",1,1,"D",13,19,5,4,18,10,1,7,5,1,0,0,0,0,0,2,32,9,28,8,6,0
"20230520NOTARS",2023-05-20,"England Premier League","Nott'm Forest","Arsenal",1,0,"H",6,11,2,3,11,12,3,6,3,2,0,0,0,0,0,1,17,5,23,9,5,0
"20230521WESLEE",2023-05-21,"England Premier League","West Ham","Leeds",3,1,"H",19,12,9,3,6,11,9,5,1,3,0,0,0,0,0,4,31,12,17,14,4,0
"20230521BRISOU",2023-05-21,"England Premier League","Brighton","Southampton",3,1,"H",26,5,8,1,8,9,4,3,2,5,0,0,0,0,0,4,31,9,17,7,7,0
"20230521MANCHE",2023-05-21,"England Premier League","Man City","Chelsea",1,0,"H",15,13,2,6,12,9,5,2,0,2,0,0,0,0,0,1,28,8,21,7,2,0
"20230522NEWLEI",2023-05-22,"England Premier League","Newcastle","Leicester",0,0,"D",23,1,4,1,9,5,12,1,2,0,0,0,0,0,0,0,24,5,14,13,2,0
"20230524BRIMAN",2023-05-24,"England Premier League","Brighton","Man City",1,1,"D",20,13,7,4,16,11,5,1,2,1,0,0,0,0,0,2,33,11,27,6,3,0
"20230525MANCHE",2023-05-25,"England Premier League","Man United","Chelsea",4,1,"H",18,14,9,5,12,6,3,4,1,1,0,0,0,0,0,5,32,14,18,7,2,0
"20230528ARSWOL",2023-05-28,"England Premier League","Arsenal","Wolves",5,0,"H",14,6,8,0,8,11,8,4,0,0,0,0,0,0,0,5,20,8,19,12,0,0
"20230528ASTBRI",2023-05-28,"England Premier League","Aston Villa","Brighton",2,1,"H",12,8,5,4,15,16,4,3,4,4,0,0,0,0,0,3,20,9,31,7,8,0
"20230528BREMAN",2023-05-28,"England Premier League","Brentford","Man City",1,0,"H",11,17,4,3,12,8,3,4,4,0,0,0,0,0,0,1,28,7,20,7,4,0
"20230528CHENEW",2023-05-28,"England Premier League","Chelsea","Newcastle",1,1,"D",22,13,5,4,9,11,10,3,0,0,0,0,0,0,0,2,35,9,20,13,0,0
"20230528CRYNOT",2023-05-28,"England Premier League","Crystal Palace","Nott'm Forest",1,1,"D",16,7,4,4,9,13,5,4,0,2,0,0,0,0,0,2,23,8,22,9,2,0
"20230528EVEBOU",2023-05-28,"England Premier League","Everton","Bournemouth",1,0,"H",13,7,6,2,11,12,9,3,1,3,0,0,0,0,0,1,20,8,23,12,4,0
"20230528LEETOT",2023-05-28,"England Premier League","Leeds","Tottenham",1,4,"A",19,11,2,7,7,5,12,3,3,0,0,0,0,0,0,5,30,9,12,15,3,0
"20230528LEIWES",2023-05-28,"England Premier League","Leicester","West Ham",2,1,"H",13,16,4,3,8,10,3,5,1,1,0,0,0,0,0,3,29,7,18,8,2,0
"20230528MANFUL",2023-05-28,"England Premier League","Man United","Fulham",2,1,"H",21,10,8,3,14,10,5,4,1,2,0,0,0,0,0,3,31,11,24,9,3,0
"20230528SOULIV",2023-05-28,"England Premier League","Southampton","Liverpool",4,4,"D",15,30,10,8,4,10,2,9,0,2,0,0,0,0,0,8,45,18,14,11,2,0
"20230811BURMAN",2023-08-11,"England Premier League","Burnley","Man City",0,3,"A",6,17,1,8,11,8,6,5,0,0,1,0,0,0,0,3,23,9,19,11,0,1
"20230812ARSNOT",2023-08-12,"England Premier League","Arsenal","Nott'm Forest",2,1,"H",15,6,7,2,12,12,8,3,2,2,0,0,0,0,0,3,21,9,24,11,4,0
"20230812BOUWES",2023-08-12,"England Premier League","Bournemouth","West Ham",1,1,"D",14,16,5,3,9,14,10,4,1,4,0,0,0,0,0,2,30,8,23,14,5,0
"20230812BRILUT",2023-08-12,"England Premier League","Brighton","Luton",4,1,"H",27,9,12,3,11,12,6,7,2,2,0,0,0,0,0,5,36,15,23,13,4,0
"20230812EVEFUL",2023-08-12,"England Premier League","Everton","Fulham",0,1,"A",19,9,9,2,12,6,10,4,0,2,0,0,0,0,0,1,28,11,18,14,2,0
"20230812SHECRY",2023-08-12,"England Premier League","Sheffield United","Crystal Palace",0,1,"A",8,24,1,8,18,11,5,5,3,0,0,0,0,0,0,1,32,9,29,10,3,0
"20230812NEWAST",2023-08-12,"England Premier League","Newcastle","Aston Villa",5,1,"H",17,16,13,6,12,17,6,5,4,4,0,0,0,0,0,6,33,19,29,11,8,0
"20230813BRETOT",2023-08-13,"England Premier League","Brentford","Tottenham",2,2,"D",11,18,6,6,12,13,3,6,1,4,0,0,0,0,0,4,29,12,25,9,5,0
"20230813CHELIV",2023-08-13,"England Premier League","Chelsea","Liverpool",1,1,"D",10,13,4,1,5,12,4,4,3,3,0,0,0,0,0,2,23,5,17,8,6,0
"20230814MANWOL",2023-08-14,"England Premier League","Man United","Wolves",1,0,"H",15,23,3,6,14,10,8,7,2,3,0,0,0,0,0,1,38,9,24,15,5,0
"20230818NOTSHE",2023-08-18,"England Premier League","Nott'm Forest","Sheffield United",2,1,"H",16,7,4,3,5,9,6,7,2,3,0,0,0,0,0,3,23,7,14,13,5,0
"20230819FULBRE",2023-08-19,"England Premier League","Fulham","Brentford",0,3,"A",10,17,2,8,13,12,5,5,2,2,1,0,0,0,0,3,27,10,25,10,4,1
"20230819LIVBOU",2023-08-19,"England Premier League","Liverpool","Bournemouth",3,1,"H",26,13,10,5,11,13,10,2,1,3,1,0,0,0,0,4,39,15,24,12,4,1
"20230819WOLBRI",2023-08-19,"England Premier League","Wolves","Brighton",1,4,"A",16,16,5,8,14,11,5,3,3,6,1,0,0,0,0,5,32,13,25,8,9,1
"20230819TOTMAN",2023-08-19,"England Premier League","Tottenham","Man United",2,0,"H",17,22,6,6,9,8,5,6,1,3,0,0,0,0,0,2,39,12,17,11,4,0
"20230819MANNEW",2023-08-19,"England Premier League","Man City","Newcastle",1,0,"H",14,7,4,1,12,11,3,0,1,5,0,0,0,0,0,1,21,5,23,3,6,0
"20230820ASTEVE",2023-08-20,"England Premier League","Aston Villa","Everton",4,0,"H",13,9,7,2,8,12,7,6,3,4,0,0,0,0,0,4,22,9,20,13,7,0
"20230820WESCHE",2023-08-20,"England Premier League","West Ham","Chelsea",3,1,"H",12,17,6,4,12,9,3,9,2,3,1,0,0,0,0,4,29,10,21,12,5,1
"20230821CRYARS",2023-08-21,"England Premier League","Crystal Palace","Arsenal",0,1,"A",14,14,2,3,14,10,1,8,2,1,0,1,0,0,0,1,28,5,24,9,3,1
"20230825CHELUT",2023-08-25,"England Premier League","Chelsea","Luton",3,0,"H",19,11,8,1,15,12,6,4,2,3,0,0,0,0,0,3,30,9,27,10,5,0
"20230826BOUTOT",2023-08-26,"England Premier League","Bournemouth","Tottenham",0,2,"A",11,17,3,6,18,11,6,2,1,3,0,0,0,0,0,2,28,9,29,8,4,0
"20230826ARSFUL",2023-08-26,"England Premier League","Arsenal","Fulham",2,2,"D",19,8,11,3,6,5,8,3,0,3,0,1,0,0,0,4,27,14,11,11,3,1
"20230826BRECRY",2023-08-26,"England Premier League","Brentford","Crystal Palace",1,1,"D",12,15,1,5,9,15,8,6,0,0,0,0,0,0,0,2,27,6,24,14,0,0
"20230826EVEWOL",2023-08-26,"England Premier League","Everton","Wolves",0,1,"A",15,11,7,2,10,14,7,0,3,4,0,0,0,0,0,1,26,9,24,7,7,0
"20230826MANNOT",2023-08-26,"England Premier League","Man United","Nott'm Forest",3,2,"H",18,9,9,4,13,11,11,3,4,4,0,1,0,0,0,5,27,13,24,14,8,1
"20230826BRIWES",2023-08-26,"England Premier League","Brighton","West Ham",1,3,"A",25,12,10,3,10,9,17,4,1,3,0,0,0,0,0,4,37,13,19,21,4,0
"20230827BURAST",2023-08-27,"England Premier League","Burnley","Aston Villa",1,3,"A",9,16,2,6,12,11,4,6,2,0,0,0,0,0,0,4,25,8,23,10,2,0
"20230827SHEMAN",2023-08-27,"England Premier League","Sheffield United","Man City",1,2,"A",6,30,2,9,11,2,1,12,3,0,0,0,0,0,0,3,36,11,13,13,3,0
"20230827NEWLIV",2023-08-27,"England Premier League","Newcastle","Liverpool",1,2,"A",23,9,8,4,16,10,5,9,1,2,0,1,0,0,0,3,32,12,26,14,3,1
"20230901LUTWES",2023-09-01,"England Premier League","Luton","West Ham",1,2,"A",16,9,1,3,8,13,9,6,1,1,0,0,0,0,0,3,25,4,21,15,2,0
"20230902SHEEVE",2023-09-02,"England Premier League","Sheffield United","Everton",2,2,"D",13,16,8,6,11,13,4,6,1,2,0,0,0,0,0,4,29,14,24,10,3,0
"20230902BREBOU",2023-09-02,"England Premier League","Brentford","Bournemouth",2,2,"D",21,12,7,5,6,13,5,2,1,2,0,0,0,0,0,4,33,12,19,7,3,0
"20230902BURTOT",2023-09-02,"England Premier League","Burnley","Tottenham",2,5,"A",16,20,4,10,15,9,7,4,4,3,0,0,0,0,0,7,36,14,24,11,7,0
"20230902CHENOT",2023-09-02,"England Premier League","Chelsea","Nott'm Forest",0,1,"A",21,7,2,3,10,9,8,0,3,4,0,0,1,0,1,1,28,5,19,8,7,0
"20230902MANFUL",2023-09-02,"England Premier League","Man City","Fulham",5,1,"H",7,6,5,4,12,12,4,5,2,4,0,0,0,0,0,6,13,9,24,9,6,0
"20230902BRINEW",2023-09-02,"England Premier League","Brighton","Newcastle",3,1,"H",15,9,6,2,14,17,5,3,4,4,0,0,0,0,0,4,24,8,31,8,8,0
"20230903CRYWOL",2023-09-03,"England Premier League","Crystal Palace","Wolves",3,2,"H",16,12,11,4,12,12,4,2,1,3,0,0,0,0,0,5,28,15,24,6,4,0
"20230903LIVAST",2023-09-03,"England Premier League","Liverpool","Aston Villa",3,0,"H",17,9,4,3,12,7,7,3,0,1,0,0,0,0,0,3,26,7,19,10,1,0
"20230903ARSMAN",2023-09-03,"England Premier League","Arsenal","Man United",3,1,"H",17,10,5,2,8,7,12,3,2,3,0,0,0,0,0,4,27,7,15,15,5,0
"20230916WOLLIV",2023-09-16,"England Premier League","Wolves","Liverpool",1,3,"A",11,16,2,6,10,4,4,4,1,3,0,0,0,0,0,4,27,8,14,8,4,0
"20230916ASTCRY",2023-09-16,"England Premier League","Aston Villa","Crystal Palace",3,1,"H",16,6,5,3,13,9,4,2,5,3,0,0,0,0,0,4,22,8,22,6,8,0
"20230916FULLUT",2023-09-16,"England Premier League","Fulham","Luton",1,0,"H",13,7,2,2,6,14,6,2,2,2,0,0,0,0,0,1,20,4,20,8,4,0
"20230916MANBRI",2023-09-16,"England Premier League","Man United","Brighton",1,3,"A",14,10,4,8,8,9,8,1,2,2,0,0,0,0,0,4,24,12,17,9,4,0
"20230916TOTSHE",2023-09-16,"England Premier League","Tottenham","Sheffield United",2,1,"H",28,7,10,5,13,14,15,2,6,5,0,1,0,0,0,3,35,15,27,17,11,1
"20230916WESMAN",2023-09-16,"England Premier League","West Ham","Man City",1,3,"A",6,29,3,15,7,11,4,11,3,2,0,0,0,0,0,4,35,18,18,15,5,0
"20230916NEWBRE",2023-09-16,"England Premier League","Newcastle","Brentford",1,0,"H",9,11,2,2,8,12,8,3,3,5,0,0,0,0,0,1,20,4,20,11,8,0
"20230917BOUCHE",2023-09-17,"England Premier League","Bournemouth","Chelsea",0,0,"D",13,14,4,6,15,20,1,7,1,5,0,0,0,0,0,0,27,10,35,8,6,0
"20230917EVEARS",2023-09-17,"England Premier League","Everton","Arsenal",0,1,"A",8,13,1,4,12,10,1,11,1,1,0,0,0,0,0,1,21,5,22,12,2,0
"20230918NOTBUR",2023-09-18,"England Premier League","Nott'm Forest","Burnley",1,1,"D",14,10,4,3,16,10,5,4,2,3,0,1,0,0,0,2,24,7,26,9,5,1
"20230923CRYFUL",2023-09-23,"England Premier League","Crystal Palace","Fulham",0,0,"D",7,10,3,5,10,15,3,2,3,2,0,0,0,0,0,0,17,8,25,5,5,0
"20230923LUTWOL",2023-09-23,"England Premier League","Luton","Wolves",1,1,"D",20,3,4,3,12,17,10,1,0,2,0,1,0,0,0,2,23,7,29,11,2,1
"20230923MANNOT",2023-09-23,"England Premier League","Man City","Nott'm Forest",2,0,"H",7,10,4,3,5,17,6,6,3,7,1,0,0,0,0,2,17,7,22,12,10,1
"20230923BREEVE",2023-09-23,"England Premier League","Brentford","Everton",1,3,"A",12,18,2,6,9,12,1,4,2,2,0,0,0,0,0,4,30,8,21,5,4,0
"20230923BURMAN",2023-09-23,"England Premier League","Burnley","Man United",0,1,"A",12,11,4,4,6,12,9,5,1,2,0,0,0,0,0,1,23,8,18,14,3,0
"20230924ARSTOT",2023-09-24,"England Premier League","Arsenal","Tottenham",2,2,"D",13,13,6,5,12,19,11,4,3,4,0,0,0,0,0,4,26,11,31,15,7,0
"20230924BRIBOU",2023-09-24,"England Premier League","Brighton","Bournemouth",3,1,"H",13,12,4,4,12,17,4,4,3,3,0,0,0,0,0,4,25,8,29,8,6,0
"20230924CHEAST",2023-09-24,"England Premier League","Chelsea","Aston Villa",0,1,"A",10,15,4,7,9,11,5,11,2,3,0,0,0,0,0,1,25,11,20,16,5,0
"20230924LIVWES",2023-09-24,"England Premier League","Liverpool","West Ham",3,1,"H",22,11,7,4,12,13,7,4,0,2,0,0,0,0,0,4,33,11,25,11,2,0
"20230924SHENEW",2023-09-24,"England Premier League","Sheffield United","Newcastle",0,8,"A",9,22,1,15,12,8,2,6,3,0,0,0,0,0,0,8,31,16,20,8,3,0
"20230930ASTBRI",2023-09-30,"England Premier League","Aston Villa","Brighton",6,1,"H",19,11,9,3,19,21,1,3,4,4,0,0,0,0,0,7,30,12,40,4,8,0
"20230930BOUARS",2023-09-30,"England Premier League","Bournemouth","Arsenal",0,4,"A",8,15,1,8,11,10,6,6,0,1,0,0,0,0,0,4,23,9,21,12,1,0
"20230930EVELUT",2023-09-30,"England Premier League","Everton","Luton",1,2,"A",23,9,5,2,8,10,3,6,0,1,0,0,0,0,0,3,32,7,18,9,1,0
"20230930MANCRY",2023-09-30,"England Premier League","Man United","Crystal Palace",0,1,"A",19,8,4,2,10,8,10,4,3,2,0,0,0,0,0,1,27,6,18,14,5,0
"20230930NEWBUR",2023-09-30,"England Premier League","Newcastle","Burnley",2,0,"H",20,8,8,2,7,15,5,3,1,3,0,0,0,0,0,2,28,10,22,8,4,0
"20230930WESSHE",2023-09-30,"England Premier League","West Ham","Sheffield United",2,0,"H",20,16,9,2,6,9,7,4,1,1,0,0,0,0,0,2,36,11,15,11,2,0
"20230930WOLMAN",2023-09-30,"England Premier League","Wolves","Man City",2,1,"H",3,23,1,8,18,12,0,6,5,4,0,0,0,0,0,3,26,9,30,6,9,0
"20230930TOTLIV",2023-09-30,"England Premier League","Tottenham","Liverpool",2,1,"H",24,12,8,4,11,17,12,5,5,4,0,2,0,0,0,3,36,12,28,17,9,2
"20231001NOTBRE",2023-10-01,"England Premier League","Nott'm Forest","Brentford",1,1,"D",6,18,1,5,6,10,1,11,1,2,1,0,0,0,0,2,24,6,16,12,3,1
"20231002FULCHE",2023-10-02,"England Premier League","Fulham","Chelsea",0,2,"A",10,11,3,4,15,12,8,1,1,4,0,0,0,0,0,2,21,7,27,9,5,0
"20231003LUTBUR",2023-10-03,"England Premier League","Luton","Burnley",1,2,"A",18,14,3,4,14,6,7,6,4,2,0,0,0,0,0,3,32,7,20,13,6,0
"20231007LUTTOT",2023-10-07,"England Premier League","Luton","Tottenham",0,1,"A",12,15,2,4,16,7,5,6,2,1,0,1,0,0,0,1,27,6,23,11,3,1
"20231007BURCHE",2023-10-07,"England Premier League","Burnley","Chelsea",1,4,"A",10,9,3,5,11,8,7,3,2,4,0,0,1,1,0,5,19,8,19,10,6,0
"20231007EVEBOU",2023-10-07,"England Premier League","Everton","Bournemouth",3,0,"H",25,11,8,4,14,15,8,7,1,2,0,0,0,0,0,3,36,12,29,15,3,0
"20231007FULSHE",2023-10-07,"England Premier League","Fulham","Sheffield United",3,1,"H",20,5,6,2,8,10,9,4,1,2,0,0,0,0,0,4,25,8,18,13,3,0
"20231007MANBRE",2023-10-07,"England Premier League","Man United","Brentford",2,1,"H",21,11,8,3,10,17,7,5,0,5,0,0,0,0,0,3,32,11,27,12,5,0
"20231007CRYNOT",2023-10-07,"England Premier League","Crystal Palace","Nott'm Forest",0,0,"D",8,16,2,5,7,12,3,7,0,1,0,0,0,0,0,0,24,7,19,10,1,0
"20231008BRILIV",2023-10-08,"England Premier League","Brighton","Liverpool",2,2,"D",14,14,3,4,12,20,8,1,1,2,0,0,0,0,0,4,28,7,32,9,3,0
"20231008WESNEW",2023-10-08,"England Premier League","West Ham","Newcastle",2,2,"D",5,10,3,3,11,18,4,2,3,3,0,0,0,0,0,4,15,6,29,6,6,0
"20231008WOLAST",2023-10-08,"England Premier League","Wolves","Aston Villa",1,1,"D",8,18,3,4,19,9,2,10,2,2,1,0,1,0,1,2,26,7,28,12,4,1
"20231008ARSMAN",2023-10-08,"England Premier League","Arsenal","Man City",1,0,"H",12,4,2,1,8,7,5,4,2,3,0,0,0,0,0,1,16,3,15,9,5,0
"20231021LIVEVE",2023-10-21,"England Premier League","Liverpool","Everton",2,0,"H",26,6,6,1,9,9,12,4,1,1,0,1,0,0,0,2,32,7,18,16,2,1
"20231021BOUWOL",2023-10-21,"England Premier League","Bournemouth","Wolves",1,2,"A",7,20,4,7,15,10,3,12,2,6,1,0,0,0,0,3,27,11,25,15,8,1
"20231021BREBUR",2023-10-21,"England Premier League","Brentford","Burnley",3,0,"H",23,6,10,1,14,12,5,5,5,2,0,1,0,0,0,3,29,11,26,10,7,1
"20231021MANBRI",2023-10-21,"England Premier League","Man City","Brighton",2,1,"H",10,5,6,3,9,11,2,2,2,2,1,0,0,0,0,3,15,9,20,4,4,1
"20231021NEWCRY",2023-10-21,"England Premier League","Newcastle","Crystal Palace",4,0,"H",10,17,7,3,7,12,6,8,2,3,0,0,0,0,0,4,27,10,19,14,5,0
"20231021NOTLUT",2023-10-21,"England Premier League","Nott'm Forest","Luton",2,2,"D",19,13,8,4,12,11,4,2,3,0,0,0,0,0,0,4,32,12,23,6,3,0
"20231021CHEARS",2023-10-21,"England Premier League","Chelsea","Arsenal",2,2,"D",11,13,5,3,7,14,2,7,3,3,0,0,0,0,0,4,24,8,21,9,6,0
"20231021SHEMAN",2023-10-21,"England Premier League","Sheffield United","Man United",1,2,"A",12,14,6,5,12,10,5,4,3,1,0,0,0,0,0,3,26,11,22,9,4,0
"20231022ASTWES",2023-10-22,"England Premier League","Aston Villa","West Ham",4,1,"H",15,14,7,4,9,15,8,7,0,1,0,0,0,0,0,5,29,11,24,15,1,0
"20231023TOTFUL",2023-10-23,"England Premier League","Tottenham","Fulham",2,0,"H",15,10,5,3,10,14,3,5,2,0,0,0,0,0,0,2,25,8,24,8,2,0
"20231027CRYTOT",2023-10-27,"England Premier League","Crystal Palace","Tottenham",1,2,"A",13,10,3,1,19,11,11,2,2,1,0,0,0,0,0,3,23,4,30,13,3,0
"20231028CHEBRE",2023-10-28,"England Premier League","Chelsea","Brentford",0,2,"A",17,7,2,5,12,7,10,1,1,4,0,0,0,0,0,2,24,7,19,11,5,0
"20231028ARSSHE",2023-10-28,"England Premier League","Arsenal","Sheffield United",5,0,"H",13,2,8,0,9,13,6,1,0,3,0,0,0,0,0,5,15,8,22,7,3,0
"20231028BOUBUR",2023-10-28,"England Premier League","Bournemouth","Burnley",2,1,"H",13,6,6,3,9,12,10,5,2,3,0,0,0,0,0,3,19,9,21,15,5,0
"20231028WOLNEW",2023-10-28,"England Premier League","Wolves","Newcastle",2,2,"D",11,13,6,5,13,15,8,7,1,4,0,0,0,0,0,4,24,11,28,15,5,0
"20231029WESEVE",2023-10-29,"England Premier League","West Ham","Everton",0,1,"A",12,10,2,4,7,11,4,3,4,1,0,0,0,0,0,1,22,6,18,7,5,0
"20231029ASTLUT",2023-10-29,"England Premier League","Aston Villa","Luton",3,1,"H",17,7,6,1,11,10,6,4,3,2,0,0,0,0,0,4,24,7,21,10,5,0
"20231029BRIFUL",2023-10-29,"England Premier League","Brighton","Fulham",1,1,"D",18,10,7,5,12,8,7,3,0,3,0,0,0,0,0,2,28,12,20,10,3,0
"20231029LIVNOT",2023-10-29,"England Premier League","Liverpool","Nott'm Forest",3,0,"H",21,9,8,1,9,13,8,3,2,3,0,0,0,0,0,3,30,9,22,11,5,0
"20231029MANMAN",2023-10-29,"England Premier League","Man United","Man City",0,3,"A",7,21,3,10,9,4,7,12,4,1,0,0,0,0,0,3,28,13,13,19,5,0
"20231104FULMAN",2023-11-04,"England Premier League","Fulham","Man United",0,1,"A",18,12,3,5,9,15,9,4,5,2,0,0,0,0,0,1,30,8,24,13,7,0
"20231104BREWES",2023-11-04,"England Premier League","Brentford","West Ham",3,2,"H",16,12,4,2,12,14,4,3,1,4,0,0,0,0,0,5,28,6,26,7,5,0
"20231104BURCRY",2023-11-04,"England Premier League","Burnley","Crystal Palace",0,2,"A",17,4,5,3,9,12,12,1,0,5,0,0,0,0,0,2,21,8,21,13,5,0
"20231104EVEBRI",2023-11-04,"England Premier League","Everton","Brighton",1,1,"D",10,7,4,2,15,5,3,3,4,2,0,0,0,0,0,2,17,6,20,6,6,0
"20231104MANBOU",2023-11-04,"England Premier League","Man City","Bournemouth",6,1,"H",21,5,8,1,8,9,12,1,0,1,0,0,0,0,0,7,26,9,17,13,1,0
"20231104SHEWOL",2023-11-04,"England Premier League","Sheffield United","Wolves",2,1,"H",11,10,2,3,13,10,4,4,2,3,0,0,0,0,0,3,21,5,23,8,5,0
"20231104NEWARS",2023-11-04,"England Premier League","Newcastle","Arsenal",1,0,"H",9,14,2,1,14,9,0,11,5,1,0,0,0,0,0,1,23,3,23,11,6,0
"20231105NOTAST",2023-11-05,"England Premier League","Nott'm Forest","Aston Villa",2,0,"H",5,13,3,3,6,9,0,10,1,1,0,0,0,0,0,2,18,6,15,10,2,0
"20231105LUTLIV",2023-11-05,"England Premier League","Luton","Liverpool",1,1,"D",8,24,5,6,7,13,4,7,1,1,0,0,0,0,0,2,32,11,20,11,2,0
"20231106TOTCHE",2023-11-06,"England Premier League","Tottenham","Chelsea",1,4,"A",8,17,5,8,12,21,1,6,1,5,2,0,0,0,0,5,25,13,33,7,6,2
"20231111WOLTOT",2023-11-11,"England Premier League","Wolves","Tottenham",2,1,"H",17,6,4,2,19,15,11,3,4,3,0,0,0,0,0,3,23,6,34,14,7,0
"20231111ARSBUR",2023-11-11,"England Premier League","Arsenal","Burnley",3,1,"H",16,8,6,5,8,9,3,3,0,1,1,0,0,0,0,4,24,11,17,6,1,1
"20231111CRYEVE",2023-11-11,"England Premier League","Crystal Palace","Everton",2,3,"A",13,8,4,4,9,18,9,2,1,4,0,0,0,0,0,5,21,8,27,11,5,0
"20231111MANLUT",2023-11-11,"England Premier League","Man United","Luton",1,0,"H",15,10,4,4,9,11,11,3,0,2,0,0,0,0,0,1,25,8,20,14,2,0
"20231111BOUNEW",2023-11-11,"England Premier League","Bournemouth","Newcastle",2,0,"H",19,8,10,5,10,4,6,5,2,1,0,0,0,0,0,2,27,15,14,11,3,0
"20231112ASTFUL",2023-11-12,"England Premier League","Aston Villa","Fulham",3,1,"H",12,9,6,5,4,17,2,2,2,5,0,0,0,0,0,4,21,11,21,4,7,0
"20231112BRISHE",2023-11-12,"England Premier League","Brighton","Sheffield United",1,1,"D",11,9,6,1,13,16,6,3,3,2,1,0,0,0,0,2,20,7,29,9,5,1
"20231112LIVBRE",2023-11-12,"England Premier League","Liverpool","Brentford",3,0,"H",17,16,10,3,16,12,6,8,1,2,0,0,0,0,0,3,33,13,28,14,3,0
"20231112WESNOT",2023-11-12,"England Premier League","West Ham","Nott'm Forest",3,2,"H",16,10,6,5,9,12,9,4,2,2,0,0,0,0,0,5,26,11,21,13,4,0
"20231112CHEMAN",2023-11-12,"England Premier League","Chelsea","Man City",4,4,"D",17,15,9,10,12,15,3,3,5,3,0,0,0,0,0,8,32,19,27,6,8,0
"20231125MANLIV",2023-11-25,"England Premier League","Man City","Liverpool",1,1,"D",16,8,5,3,9,11,9,6,1,3,0,0,0,0,0,2,24,8,20,15,4,0
"20231125BURWES",2023-11-25,"England Premier League","Burnley","West Ham",1,2,"A",11,11,5,3,11,7,4,5,1,3,0,0,0,0,0,3,22,8,18,9,4,0
"20231125LUTCRY",2023-11-25,"England Premier League","Luton","Crystal Palace",2,1,"H",8,16,3,8,15,12,4,5,6,1,0,0,0,0,0,3,24,11,27,9,7,0
"20231125NEWCHE",2023-11-25,"England Premier League","Newcastle","Chelsea",4,1,"H",14,7,5,4,13,19,4,2,4,4,0,1,1,0,1,5,21,9,32,6,8,1
"20231125NOTBRI",2023-11-25,"England Premier League","Nott'm Forest","Brighton",2,3,"A",18,11,5,5,12,7,6,4,2,4,0,1,0,0,0,5,29,10,19,10,6,1
"20231125SHEBOU",2023-11-25,"England Premier League","Sheffield United","Bournemouth",1,3,"A",10,23,2,11,6,8,4,7,4,1,0,0,0,0,0,4,33,13,14,11,5,0
"20231125BREARS",2023-11-25,"England Premier League","Brentford","Arsenal",0,1,"A",9,15,3,4,9,7,1,8,1,1,0,0,0,0,0,1,24,7,16,9,2,0
"20231126TOTAST",2023-11-26,"England Premier League","Tottenham","Aston Villa",1,2,"A",18,15,8,5,11,13,9,3,0,4,0,0,0,0,0,3,33,13,24,12,4,0
"20231126EVEMAN",2023-11-26,"England Premier League","Everton","Man United",0,3,"A",24,9,6,4,10,8,6,5,3,0,0,0,0,0,0,3,33,10,18,11,3,0
"20231127FULWOL",2023-11-27,"England Premier League","Fulham","Wolves",3,2,"H",12,10,6,6,13,13,6,2,2,2,0,0,0,0,0,5,22,12,26,8,4,0
"20231202ARSWOL",2023-12-02,"England Premier League","Arsenal","Wolves",2,1,"H",19,6,6,3,10,10,4,0,1,2,0,0,0,0,0,3,25,9,20,4,3,0
"20231202BRELUT",2023-12-02,"England Premier League","Brentford","Luton",3,1,"H",27,7,6,1,10,8,7,5,1,2,0,0,0,0,0,4,34,7,18,12,3,0
"20231202BURSHE",2023-12-02,"England Premier League","Burnley","Sheffield United",5,0,"H",19,6,7,3,9,12,6,1,2,5,0,1,0,0,0,5,25,10,21,7,7,1
"20231202NOTEVE",2023-12-02,"England Premier League","Nott'm Forest","Everton",0,1,"A",13,12,2,3,15,14,4,3,1,0,0,0,0,0,0,1,25,5,29,7,1,0
"20231202NEWMAN",2023-12-02,"England Premier League","Newcastle","Man United",1,0,"H",22,8,4,1,6,13,7,3,1,2,0,0,0,0,0,1,30,5,19,10,3,0
"20231203BOUAST",2023-12-03,"England Premier League","Bournemouth","Aston Villa",2,2,"D",15,11,7,3,16,12,7,7,5,3,0,0,0,0,0,4,26,10,28,14,8,0
"20231203CHEBRI",2023-12-03,"England Premier League","Chelsea","Brighton",3,2,"H",8,18,5,9,16,12,5,8,3,5,1,0,0,0,0,5,26,14,28,13,8,1
"20231203LIVFUL",2023-12-03,"England Premier League","Liverpool","Fulham",4,3,"H",26,9,12,5,6,7,3,4,0,0,0,0,0,0,0,7,35,17,13,7,0,0
"20231203WESCRY",2023-12-03,"England Premier League","West Ham","Crystal Palace",1,1,"D",9,9,3,2,17,7,2,3,2,0,0,0,0,0,0,2,18,5,24,5,2,0
"20231203MANTOT",2023-12-03,"England Premier League","Man City","Tottenham",3,3,"D",18,8,4,4,14,14,10,8,4,4,0,0,0,0,0,6,26,8,28,18,8,0
"20231205WOLBUR",2023-12-05,"England Premier League","Wolves","Burnley",1,0,"H",7,12,4,3,11,15,6,8,2,4,0,0,0,0,0,1,19,7,26,14,6,0
"20231205LUTARS",2023-12-05,"England Premier League","Luton","Arsenal",3,4,"A",6,23,4,9,14,7,3,8,2,1,0,0,0,0,0,7,29,13,21,11,3,0
"20231206BRIBRE",2023-12-06,"England Premier League","Brighton","Brentford",2,1,"H",18,8,7,2,10,8,7,3,3,1,0,0,0,0,0,3,26,9,18,10,4,0
"20231206CRYBOU",2023-12-06,"England Premier League","Crystal Palace","Bournemouth",0,2,"A",16,11,3,4,10,17,3,9,1,3,0,0,0,0,0,2,27,7,27,12,4,0
"20231206FULNOT",2023-12-06,"England Premier League","Fulham","Nott'm Forest",5,0,"H",14,4,6,1,7,10,6,1,0,1,0,0,0,0,0,5,18,7,17,7,1,0
"20231206SHELIV",2023-12-06,"England Premier League","Sheffield United","Liverpool",0,2,"A",6,15,1,8,12,8,2,12,2,3,0,0,0,0,0,2,21,9,20,14,5,0
"20231206ASTMAN",2023-12-06,"England Premier League","Aston Villa","Man City",1,0,"H",22,2,7,2,13,13,6,0,2,2,0,0,0,0,0,1,24,9,26,6,4,0
"20231206MANCHE",2023-12-06,"England Premier League","Man United","Chelsea",2,1,"H",28,13,9,3,12,12,12,4,4,0,0,0,0,0,0,3,41,12,24,16,4,0
"20231207EVENEW",2023-12-07,"England Premier League","Everton","Newcastle",3,0,"H",21,13,6,3,18,8,5,2,3,0,0,0,0,0,0,3,34,9,26,7,3,0
"20231207TOTWES",2023-12-07,"England Premier League","Tottenham","West Ham",1,2,"A",23,11,7,5,11,12,8,4,3,3,0,0,0,0,0,3,34,12,23,12,6,0
"20231209CRYLIV",2023-12-09,"England Premier League","Crystal Palace","Liverpool",1,2,"A",8,14,4,2,17,17,6,5,5,2,1,0,0,0,0,3,22,6,34,11,7,1
"20231209BRIBUR",2023-12-09,"England Premier League","Brighton","Burnley",1,1,"D",29,6,11,3,5,8,9,1,0,4,0,0,0,0,0,2,35,14,13,10,4,0
"20231209MANBOU",2023-12-09,"England Premier League","Man United","Bournemouth",0,3,"A",20,10,3,4,7,10,10,4,3,1,0,0,0,0,0,3,30,7,17,14,4,0
"20231209SHEBRE",2023-12-09,"England Premier League","Sheffield United","Brentford",1,0,"H",9,10,4,4,14,13,3,4,5,1,0,0,0,0,0,1,19,8,27,7,6,0
"20231209WOLNOT",2023-12-09,"England Premier League","Wolves","Nott'm Forest",1,1,"D",10,8,4,2,9,11,4,3,0,1,0,0,0,0,0,2,18,6,20,7,1,0
"20231209ASTARS",2023-12-09,"England Premier League","Aston Villa","Arsenal",1,0,"H",10,12,3,5,16,11,3,3,4,2,0,0,0,0,0,1,22,8,27,6,6,0
"20231210EVECHE",2023-12-10,"England Premier League","Everton","Chelsea",2,0,"H",9,16,5,4,12,12,4,8,2,2,0,0,0,0,0,2,25,9,24,12,4,0
"20231210FULWES",2023-12-10,"England Premier League","Fulham","West Ham",5,0,"H",14,9,8,5,5,10,3,6,2,1,0,0,0,0,0,5,23,13,15,9,3,0
"20231210LUTMAN",2023-12-10,"England Premier League","Luton","Man City",1,2,"A",4,18,2,6,16,6,6,3,2,1,0,0,0,0,0,3,22,8,22,9,3,0
"20231210TOTNEW",2023-12-10,"England Premier League","Tottenham","Newcastle",4,1,"H",23,9,12,3,10,12,3,6,1,3,0,0,0,0,0,5,32,15,22,9,4,0
"20231215NOTTOT",2023-12-15,"England Premier League","Nott'm Forest","Tottenham",0,2,"A",15,12,1,6,16,11,6,4,2,4,0,1,0,0,0,2,27,7,27,10,6,1
"20231216CHESHE",2023-12-16,"England Premier League","Chelsea","Sheffield United",2,0,"H",15,6,6,1,9,14,7,6,1,3,0,0,0,0,0,2,21,7,23,13,4,0
"20231216MANCRY",2023-12-16,"England Premier League","Man City","Crystal Palace",2,2,"D",19,5,9,2,12,9,6,1,1,1,0,0,0,0,0,4,24,11,21,7,2,0
"20231216NEWFUL",2023-12-16,"England Premier League","Newcastle","Fulham",3,0,"H",27,6,10,4,7,12,5,1,0,2,0,1,0,0,0,3,33,14,19,6,2,1
"20231216BUREVE",2023-12-16,"England Premier League","Burnley","Everton",0,2,"A",14,9,2,6,9,8,8,6,0,1,0,0,0,0,0,2,23,8,17,14,1,0
"20231217ARSBRI",2023-12-17,"England Premier League","Arsenal","Brighton",2,0,"H",26,6,9,1,11,9,10,1,1,3,0,0,0,0,0,2,32,10,20,11,4,0
"20231217BREAST",2023-12-17,"England Premier League","Brentford","Aston Villa",1,2,"A",4,15,3,5,19,6,7,12,6,4,1,1,0,0,0,3,19,8,25,19,10,2
"20231217WESWOL",2023-12-17,"England Premier League","West Ham","Wolves",3,0,"H",13,14,4,3,12,15,6,6,3,1,0,0,0,0,0,3,27,7,27,12,4,0
"20231217LIVMAN",2023-12-17,"England Premier League","Liverpool","Man United",0,0,"D",34,6,8,1,13,8,12,0,2,4,0,1,1,0,1,0,40,9,21,12,6,1
"20231221CRYBRI",2023-12-21,"England Premier League","Crystal Palace","Brighton",1,1,"D",11,18,3,6,12,11,3,1,5,2,0,0,0,0,0,2,29,9,23,4,7,0
"20231222ASTSHE",2023-12-22,"England Premier League","Aston Villa","Sheffield United",1,1,"D",12,5,4,2,11,16,9,1,3,3,0,0,0,0,0,2,17,6,27,10,6,0
"20231223WESMAN",2023-12-23,"England Premier League","West Ham","Man United",2,0,"H",12,11,5,3,13,15,4,4,2,3,0,0,0,0,0,2,23,8,28,8,5,0
"20231223FULBUR",2023-12-23,"England Premier League","Fulham","Burnley",0,2,"A",19,7,5,2,5,17,8,6,2,1,0,0,0,0,0,2,26,7,22,14,3,0
"20231223LUTNEW",2023-12-23,"England Premier League","Luton","Newcastle",1,0,"H",16,15,5,2,11,5,6,7,2,1,0,0,0,0,0,1,31,7,16,13,3,0
"20231223NOTBOU",2023-12-23,"England Premier League","Nott'm Forest","Bournemouth",2,3,"A",11,18,5,7,10,10,6,6,0,3,1,0,0,0,0,5,29,12,20,12,3,1
"20231223TOTEVE",2023-12-23,"England Premier League","Tottenham","Everton",2,1,"H",13,18,6,8,6,18,3,8,1,4,0,0,0,0,0,3,31,14,24,11,5,0
"20231223LIVARS",2023-12-23,"England Premier League","Liverpool","Arsenal",1,1,"D",13,13,3,2,13,14,4,5,2,5,0,0,0,0,0,2,26,5,27,9,7,0
"20231224WOLCHE",2023-12-24,"England Premier League","Wolves","Chelsea",2,1,"H",14,16,6,5,11,9,10,6,3,5,0,0,0,0,0,3,30,11,20,16,8,0
"20231226NEWNOT",2023-12-26,"England Premier League","Newcastle","Nott'm Forest",1,3,"A",19,15,7,6,10,11,10,2,3,3,0,0,0,0,0,4,34,13,21,12,6,0
"20231226BOUFUL",2023-12-26,"England Premier League","Bournemouth","Fulham",3,0,"H",16,8,4,3,10,10,6,5,0,2,0,0,0,0,0,3,24,7,20,11,2,0
"20231226SHELUT",2023-12-26,"England Premier League","Sheffield United","Luton",2,3,"A",21,12,6,4,13,13,9,4,5,0,0,0,0,0,0,5,33,10,26,13,5,0
"20231226BURLIV",2023-12-26,"England Premier League","Burnley","Liverpool",0,2,"A",9,19,0,10,7,10,4,4,2,1,0,0,0,0,0,2,28,10,17,8,3,0
"20231226MANAST",2023-12-26,"England Premier League","Man United","Aston Villa",3,2,"H",13,10,7,4,10,10,3,6,1,3,0,0,0,0,0,5,23,11,20,9,4,0
"20231227BREWOL",2023-12-27,"England Premier League","Brentford","Wolves",1,4,"A",14,11,4,5,5,14,8,2,1,1,0,0,0,0,0,5,25,9,19,10,2,0
"20231227CHECRY",2023-12-27,"England Premier League","Chelsea","Crystal Palace",2,1,"H",9,13,4,5,13,16,4,3,3,2,0,0,0,0,0,3,22,9,29,7,5,0
"20231227EVEMAN",2023-12-27,"England Premier League","Everton","Man City",1,3,"A",7,23,2,9,13,5,8,4,4,2,0,0,0,0,0,4,30,11,18,12,6,0
"20231228BRITOT",2023-12-28,"England Premier League","Brighton","Tottenham",4,2,"H",15,19,9,3,18,6,7,6,3,2,0,0,0,0,0,6,34,12,24,13,5,0
"20231228ARSWES",2023-12-28,"England Premier League","Arsenal","West Ham",0,2,"A",30,6,8,3,8,8,10,3,2,0,0,0,0,0,0,2,36,11,16,13,2,0
"20231230LUTCHE",2023-12-30,"England Premier League","Luton","Chelsea",2,3,"A",15,12,6,8,14,21,7,2,2,2,0,0,0,0,0,5,27,14,35,9,4,0
"20231230ASTBUR",2023-12-30,"England Premier League","Aston Villa","Burnley",3,2,"H",19,9,7,5,9,14,6,2,4,1,0,1,0,0,0,5,28,12,23,8,5,1
"20231230CRYBRE",2023-12-30,"England Premier League","Crystal Palace","Brentford",3,1,"H",13,9,6,4,14,10,7,4,0,1,0,0,0,0,0,4,22,10,24,11,1,0
"20231230MANSHE",2023-12-30,"England Premier League","Man City","Sheffield United",2,0,"H",18,4,4,2,5,6,12,2,1,1,0,0,0,0,0,2,22,6,11,14,2,0
"20231230WOLEVE",2023-12-30,"England Premier League","Wolves","Everton",3,0,"H",12,10,6,0,9,14,5,2,2,3,0,0,0,0,0,3,22,6,23,7,5,0
"20231230NOTMAN",2023-12-30,"England Premier League","Nott'm Forest","Man United",2,1,"H",8,10,2,5,9,11,4,5,2,4,0,0,0,0,0,3,18,7,20,9,6,0
"20231231FULARS",2023-12-31,"England Premier League","Fulham","Arsenal",2,1,"H",15,13,4,3,11,10,5,4,4,1,0,0,0,0,0,3,28,7,21,9,5,0
"20231231TOTBOU",2023-12-31,"England Premier League","Tottenham","Bournemouth",3,1,"H",12,24,6,4,9,18,4,13,3,3,0,0,0,0,0,4,36,10,27,17,6,0
"20240101LIVNEW",2024-01-01,"England Premier League","Liverpool","Newcastle",4,2,"H",34,5,15,3,16,15,7,3,3,5,0,0,0,0,0,6,39,18,31,10,8,0
"20240102WESBRI",2024-01-02,"England Premier League","West Ham","Brighton",0,0,"D",6,22,2,8,4,6,2,0,1,0,0,0,0,0,0,0,28,10,10,2,1,0
"20240112BURLUT",2024-01-12,"England Premier League","Burnley","Luton",1,1,"D",13,14,7,5,7,12,2,8,1,0,0,0,0,0,0,2,27,12,19,10,1,0
"20240113CHEFUL",2024-01-13,"England Premier League","Chelsea","Fulham",1,0,"H",17,14,3,4,13,9,6,4,5,1,0,0,0,0,0,1,31,7,22,10,6,0
"20240113NEWMAN",2024-01-13,"England Premier League","Newcastle","Man City",2,3,"A",12,27,5,11,7,7,3,13,1,2,0,0,0,0,0,5,39,16,14,16,3,0
"20240114EVEAST",2024-01-14,"England Premier League","Everton","Aston Villa",0,0,"D",10,16,2,5,13,14,4,5,1,4,0,0,0,0,0,0,26,7,27,9,5,0
"20240114MANTOT",2024-01-14,"England Premier League","Man United","Tottenham",2,2,"D",9,16,2,6,8,5,8,13,2,1,0,0,0,0,0,4,25,8,13,21,3,0
"20240120ARSCRY",2024-01-20,"England Premier League","Arsenal","Crystal Palace",5,0,"H",21,12,6,5,8,12,6,7,0,0,0,0,0,0,0,5,33,11,20,13,0,0
"20240120BRENOT",2024-01-20,"England Premier League","Brentford","Nott'm Forest",3,2,"H",11,12,5,3,10,14,6,4,1,3,0,0,0,0,0,5,23,8,24,10,4,0
"20240121SHEWES",2024-01-21,"England Premier League","Sheffield United","West Ham",2,2,"D",21,16,6,5,11,10,4,1,3,1,1,1,0,0,0,4,37,11,21,5,4,2
"20240121BOULIV",2024-01-21,"England Premier League","Bournemouth","Liverpool",0,4,"A",11,14,1,7,9,12,8,5,1,2,0,0,0,0,0,4,25,8,21,13,3,0
"20240122BRIWOL",2024-01-22,"England Premier League","Brighton","Wolves",0,0,"D",11,8,4,3,10,13,8,2,1,4,0,0,1,1,0,0,19,7,23,10,5,0
"20240130NOTARS",2024-01-30,"England Premier League","Nott'm Forest","Arsenal",1,2,"A",9,19,3,3,6,7,2,11,0,1,0,0,0,0,0,3,28,6,13,13,1,0
"20240130FULEVE",2024-01-30,"England Premier League","Fulham","Everton",0,0,"D",25,21,6,4,6,13,15,6,1,2,0,0,0,0,0,0,46,10,19,21,3,0
"20240130LUTBRI",2024-01-30,"England Premier League","Luton","Brighton",4,0,"H",18,9,8,2,13,14,7,4,2,2,0,0,0,0,0,4,27,10,27,11,4,0
"20240130CRYSHE",2024-01-30,"England Premier League","Crystal Palace","Sheffield United",3,2,"H",12,9,4,5,8,18,11,1,1,4,0,0,0,0,0,5,21,9,26,12,5,0
"20240130ASTNEW",2024-01-30,"England Premier League","Aston Villa","Newcastle",1,3,"A",12,14,6,5,14,12,8,7,4,1,0,0,0,0,0,4,26,11,26,15,5,0
"20240131MANBUR",2024-01-31,"England Premier League","Man City","Burnley",3,1,"H",14,8,4,3,3,13,7,3,2,2,0,0,0,0,0,4,22,7,16,10,4,0
"20240131TOTBRE",2024-01-31,"England Premier League","Tottenham","Brentford",3,2,"H",19,9,5,5,13,15,5,3,2,3,0,0,0,0,0,5,28,10,28,8,5,0
"20240131LIVCHE",2024-01-31,"England Premier League","Liverpool","Chelsea",4,1,"H",28,4,13,3,15,16,8,1,2,4,0,0,0,0,0,5,32,16,31,9,6,0
"20240201WESBOU",2024-02-01,"England Premier League","West Ham","Bournemouth",1,1,"D",9,9,3,4,13,11,1,5,1,3,0,0,0,0,0,2,18,7,24,6,4,0
"20240201WOLMAN",2024-02-01,"England Premier League","Wolves","Man United",3,4,"A",16,21,7,8,10,10,4,5,2,5,0,0,0,0,0,7,37,15,20,9,7,0
"20240203EVETOT",2024-02-03,"England Premier League","Everton","Tottenham",2,2,"D",14,9,5,6,8,14,9,5,3,0,0,0,0,0,0,4,23,11,22,14,3,0
"20240203BRICRY",2024-02-03,"England Premier League","Brighton","Crystal Palace",4,1,"H",13,7,6,5,8,14,3,2,1,3,0,0,0,0,0,5,20,11,22,5,4,0
"20240203BURFUL",2024-02-03,"England Premier League","Burnley","Fulham",2,2,"D",12,15,4,7,11,7,2,13,2,2,0,0,1,0,1,4,27,11,18,15,4,0
"20240203NEWLUT",2024-02-03,"England Premier League","Newcastle","Luton",4,4,"D",19,11,6,8,13,16,8,2,2,2,0,0,0,0,0,8,30,14,29,10,4,0
"20240203SHEAST",2024-02-03,"England Premier League","Sheffield United","Aston Villa",0,5,"A",10,14,5,10,10,7,3,4,1,0,0,0,0,0,0,5,24,15,17,7,1,0
"20240204BOUNOT",2024-02-04,"England Premier League","Bournemouth","Nott'm Forest",1,1,"D",9,8,2,6,19,12,11,6,3,2,1,0,0,0,0,2,17,8,31,17,5,1
"20240204CHEWOL",2024-02-04,"England Premier League","Chelsea","Wolves",2,4,"A",15,14,6,7,15,11,10,1,3,2,0,0,0,0,0,6,29,13,26,11,5,0
"20240204MANWES",2024-02-04,"England Premier League","Man United","West Ham",3,0,"H",12,22,5,3,10,5,5,8,0,1,0,0,0,0,0,3,34,8,15,13,1,0
"20240204ARSLIV",2024-02-04,"England Premier League","Arsenal","Liverpool",3,1,"H",15,10,7,1,11,11,2,4,6,2,0,1,0,0,0,4,25,8,22,6,8,1
"20240205BREMAN",2024-02-05,"England Premier League","Brentford","Man City",1,3,"A",9,25,3,15,2,4,8,13,1,0,0,0,0,0,0,4,34,18,6,21,1,0
"20240210MANEVE",2024-02-10,"England Premier League","Man City","Everton",2,0,"H",19,5,3,1,6,11,9,0,0,2,0,0,0,0,0,2,24,4,17,9,2,0
"20240210FULBOU",2024-02-10,"England Premier League","Fulham","Bournemouth",3,1,"H",7,25,6,4,11,11,1,14,1,2,0,0,0,0,0,4,32,10,22,15,3,0
"20240210LIVBUR",2024-02-10,"England Premier League","Liverpool","Burnley",3,1,"H",25,9,10,4,11,13,9,3,3,2,0,0,0,0,0,4,34,14,24,12,5,0
"20240210LUTSHE",2024-02-10,"England Premier League","Luton","Sheffield United",1,3,"A",20,7,5,3,7,12,13,1,1,2,0,0,0,0,0,4,27,8,19,14,3,0
"20240210TOTBRI",2024-02-10,"England Premier League","Tottenham","Brighton",2,1,"H",16,6,6,3,14,13,9,6,2,3,0,0,0,0,0,3,22,9,27,15,5,0
"20240210WOLBRE",2024-02-10,"England Premier League","Wolves","Brentford",0,2,"A",17,9,5,6,11,9,7,4,2,3,0,0,0,0,0,2,26,11,20,11,5,0
"20240210NOTNEW",2024-02-10,"England Premier League","Nott'm Forest","Newcastle",2,3,"A",13,7,3,5,9,6,4,4,1,2,0,0,0,0,0,5,20,8,15,8,3,0
"20240211WESARS",2024-02-11,"England Premier League","West Ham","Arsenal",0,6,"A",5,25,1,12,17,11,2,6,4,0,0,0,0,0,0,6,30,13,28,8,4,0
"20240211ASTMAN",2024-02-11,"England Premier League","Aston Villa","Man United",1,2,"A",23,17,10,5,9,7,10,8,3,2,0,0,0,0,0,3,40,15,16,18,5,0
"20240212CRYCHE",2024-02-12,"England Premier League","Crystal Palace","Chelsea",1,3,"A",13,14,4,5,14,7,1,7,2,2,0,0,0,0,0,4,27,9,21,8,4,0
"20240217BRELIV",2024-02-17,"England Premier League","Brentford","Liverpool",1,4,"A",15,15,6,8,4,18,1,6,2,1,0,0,0,0,0,5,30,14,22,7,3,0
"20240217BURARS",2024-02-17,"England Premier League","Burnley","Arsenal",0,5,"A",8,16,0,7,11,8,4,6,2,1,0,0,0,0,0,5,24,7,19,10,3,0
"20240217FULAST",2024-02-17,"England Premier League","Fulham","Aston Villa",1,2,"A",15,12,4,3,11,6,4,4,5,2,0,0,0,0,0,3,27,7,17,8,7,0
"20240217NEWBOU",2024-02-17,"England Premier League","Newcastle","Bournemouth",2,2,"D",17,12,5,7,9,22,4,2,1,3,0,0,0,0,0,4,29,12,31,6,4,0
"20240217NOTWES",2024-02-17,"England Premier League","Nott'm Forest","West Ham",2,0,"H",19,10,8,3,13,15,5,3,4,4,0,1,0,0,0,2,29,11,28,8,8,1
"20240217TOTWOL",2024-02-17,"England Premier League","Tottenham","Wolves",1,2,"A",15,12,4,7,8,13,10,4,0,1,0,0,0,0,0,3,27,11,21,14,1,0
"20240217MANCHE",2024-02-17,"England Premier League","Man City","Chelsea",1,1,"D",31,9,5,6,7,12,12,1,1,3,0,0,0,0,0,2,40,11,19,13,4,0
"20240218SHEBRI",2024-02-18,"England Premier League","Sheffield United","Brighton",0,5,"A",6,24,1,10,3,5,5,10,1,4,1,0,0,0,0,5,30,11,8,15,5,1
"20240218LUTMAN",2024-02-18,"England Premier League","Luton","Man United",1,2,"A",22,21,4,9,7,21,8,6,3,5,0,0,0,0,0,3,43,13,28,14,8,0
"20240219EVECRY",2024-02-19,"England Premier League","Everton","Crystal Palace",1,1,"D",19,10,4,4,8,12,3,6,0,2,0,0,0,0,0,2,29,8,20,9,2,0
"20240220MANBRE",2024-02-20,"England Premier League","Man City","Brentford",1,0,"H",25,6,11,2,12,6,10,1,2,4,0,0,0,0,0,1,31,13,18,11,6,0
"20240221LIVLUT",2024-02-21,"England Premier League","Liverpool","Luton",4,1,"H",29,12,13,3,15,14,13,4,1,4,0,0,0,0,0,5,41,16,29,17,5,0
"20240224ASTNOT",2024-02-24,"England Premier League","Aston Villa","Nott'm Forest",4,2,"H",16,10,6,3,7,16,7,2,1,2,0,0,0,0,0,6,26,9,23,9,3,0
"20240224BRIEVE",2024-02-24,"England Premier League","Brighton","Everton",1,1,"D",23,6,7,3,9,14,11,3,2,3,1,0,0,0,0,2,29,10,23,14,5,1
"20240224CRYBUR",2024-02-24,"England Premier League","Crystal Palace","Burnley",3,0,"H",15,2,6,0,8,13,12,3,3,1,0,1,0,0,0,3,17,6,21,15,4,1
"20240224MANFUL",2024-02-24,"England Premier League","Man United","Fulham",1,2,"A",21,17,9,5,6,11,10,9,2,5,0,0,0,0,0,3,38,14,17,19,7,0
"20240224BOUMAN",2024-02-24,"England Premier League","Bournemouth","Man City",0,1,"A",13,15,4,6,14,6,3,8,2,2,0,0,0,0,0,1,28,10,20,11,4,0
"20240224ARSNEW",2024-02-24,"England Premier League","Arsenal","Newcastle",4,1,"H",18,3,8,2,15,6,9,0,1,0,0,0,0,0,0,5,21,10,21,9,1,0
"20240225WOLSHE",2024-02-25,"England Premier League","Wolves","Sheffield United",1,0,"H",13,12,2,4,8,4,5,6,2,1,0,0,0,0,0,1,25,6,12,11,3,0
"20240226WESBRE",2024-02-26,"England Premier League","West Ham","Brentford",4,2,"H",17,14,6,8,5,9,1,7,1,2,0,0,0,0,0,6,31,14,14,8,3,0
"20240302BRECHE",2024-03-02,"England Premier League","Brentford","Chelsea",2,2,"D",14,17,5,6,10,9,0,6,3,1,0,0,0,0,0,4,31,11,19,6,4,0
"20240302EVEWES",2024-03-02,"England Premier League","Everton","West Ham",1,3,"A",22,12,11,5,9,6,4,5,1,2,0,0,0,0,0,4,34,16,15,9,3,0
"20240302FULBRI",2024-03-02,"England Premier League","Fulham","Brighton",3,0,"H",12,15,5,5,16,10,2,6,1,2,0,0,0,0,0,3,27,10,26,8,3,0
"20240302NEWWOL",2024-03-02,"England Premier League","Newcastle","Wolves",3,0,"H",14,12,7,3,8,11,3,5,0,1,0,0,0,0,0,3,26,10,19,8,1,0
"20240302NOTLIV",2024-03-02,"England Premier League","Nott'm Forest","Liverpool",0,1,"A",8,22,2,2,11,12,3,12,2,2,0,0,0,0,0,1,30,4,23,15,4,0
"20240302TOTCRY",2024-03-02,"England Premier League","Tottenham","Crystal Palace",3,1,"H",14,4,6,1,7,16,11,1,1,2,0,0,0,0,0,4,18,7,23,12,3,0
"20240302LUTAST",2024-03-02,"England Premier League","Luton","Aston Villa",2,3,"A",13,12,5,8,8,19,8,6,1,4,0,0,0,0,0,5,25,13,27,14,5,0
"20240303BURBOU",2024-03-03,"England Premier League","Burnley","Bournemouth",0,2,"A",20,10,6,3,8,13,7,2,2,4,0,0,0,0,0,2,30,9,21,9,6,0
"20240303MANMAN",2024-03-03,"England Premier League","Man City","Man United",3,1,"H",27,3,8,1,5,10,15,2,0,1,0,0,0,0,0,4,30,9,15,17,1,0
"20240304SHEARS",2024-03-04,"England Premier League","Sheffield United","Arsenal",0,6,"A",4,22,0,10,11,4,0,7,1,0,0,0,0,0,0,6,26,10,15,7,1,0
"20240309MANEVE",2024-03-09,"England Premier League","Man United","Everton",2,0,"H",15,23,8,6,13,11,5,8,1,2,0,0,0,0,0,2,38,14,24,13,3,0
"20240309BOUSHE",2024-03-09,"England Premier League","Bournemouth","Sheffield United",2,2,"D",32,13,12,9,12,11,10,3,3,5,0,0,0,0,0,4,45,21,23,13,8,0
"20240309CRYLUT",2024-03-09,"England Premier League","Crystal Palace","Luton",1,1,"D",21,8,4,2,20,11,8,6,2,3,0,0,0,0,0,2,29,6,31,14,5,0
"20240309WOLFUL",2024-03-09,"England Premier League","Wolves","Fulham",2,1,"H",8,23,3,6,7,11,3,4,2,2,0,0,0,0,0,3,31,9,18,7,4,0
"20240309ARSBRE",2024-03-09,"England Premier League","Arsenal","Brentford",2,1,"H",17,9,6,4,9,10,10,4,2,4,0,0,0,0,0,3,26,10,19,14,6,0
"20240310ASTTOT",2024-03-10,"England Premier League","Aston Villa","Tottenham",0,4,"A",10,9,1,5,11,15,6,4,0,2,1,0,0,0,0,4,19,6,26,10,2,1
"20240310BRINOT",2024-03-10,"England Premier League","Brighton","Nott'm Forest",1,0,"H",10,9,3,4,14,14,6,3,4,4,0,0,0,0,0,1,19,7,28,9,8,0
"20240310WESBUR",2024-03-10,"England Premier League","West Ham","Burnley",2,2,"D",22,11,4,4,11,18,4,4,2,4,0,0,0,0,0,4,33,8,29,8,6,0
"20240310LIVMAN",2024-03-10,"England Premier League","Liverpool","Man City",1,1,"D",19,10,6,6,6,10,7,4,0,3,0,0,0,0,0,2,29,12,16,11,3,0
"20240311CHENEW",2024-03-11,"England Premier League","Chelsea","Newcastle",3,2,"H",12,11,8,3,12,7,0,4,3,1,0,0,0,0,0,5,23,11,19,4,4,0
"20240313BOULUT",2024-03-13,"England Premier League","Bournemouth","Luton",4,3,"H",24,8,10,4,16,11,11,3,1,2,0,0,0,0,0,7,32,14,27,14,3,0
"20240316BURBRE",2024-03-16,"England Premier League","Burnley","Brentford",2,1,"H",17,9,6,5,14,17,5,4,2,4,0,1,0,0,0,3,26,11,31,9,6,1
"20240316LUTNOT",2024-03-16,"England Premier League","Luton","Nott'm Forest",1,1,"D",10,16,4,6,10,17,6,7,1,2,0,0,0,0,0,2,26,10,27,13,3,0
"20240316FULTOT",2024-03-16,"England Premier League","Fulham","Tottenham",3,0,"H",16,14,7,5,9,10,4,5,2,3,0,0,1,0,1,3,30,12,19,9,5,0
"20240317WESAST",2024-03-17,"England Premier League","West Ham","Aston Villa",1,1,"D",13,13,5,5,13,12,7,11,3,3,0,0,0,0,0,2,26,10,25,18,6,0
"20240330NEWWES",2024-03-30,"England Premier League","Newcastle","West Ham",4,3,"H",24,10,9,4,9,8,3,4,1,1,1,0,0,0,0,7,34,13,17,7,2,1
"20240330BOUEVE",2024-03-30,"England Premier League","Bournemouth","Everton",2,1,"H",11,7,4,3,14,11,9,8,1,2,0,0,0,0,0,3,18,7,25,17,3,0
"20240330CHEBUR",2024-03-30,"England Premier League","Chelsea","Burnley",2,2,"D",33,18,13,7,12,7,12,4,2,2,0,1,0,0,0,4,51,20,19,16,4,1
"20240330NOTCRY",2024-03-30,"England Premier League","Nott'm Forest","Crystal Palace",1,1,"D",12,10,5,3,14,12,4,6,1,1,0,0,0,0,0,2,22,8,26,10,2,0
"20240330SHEFUL",2024-03-30,"England Premier League","Sheffield United","Fulham",3,3,"D",8,24,4,9,10,13,2,15,4,1,0,0,0,0,0,6,32,13,23,17,5,0
"20240330TOTLUT",2024-03-30,"England Premier League","Tottenham","Luton",2,1,"H",17,7,4,3,16,14,3,6,2,4,0,0,0,0,0,3,24,7,30,9,6,0
"20240330ASTWOL",2024-03-30,"England Premier League","Aston Villa","Wolves",2,0,"H",11,13,5,3,11,19,5,4,3,4,0,0,0,0,0,2,24,8,30,9,7,0
"20240330BREMAN",2024-03-30,"England Premier League","Brentford","Man United",1,1,"D",31,11,5,5,7,14,14,4,2,2,0,0,0,0,0,2,42,10,21,18,4,0
"20240331LIVBRI",2024-03-31,"England Premier League","Liverpool","Brighton",2,1,"H",30,9,8,3,20,6,8,4,5,3,0,0,0,0,0,3,39,11,26,12,8,0
"20240331MANARS",2024-03-31,"England Premier League","Man City","Arsenal",0,0,"D",12,6,1,2,9,20,7,4,0,2,0,0,0,0,0,0,18,3,29,11,2,0
"20240402NEWEVE",2024-04-02,"England Premier League","Newcastle","Everton",1,1,"D",18,10,6,3,9,14,7,3,0,3,0,0,0,0,0,2,28,9,23,10,3,0
"20240402NOTFUL",2024-04-02,"England Premier League","Nott'm Forest","Fulham",3,1,"H",16,18,4,3,7,8,3,8,0,0,0,0,0,0,0,4,34,7,15,11,0,0
"20240402BOUCRY",2024-04-02,"England Premier League","Bournemouth","Crystal Palace",1,0,"H",11,3,6,2,13,14,9,2,3,2,0,0,0,0,0,1,14,8,27,11,5,0
"20240402BURWOL",2024-04-02,"England Premier League","Burnley","Wolves",1,1,"D",13,8,6,2,10,12,7,4,0,2,0,0,0,0,0,2,21,8,22,11,2,0
"20240402WESTOT",2024-04-02,"England Premier League","West Ham","Tottenham",1,1,"D",11,13,4,4,13,9,9,5,1,4,0,0,0,0,0,2,24,8,22,14,5,0
"20240403ARSLUT",2024-04-03,"England Premier League","Arsenal","Luton",2,0,"H",13,5,4,1,12,8,3,1,1,1,0,0,0,0,0,2,18,5,20,4,2,0
"20240403BREBRI",2024-04-03,"England Premier League","Brentford","Brighton",0,0,"D",5,24,2,6,9,12,1,5,1,1,0,0,0,0,0,0,29,8,21,6,2,0
"20240403MANAST",2024-04-03,"England Premier League","Man City","Aston Villa",4,1,"H",25,8,11,3,6,13,2,3,1,2,0,0,0,0,0,5,33,14,19,5,3,0
"20240404LIVSHE",2024-04-04,"England Premier League","Liverpool","Sheffield United",3,1,"H",29,8,9,3,6,9,13,1,0,1,0,0,0,0,0,4,37,12,15,14,1,0
"20240404CHEMAN",2024-04-04,"England Premier League","Chelsea","Man United",4,3,"H",28,19,10,5,7,15,12,3,3,0,0,0,0,0,0,7,47,15,22,15,3,0
"20240406CRYMAN",2024-04-06,"England Premier League","Crystal Palace","Man City",2,4,"A",7,18,4,8,13,3,2,9,1,1,0,0,0,0,0,6,25,12,16,11,2,0
"20240406ASTBRE",2024-04-06,"England Premier League","Aston Villa","Brentford",3,3,"D",11,8,3,3,15,11,11,3,2,2,0,0,0,0,0,6,19,6,26,14,4,0
"20240406EVEBUR",2024-04-06,"England Premier League","Everton","Burnley",1,0,"H",12,6,3,1,11,13,3,5,2,1,0,1,0,0,0,1,18,4,24,8,3,1
"20240406FULNEW",2024-04-06,"England Premier League","Fulham","Newcastle",0,1,"A",14,12,4,5,10,13,14,3,1,2,0,0,0,0,0,1,26,9,23,17,3,0
"20240406LUTBOU",2024-04-06,"England Premier League","Luton","Bournemouth",2,1,"H",19,8,9,1,7,14,7,2,0,0,0,0,0,0,0,3,27,10,21,9,0,0
"20240406WOLWES",2024-04-06,"England Premier League","Wolves","West Ham",1,2,"A",14,11,7,4,15,7,4,4,5,2,0,0,0,0,0,3,25,11,22,8,7,0
"20240406BRIARS",2024-04-06,"England Premier League","Brighton","Arsenal",0,3,"A",10,20,2,7,14,13,8,7,1,2,0,0,0,0,0,3,30,9,27,15,3,0
"20240407MANLIV",2024-04-07,"England Premier League","Man United","Liverpool",2,2,"D",9,28,5,7,9,10,6,11,5,2,0,0,0,0,0,4,37,12,19,17,7,0
"20240407SHECHE",2024-04-07,"England Premier League","Sheffield United","Chelsea",2,2,"D",11,6,6,3,12,10,7,6,4,2,0,0,0,0,0,4,17,9,22,13,6,0
"20240407TOTNOT",2024-04-07,"England Premier League","Tottenham","Nott'm Forest",3,1,"H",17,13,7,6,11,12,12,2,2,3,0,0,0,0,0,4,30,13,23,14,5,0
"20240413NEWTOT",2024-04-13,"England Premier League","Newcastle","Tottenham",4,0,"H",18,11,5,2,14,12,16,3,0,4,0,0,0,0,0,4,29,7,26,19,4,0
"20240413BRESHE",2024-04-13,"England Premier League","Brentford","Sheffield United",2,0,"H",9,8,5,2,8,11,3,6,3,1,0,0,0,0,0,2,17,7,19,9,4,0
"20240413BURBRI",2024-04-13,"England Premier League","Burnley","Brighton",1,1,"D",11,20,3,8,18,8,4,5,1,2,0,0,0,0,0,2,31,11,26,9,3,0
"20240413MANLUT",2024-04-13,"England Premier League","Man City","Luton",5,1,"H",33,4,13,2,7,6,12,1,1,0,0,0,0,0,0,6,37,15,13,13,1,0
"20240413NOTWOL",2024-04-13,"England Premier League","Nott'm Forest","Wolves",2,2,"D",18,11,9,4,15,10,10,1,2,3,0,0,0,0,0,4,29,13,25,11,5,0
"20240413BOUMAN",2024-04-13,"England Premier League","Bournemouth","Man United",2,2,"D",20,8,5,2,13,14,7,2,4,0,0,0,1,0,1,4,28,7,27,9,4,0
"20240414LIVCRY",2024-04-14,"England Premier League","Liverpool","Crystal Palace",0,1,"A",21,8,6,5,10,10,11,1,1,1,0,0,0,0,0,1,29,11,20,12,2,0
"20240414WESFUL",2024-04-14,"England Premier League","West Ham","Fulham",0,2,"A",15,18,4,10,6,13,8,3,1,2,0,0,0,0,0,2,33,14,19,11,3,0
"20240414ARSAST",2024-04-14,"England Premier League","Arsenal","Aston Villa",0,2,"A",18,11,4,2,12,7,4,6,3,1,0,0,0,0,0,2,29,6,19,10,4,0
"20240415CHEEVE",2024-04-15,"England Premier League","Chelsea","Everton",6,0,"H",14,10,10,2,5,21,4,8,1,4,0,0,0,0,0,6,24,12,26,12,5,0
"20240420LUTBRE",2024-04-20,"England Premier League","Luton","Brentford",1,5,"A",6,21,3,9,13,9,4,9,1,2,0,0,0,0,0,6,27,12,22,13,3,0
"20240420SHEBUR",2024-04-20,"England Premier League","Sheffield United","Burnley",1,4,"A",18,16,11,9,10,9,11,2,1,0,0,0,0,0,0,5,34,20,19,13,1,0
"20240420WOLARS",2024-04-20,"England Premier League","Wolves","Arsenal",0,2,"A",5,24,3,9,14,9,1,2,3,2,0,0,0,0,0,2,29,12,23,3,5,0
"20240421EVENOT",2024-04-21,"England Premier League","Everton","Nott'm Forest",2,0,"H",7,8,4,3,15,9,6,4,3,2,0,0,0,0,0,2,15,7,24,10,5,0
"20240421ASTBOU",2024-04-21,"England Premier League","Aston Villa","Bournemouth",3,1,"H",14,14,4,6,8,14,8,4,1,3,0,0,0,0,0,4,28,10,22,12,4,0
"20240421CRYWES",2024-04-21,"England Premier League","Crystal Palace","West Ham",5,2,"H",18,4,7,1,9,9,4,0,3,2,0,0,0,0,0,7,22,8,18,4,5,0
"20240421FULLIV",2024-04-21,"England Premier League","Fulham","Liverpool",1,3,"A",12,14,5,7,5,11,1,4,3,0,0,0,0,0,0,4,26,12,16,5,3,0
"20240423ARSCHE",2024-04-23,"England Premier League","Arsenal","Chelsea",5,0,"H",27,7,10,1,12,11,4,2,2,2,0,0,0,0,0,5,34,11,23,6,4,0
"20240424WOLBOU",2024-04-24,"England Premier League","Wolves","Bournemouth",0,1,"A",15,21,4,6,10,17,8,12,4,1,0,1,0,0,0,1,36,10,27,20,5,1
"20240424CRYNEW",2024-04-24,"England Premier League","Crystal Palace","Newcastle",2,0,"H",20,7,7,2,10,15,7,2,3,3,0,0,0,0,0,2,27,9,25,9,6,0
"20240424EVELIV",2024-04-24,"England Premier League","Everton","Liverpool",2,0,"H",16,23,6,7,6,13,4,13,0,3,0,0,0,0,0,2,39,13,19,17,3,0
"20240424MANSHE",2024-04-24,"England Premier League","Man United","Sheffield United",4,2,"H",25,10,13,4,7,9,9,4,0,1,0,0,0,0,0,6,35,17,16,13,1,0
"20240425BRIMAN",2024-04-25,"England Premier League","Brighton","Man City",0,4,"A",7,14,3,6,10,3,4,4,2,0,0,0,0,0,0,4,21,9,13,8,2,0
"20240427WESLIV",2024-04-27,"England Premier League","West Ham","Liverpool",2,2,"D",11,28,8,8,8,10,5,8,0,2,0,0,0,0,0,4,39,16,18,13,2,0
"20240427FULCRY",2024-04-27,"England Premier League","Fulham","Crystal Palace",1,1,"D",9,14,2,4,11,15,5,9,0,2,0,0,0,0,0,2,23,6,26,14,2,0
"20240427MANBUR",2024-04-27,"England Premier League","Man United","Burnley",1,1,"D",27,16,10,7,7,11,6,5,1,3,0,0,0,0,0,2,43,17,18,11,4,0
"20240427NEWSHE",2024-04-27,"England Premier League","Newcastle","Sheffield United",5,1,"H",20,15,7,5,9,10,4,5,0,0,0,0,0,0,0,6,35,12,19,9,0,0
"20240427WOLLUT",2024-04-27,"England Premier League","Wolves","Luton",2,1,"H",13,9,5,6,14,14,4,4,3,1,0,0,0,0,0,3,22,11,28,8,4,0
"20240427EVEBRE",2024-04-27,"England Premier League","Everton","Brentford",1,0,"H",18,10,1,4,10,12,6,6,1,2,0,0,0,0,0,1,28,5,22,12,3,0
"20240427ASTCHE",2024-04-27,"England Premier League","Aston Villa","Chelsea",2,2,"D",9,21,4,5,13,14,2,4,3,5,0,0,0,0,0,4,30,9,27,6,8,0
"20240428BOUBRI",2024-04-28,"England Premier League","Bournemouth","Brighton",3,0,"H",15,13,6,1,14,10,8,2,2,2,0,0,0,0,0,3,28,7,24,10,4,0
"20240428TOTARS",2024-04-28,"England Premier League","Tottenham","Arsenal",2,3,"A",14,9,2,3,12,16,8,6,2,1,0,0,0,0,0,5,23,5,28,14,3,0
"20240428NOTMAN",2024-04-28,"England Premier League","Nott'm Forest","Man City",0,2,"A",14,11,2,5,8,6,4,5,0,0,0,0,0,0,0,2,25,7,14,9,0,0
"20240502CHETOT",2024-05-02,"England Premier League","Chelsea","Tottenham",2,0,"H",16,19,5,3,12,16,4,9,0,1,0,0,0,0,0,2,35,8,28,13,1,0
"20240503LUTEVE",2024-05-03,"England Premier League","Luton","Everton",1,1,"D",18,10,5,3,14,12,8,7,1,3,0,0,0,0,0,2,28,8,26,15,4,0
"20240504ARSBOU",2024-05-04,"England Premier League","Arsenal","Bournemouth",3,0,"H",25,7,9,2,16,12,6,1,2,3,0,0,0,0,0,3,32,11,28,7,5,0
"20240504BREFUL",2024-05-04,"England Premier League","Brentford","Fulham",0,0,"D",7,15,3,3,3,6,7,6,1,1,0,0,0,0,0,0,22,6,9,13,2,0
"20240504BURNEW",2024-05-04,"England Premier League","Burnley","Newcastle",1,4,"A",17,23,5,11,8,8,4,11,2,2,0,0,0,0,0,5,40,16,16,15,4,0
"20240504SHENOT",2024-05-04,"England Premier League","Sheffield United","Nott'm Forest",1,3,"A",17,15,5,4,9,7,5,3,0,1,1,0,0,0,0,4,32,9,16,8,1,1
"20240504MANWOL",2024-05-04,"England Premier League","Man City","Wolves",5,1,"H",20,2,12,1,4,17,6,0,0,4,0,0,0,0,0,6,22,13,21,6,4,0
"20240505BRIAST",2024-05-05,"England Premier League","Brighton","Aston Villa",1,0,"H",15,2,8,1,13,10,7,3,2,1,0,0,0,0,0,1,17,9,23,10,3,0
"20240505CHEWES",2024-05-05,"England Premier League","Chelsea","West Ham",5,0,"H",25,13,14,2,12,10,8,6,1,3,0,0,0,0,0,5,38,16,22,14,4,0
"20240505LIVTOT",2024-05-05,"England Premier League","Liverpool","Tottenham",4,2,"H",25,11,13,6,14,12,8,3,1,4,0,0,0,0,0,6,36,19,26,11,5,0
"20240506CRYMAN",2024-05-06,"England Premier League","Crystal Palace","Man United",4,0,"H",18,7,10,2,12,8,6,3,1,1,0,0,0,0,0,4,25,12,20,9,2,0
"20240511FULMAN",2024-05-11,"England Premier League","Fulham","Man City",0,4,"A",1,16,1,9,9,6,1,7,1,0,1,0,0,0,0,4,17,10,15,8,1,1
"20240511BOUBRE",2024-05-11,"England Premier League","Bournemouth","Brentford",1,2,"A",13,11,4,5,16,12,3,8,2,2,0,0,0,0,0,3,24,9,28,11,4,0
"20240511EVESHE",2024-05-11,"England Premier League","Everton","Sheffield United",1,0,"H",15,13,6,1,6,11,3,6,1,2,0,0,0,0,0,1,28,7,17,9,3,0
"20240511NEWBRI",2024-05-11,"England Premier League","Newcastle","Brighton",1,1,"D",18,15,7,4,9,16,8,4,3,4,0,0,0,0,0,2,33,11,25,12,7,0
"20240511TOTBUR",2024-05-11,"England Premier League","Tottenham","Burnley",2,1,"H",21,7,9,3,10,14,9,3,3,5,0,0,0,0,0,3,28,12,24,12,8,0
"20240511WESLUT",2024-05-11,"England Premier League","West Ham","Luton",3,1,"H",24,4,8,1,9,15,7,6,1,3,0,0,0,0,0,4,28,9,24,13,4,0
"20240511WOLCRY",2024-05-11,"England Premier League","Wolves","Crystal Palace",1,3,"A",13,13,7,3,13,12,8,3,3,2,0,1,0,0,0,4,26,10,25,11,5,1
"20240511NOTCHE",2024-05-11,"England Premier League","Nott'm Forest","Chelsea",2,3,"A",20,12,4,5,14,8,5,6,2,3,0,0,0,0,0,5,32,9,22,11,5,0
"20240512MANARS",2024-05-12,"England Premier League","Man United","Arsenal",0,1,"A",14,11,2,5,5,6,4,7,0,2,0,0,0,0,0,1,25,7,11,11,2,0
"20240513ASTLIV",2024-05-13,"England Premier League","Aston Villa","Liverpool",3,3,"D",19,14,5,7,11,15,5,4,1,1,0,0,0,0,0,6,33,12,26,9,2,0
"20240514TOTMAN",2024-05-14,"England Premier League","Tottenham","Man City",0,2,"A",10,8,5,5,14,11,7,4,3,3,0,0,0,0,0,2,18,10,25,11,6,0
"20240515BRICHE",2024-05-15,"England Premier League","Brighton","Chelsea",1,2,"A",12,13,2,6,13,14,4,6,2,2,0,1,0,0,0,3,25,8,27,10,4,1
"20240515MANNEW",2024-05-15,"England Premier League","Man United","Newcastle",3,2,"H",17,21,8,8,16,7,9,9,3,3,0,0,0,0,0,5,38,16,23,18,6,0
"20240519ARSEVE",2024-05-19,"England Premier League","Arsenal","Everton",2,1,"H",26,5,5,2,8,11,8,1,4,3,0,0,0,0,0,3,31,7,19,9,7,0
"20240519BRENEW",2024-05-19,"England Premier League","Brentford","Newcastle",2,4,"A",10,12,5,7,15,11,3,0,4,4,0,0,0,0,0,6,22,12,26,3,8,0
"20240519BRIMAN",2024-05-19,"England Premier League","Brighton","Man United",0,2,"A",17,11,3,4,10,9,7,5,1,3,0,0,0,0,0,2,28,7,19,12,4,0
"20240519BURNOT",2024-05-19,"England Premier League","Burnley","Nott'm Forest",1,2,"A",20,12,3,6,11,5,4,3,1,0,0,0,0,0,0,3,32,9,16,7,1,0
"20240519CHEBOU",2024-05-19,"England Premier League","Chelsea","Bournemouth",2,1,"H",16,22,6,5,5,9,6,5,2,3,0,0,0,0,0,3,38,11,14,11,5,0
"20240519CRYAST",2024-05-19,"England Premier League","Crystal Palace","Aston Villa",5,0,"H",15,8,9,2,10,8,2,4,1,4,0,0,0,0,0,5,23,11,18,6,5,0
"20240519LIVWOL",2024-05-19,"England Premier League","Liverpool","Wolves",2,0,"H",36,4,14,3,14,11,10,2,1,1,0,1,0,0,0,2,40,17,25,12,2,1
"20240519LUTFUL",2024-05-19,"England Premier League","Luton","Fulham",2,4,"A",15,15,6,7,15,20,4,4,5,4,0,0,0,0,0,6,30,13,35,8,9,0
"20240519MANWES",2024-05-19,"England Premier League","Man City","West Ham",3,1,"H",28,3,12,2,3,12,11,2,0,1,0,0,0,0,0,4,31,14,15,13,1,0
"20240519SHETOT",2024-05-19,"England Premier League","Sheffield United","Tottenham",0,3,"A",6,18,1,9,11,9,2,6,2,0,0,0,0,0,0,3,24,10,20,8,2,0
"20240816MANFUL",2024-08-16,"England Premier League","Man United","Fulham",1,0,"H",14,10,5,2,12,10,7,8,2,3,0,0,0,0,0,1,24,7,22,15,5,0
"20240817IPSLIV",2024-08-17,"England Premier League","Ipswich","Liverpool",0,2,"A",7,18,2,5,9,18,2,10,3,1,0,0,0,0,0,2,25,7,27,12,4,0
"20240817ARSWOL",2024-08-17,"England Premier League","Arsenal","Wolves",2,0,"H",18,9,6,3,17,14,8,2,2,2,0,0,0,0,0,2,27,9,31,10,4,0
"20240817EVEBRI",2024-08-17,"England Premier League","Everton","Brighton",0,3,"A",9,10,1,5,8,8,1,5,1,1,1,0,0,0,0,3,19,6,16,6,2,1
"20240817NEWSOU",2024-08-17,"England Premier League","Newcastle","Southampton",1,0,"H",3,19,1,4,15,16,3,12,2,4,1,0,0,0,0,1,22,5,31,15,6,1
"20240817NOTBOU",2024-08-17,"England Premier League","Nott'm Forest","Bournemouth",1,1,"D",14,13,8,4,17,8,2,6,1,3,0,0,0,0,0,2,27,12,25,8,4,0
"20240817WESAST",2024-08-17,"England Premier League","West Ham","Aston Villa",1,2,"A",14,15,3,3,18,11,5,3,1,2,0,0,0,0,0,3,29,6,29,8,3,0
"20240818BRECRY",2024-08-18,"England Premier League","Brentford","Crystal Palace",2,1,"H",9,14,5,6,6,15,4,7,1,5,0,0,0,0,0,3,23,11,21,11,6,0
"20240818CHEMAN",2024-08-18,"England Premier League","Chelsea","Man City",0,2,"A",10,11,3,5,12,9,4,3,1,1,0,0,0,0,0,2,21,8,21,7,2,0
"20240819LEITOT",2024-08-19,"England Premier League","Leicester","Tottenham",1,1,"D",7,15,3,7,11,12,2,13,1,1,0,0,0,0,0,2,22,10,23,15,2,0
"20240824BRIMAN",2024-08-24,"England Premier League","Brighton","Man United",2,1,"H",14,11,5,4,9,13,4,4,1,2,0,0,0,0,0,3,25,9,22,8,3,0
"20240824CRYWES",2024-08-24,"England Premier League","Crystal Palace","West Ham",0,2,"A",14,18,2,3,9,17,3,3,1,1,0,0,0,0,0,2,32,5,26,6,2,0
"20240824FULLEI",2024-08-24,"England Premier League","Fulham","Leicester",2,1,"H",18,10,6,4,14,13,7,5,2,2,0,0,0,0,0,3,28,10,27,12,4,0
"20240824MANIPS",2024-08-24,"England Premier League","Man City","Ipswich",4,1,"H",14,1,5,1,4,15,10,1,2,3,0,0,0,0,0,5,15,6,19,11,5,0
"20240824SOUNOT",2024-08-24,"England Premier League","Southampton","Nott'm Forest",0,1,"A",5,23,1,8,14,14,4,10,3,3,0,0,0,0,0,1,28,9,28,14,6,0
"20240824TOTEVE",2024-08-24,"England Premier League","Tottenham","Everton",4,0,"H",13,10,7,1,11,15,12,5,0,0,0,0,0,0,0,4,23,8,26,17,0,0
"20240824ASTARS",2024-08-24,"England Premier League","Aston Villa","Arsenal",0,2,"A",11,9,3,4,8,15,4,1,1,3,0,0,0,0,0,2,20,7,23,5,4,0
"20240825BOUNEW",2024-08-25,"England Premier League","Bournemouth","Newcastle",1,1,"D",16,14,4,5,19,8,8,9,2,2,0,0,1,1,0,2,30,9,27,17,4,0
"20240825WOLCHE",2024-08-25,"England Premier League","Wolves","Chelsea",2,6,"A",12,14,4,8,13,13,5,5,2,3,0,0,0,0,0,8,26,12,26,10,5,0
"20240825LIVBRE",2024-08-25,"England Premier League","Liverpool","Brentford",2,0,"H",19,8,8,2,10,7,9,4,2,3,0,0,0,0,0,2,27,10,17,13,5,0
"20240831ARSBRI",2024-08-31,"England Premier League","Arsenal","Brighton",1,1,"D",11,22,7,4,12,7,3,7,3,2,1,0,0,0,0,2,33,11,19,10,5,1
"20240831BRESOU",2024-08-31,"England Premier League","Brentford","Southampton",3,1,"H",20,18,7,6,10,7,2,8,2,1,0,0,1,1,0,4,38,13,17,10,3,0
"20240831EVEBOU",2024-08-31,"England Premier League","Everton","Bournemouth",2,3,"A",18,17,8,7,6,1,8,4,2,1,0,0,0,0,0,5,35,15,7,12,3,0
"20240831IPSFUL",2024-08-31,"England Premier League","Ipswich","Fulham",1,1,"D",11,9,4,4,15,15,8,6,2,3,0,0,0,0,0,2,20,8,30,14,5,0
"20240831LEIAST",2024-08-31,"England Premier League","Leicester","Aston Villa",1,2,"A",9,10,3,5,13,21,1,4,4,5,0,0,0,0,0,3,19,8,34,5,9,0
"20240831NOTWOL",2024-08-31,"England Premier League","Nott'm Forest","Wolves",1,1,"D",16,11,5,3,15,18,7,3,3,4,0,0,0,0,0,2,27,8,33,10,7,0
"20240831WESMAN",2024-08-31,"England Premier League","West Ham","Man City",1,3,"A",10,23,2,8,10,3,3,11,3,2,0,0,0,0,0,4,33,10,13,14,5,0
"20240901CHECRY",2024-09-01,"England Premier League","Chelsea","Crystal Palace",1,1,"D",13,9,7,3,9,13,4,5,4,2,0,0,0,0,0,2,22,10,22,9,6,0
"20240901NEWTOT",2024-09-01,"England Premier League","Newcastle","Tottenham",2,1,"H",9,20,3,6,16,13,7,12,4,4,0,0,0,0,0,3,29,9,29,19,8,0
"20240901MANLIV",2024-09-01,"England Premier League","Man United","Liverpool",0,3,"A",8,11,3,3,7,7,5,2,4,1,0,0,0,0,0,3,19,6,14,7,5,0
"20240914SOUMAN",2024-09-14,"England Premier League","Southampton","Man United",0,3,"A",6,20,4,10,11,14,0,7,1,4,1,0,0,0,0,3,26,14,25,7,5,1
"20240914BRIIPS",2024-09-14,"England Premier League","Brighton","Ipswich",0,0,"D",21,6,6,1,14,16,9,2,4,3,0,0,0,0,0,0,27,7,30,11,7,0
"20240914CRYLEI",2024-09-14,"England Premier League","Crystal Palace","Leicester",2,2,"D",20,9,4,4,11,15,5,2,0,3,0,0,0,0,0,4,29,8,26,7,3,0
"20240914FULWES",2024-09-14,"England Premier League","Fulham","West Ham",1,1,"D",21,11,5,3,15,18,3,2,2,3,0,0,0,0,0,2,32,8,33,5,5,0
"20240914LIVNOT",2024-09-14,"England Premier League","Liverpool","Nott'm Forest",0,1,"A",14,5,5,3,15,6,7,2,4,4,0,0,0,0,0,1,19,8,21,9,8,0
"20240914MANBRE",2024-09-14,"England Premier League","Man City","Brentford",2,1,"H",18,8,7,5,9,3,12,3,3,1,0,0,0,0,0,3,26,12,12,15,4,0
"20240914ASTEVE",2024-09-14,"England Premier League","Aston Villa","Everton",3,2,"H",17,6,8,2,10,12,6,2,1,4,0,0,0,0,0,5,23,10,22,8,5,0
"20240914BOUCHE",2024-09-14,"England Premier League","Bournemouth","Chelsea",0,1,"A",19,10,7,3,16,9,6,3,6,8,0,0,0,0,0,1,29,10,25,9,14,0
"20240915TOTARS",2024-09-15,"England Premier League","Tottenham","Arsenal",0,1,"A",15,7,5,4,13,10,7,6,5,3,0,0,0,0,0,1,22,9,23,13,8,0
"20240915WOLNEW",2024-09-15,"England Premier League","Wolves","Newcastle",1,2,"A",12,14,5,6,17,6,4,7,3,3,0,0,0,0,0,3,26,11,23,11,6,0
"20240921WESCHE",2024-09-21,"England Premier League","West Ham","Chelsea",0,3,"A",15,12,7,5,17,9,6,5,5,2,0,0,0,0,0,3,27,12,26,11,7,0
"20240921ASTWOL",2024-09-21,"England Premier League","Aston Villa","Wolves",3,1,"H",9,10,4,4,11,16,6,5,3,6,0,0,0,0,0,4,19,8,27,11,9,0
"20240921FULNEW",2024-09-21,"England Premier League","Fulham","Newcastle",3,1,"H",22,15,11,4,16,8,6,0,6,0,0,0,0,0,0,4,37,15,24,6,6,0
"20240921LEIEVE",2024-09-21,"England Premier League","Leicester","Everton",1,1,"D",12,16,2,5,11,12,6,1,1,2,0,0,0,0,0,2,28,7,23,7,3,0
"20240921LIVBOU",2024-09-21,"England Premier League","Liverpool","Bournemouth",3,0,"H",19,19,13,6,10,12,3,9,1,4,0,0,0,0,0,3,38,19,22,12,5,0
"20240921SOUIPS",2024-09-21,"England Premier League","Southampton","Ipswich",1,1,"D",11,13,3,6,16,16,2,10,4,4,0,0,0,0,0,2,24,9,32,12,8,0
"20240921TOTBRE",2024-09-21,"England Premier League","Tottenham","Brentford",3,1,"H",23,6,10,6,11,9,9,4,3,1,0,0,0,0,0,4,29,16,20,13,4,0
"20240921CRYMAN",2024-09-21,"England Premier League","Crystal Palace","Man United",0,0,"D",9,15,4,6,7,12,4,11,3,1,0,0,0,0,0,0,24,10,19,15,4,0
"20240922BRINOT",2024-09-22,"England Premier League","Brighton","Nott'm Forest",2,2,"D",14,4,3,3,12,11,9,1,3,4,0,1,0,0,0,4,18,6,23,10,7,1
"20240922MANARS",2024-09-22,"England Premier League","Man City","Arsenal",2,2,"D",33,5,11,3,7,10,8,2,3,4,0,1,0,0,0,4,38,14,17,10,7,1
"20240928NEWMAN",2024-09-28,"England Premier League","Newcastle","Man City",1,1,"D",11,16,4,6,14,10,5,6,4,4,0,0,0,0,0,2,27,10,24,11,8,0
"20240928ARSLEI",2024-09-28,"England Premier League","Arsenal","Leicester",4,2,"H",36,5,16,3,11,6,17,0,2,4,0,0,0,0,0,6,41,19,17,17,6,0
"20240928BREWES",2024-09-28,"England Premier League","Brentford","West Ham",1,1,"D",8,19,3,3,2,11,7,7,2,3,0,0,0,0,0,2,27,6,13,14,5,0
"20240928CHEBRI",2024-09-28,"England Premier League","Chelsea","Brighton",4,2,"H",15,15,7,5,11,8,8,2,3,2,0,0,0,0,0,6,30,12,19,10,5,0
"20240928EVECRY",2024-09-28,"England Premier League","Everton","Crystal Palace",2,1,"H",8,17,2,5,13,11,5,8,2,1,0,0,0,0,0,3,25,7,24,13,3,0
"20240928NOTFUL",2024-09-28,"England Premier League","Nott'm Forest","Fulham",0,1,"A",11,14,1,2,11,15,6,5,2,4,0,0,0,0,0,1,25,3,26,11,6,0
"20240928WOLLIV",2024-09-28,"England Premier League","Wolves","Liverpool",1,2,"A",8,10,3,6,16,8,2,10,2,3,0,0,1,0,1,3,18,9,24,12,5,0
"20240929IPSAST",2024-09-29,"England Premier League","Ipswich","Aston Villa",2,2,"D",15,7,5,3,10,14,10,0,4,1,0,0,0,0,0,4,22,8,24,10,5,0
"20240929MANTOT",2024-09-29,"England Premier League","Man United","Tottenham",0,3,"A",11,24,2,10,16,14,5,3,5,3,1,0,0,0,0,3,35,12,30,8,8,1
"20240930BOUSOU",2024-09-30,"England Premier League","Bournemouth","Southampton",3,1,"H",14,9,6,3,19,12,7,4,2,5,0,0,0,0,0,4,23,9,31,11,7,0
"20241005CRYLIV",2024-10-05,"England Premier League","Crystal Palace","Liverpool",0,1,"A",9,16,5,4,7,15,3,8,4,2,0,0,1,0,1,1,25,9,22,11,6,0
"20241005ARSSOU",2024-10-05,"England Premier League","Arsenal","Southampton",3,1,"H",29,8,6,2,10,9,13,1,0,3,0,0,0,0,0,4,37,8,19,14,3,0
"20241005BREWOL",2024-10-05,"England Premier League","Brentford","Wolves",5,3,"H",19,17,12,6,9,10,10,3,2,3,0,0,0,0,0,8,36,18,19,13,5,0
"20241005LEIBOU",2024-10-05,"England Premier League","Leicester","Bournemouth",1,0,"H",6,17,2,2,12,14,0,9,4,1,0,0,0,0,0,1,23,4,26,9,5,0
"20241005MANFUL",2024-10-05,"England Premier League","Man City","Fulham",3,2,"H",20,11,7,4,4,10,8,3,2,1,0,0,0,0,0,5,31,11,14,11,3,0
"20241005WESIPS",2024-10-05,"England Premier League","West Ham","Ipswich",4,1,"H",23,9,13,2,12,6,5,5,0,1,0,0,0,0,0,5,32,15,18,10,1,0
"20241005EVENEW",2024-10-05,"England Premier League","Everton","Newcastle",0,0,"D",8,14,2,3,12,8,0,10,1,2,0,0,0,0,0,0,22,5,20,10,3,0
"20241006ASTMAN",2024-10-06,"England Premier League","Aston Villa","Man United",0,0,"D",11,10,1,4,12,11,6,3,1,5,0,0,0,0,0,0,21,5,23,9,6,0
"20241006CHENOT",2024-10-06,"England Premier League","Chelsea","Nott'm Forest",1,1,"D",22,16,8,9,12,11,11,3,6,2,0,1,0,0,0,2,38,17,23,14,8,1
"20241006BRITOT",2024-10-06,"England Premier League","Brighton","Tottenham",3,2,"H",11,13,4,3,14,10,4,7,2,2,0,0,0,0,0,5,24,7,24,11,4,0
"20241019TOTWES",2024-10-19,"England Premier League","Tottenham","West Ham",4,1,"H",22,11,7,4,10,15,13,5,1,3,0,1,0,0,0,5,33,11,25,18,4,1
"20241019FULAST",2024-10-19,"England Premier League","Fulham","Aston Villa",1,3,"A",10,14,4,5,8,11,6,11,3,3,1,1,0,0,0,4,24,9,19,17,6,2
"20241019IPSEVE",2024-10-19,"England Premier League","Ipswich","Everton",0,2,"A",13,11,2,8,12,10,5,8,1,1,0,0,0,0,0,2,24,10,22,13,2,0
"20241019MANBRE",2024-10-19,"England Premier League","Man United","Brentford",2,1,"H",23,8,11,2,14,5,9,2,2,2,0,0,0,0,0,3,31,13,19,11,4,0
"20241019NEWBRI",2024-10-19,"England Premier League","Newcastle","Brighton",0,1,"A",21,10,6,5,11,9,9,4,2,2,0,0,0,0,0,1,31,11,20,13,4,0
"20241019SOULEI",2024-10-19,"England Premier League","Southampton","Leicester",2,3,"A",14,18,7,4,10,10,10,6,5,3,1,0,0,0,0,5,32,11,20,16,8,1
"20241019BOUARS",2024-10-19,"England Premier League","Bournemouth","Arsenal",2,0,"H",13,6,4,1,12,11,7,4,1,1,0,1,0,0,0,2,19,5,23,11,2,1
"20241020WOLMAN",2024-10-20,"England Premier League","Wolves","Man City",1,2,"A",3,22,2,7,8,5,1,18,4,1,0,0,0,0,0,3,25,9,13,19,5,0
"20241020LIVCHE",2024-10-20,"England Premier League","Liverpool","Chelsea",2,1,"H",9,12,5,2,12,13,1,6,4,3,0,0,0,0,0,3,21,7,25,7,7,0
"20241021NOTCRY",2024-10-21,"England Premier League","Nott'm Forest","Crystal Palace",1,0,"H",20,20,6,7,9,12,6,6,2,3,0,0,0,0,0,1,40,13,21,12,5,0
"20241025LEINOT",2024-10-25,"England Premier League","Leicester","Nott'm Forest",1,3,"A",11,20,1,5,16,9,6,7,5,2,0,0,0,0,0,4,31,6,25,13,7,0
"20241026ASTBOU",2024-10-26,"England Premier League","Aston Villa","Bournemouth",1,1,"D",18,11,8,3,12,14,9,7,7,6,0,0,0,0,0,2,29,11,26,16,13,0
"20241026BREIPS",2024-10-26,"England Premier League","Brentford","Ipswich",4,3,"H",20,11,9,5,7,10,5,5,0,1,0,1,0,0,0,7,31,14,17,10,1,1
"20241026BRIWOL",2024-10-26,"England Premier League","Brighton","Wolves",2,2,"D",19,14,6,7,12,10,9,6,3,3,0,0,0,0,0,4,33,13,22,15,6,0
"20241026MANSOU",2024-10-26,"England Premier League","Man City","Southampton",1,0,"H",22,5,8,2,9,9,12,1,1,3,0,0,0,0,0,1,27,10,18,13,4,0
"20241026EVEFUL",2024-10-26,"England Premier League","Everton","Fulham",1,1,"D",10,14,5,3,8,8,4,2,1,0,0,0,0,0,0,2,24,8,16,6,1,0
"20241027CHENEW",2024-10-27,"England Premier League","Chelsea","Newcastle",2,1,"H",17,11,7,3,13,16,7,4,6,3,0,0,0,0,0,3,28,10,29,11,9,0
"20241027CRYTOT",2024-10-27,"England Premier League","Crystal Palace","Tottenham",1,0,"H",14,11,6,3,16,12,8,8,4,4,0,0,0,0,0,1,25,9,28,16,8,0
"20241027WESMAN",2024-10-27,"England Premier League","West Ham","Man United",2,1,"H",12,18,3,5,6,7,6,5,5,1,0,0,0,0,0,3,30,8,13,11,6,0
"20241027ARSLIV",2024-10-27,"England Premier League","Arsenal","Liverpool",2,2,"D",9,9,3,4,14,14,1,3,2,2,0,0,0,0,0,4,18,7,28,4,4,0
"20241102NEWARS",2024-11-02,"England Premier League","Newcastle","Arsenal",1,0,"H",9,10,4,1,16,18,4,6,4,4,0,0,0,0,0,1,19,5,34,10,8,0
"20241102BOUMAN",2024-11-02,"England Premier League","Bournemouth","Man City",2,1,"H",12,18,6,4,11,6,3,10,2,1,0,0,0,0,0,3,30,10,17,13,3,0
"20241102IPSLEI",2024-11-02,"England Premier League","Ipswich","Leicester",1,1,"D",14,20,2,6,11,10,4,6,4,2,1,0,0,0,0,2,34,8,21,10,6,1
"20241102LIVBRI",2024-11-02,"England Premier League","Liverpool","Brighton",2,1,"H",16,13,8,5,10,18,10,7,1,1,0,0,0,0,0,3,29,13,28,17,2,0
"20241102NOTWES",2024-11-02,"England Premier League","Nott'm Forest","West Ham",3,0,"H",19,4,6,2,7,9,11,6,1,2,0,1,0,0,0,3,23,8,16,17,3,1
"20241102SOUEVE",2024-11-02,"England Premier League","Southampton","Everton",1,0,"H",9,16,2,5,14,18,3,6,4,2,0,0,0,0,0,1,25,7,32,9,6,0
"20241102WOLCRY",2024-11-02,"England Premier League","Wolves","Crystal Palace",2,2,"D",11,19,6,7,7,9,3,6,1,2,0,0,0,0,0,4,30,13,16,9,3,0
"20241103TOTAST",2024-11-03,"England Premier League","Tottenham","Aston Villa",4,1,"H",16,12,6,1,14,14,6,4,2,0,0,0,0,0,0,5,28,7,28,10,2,0
"20241103MANCHE",2024-11-03,"England Premier League","Man United","Chelsea",1,1,"D",11,12,4,3,19,14,4,8,6,2,0,0,0,0,0,2,23,7,33,12,8,0
"20241104FULBRE",2024-11-04,"England Premier League","Fulham","Brentford",2,1,"H",26,5,12,2,3,10,11,3,2,1,0,0,0,0,0,3,31,14,13,14,3,0
"20241109BREBOU",2024-11-09,"England Premier League","Brentford","Bournemouth",3,2,"H",12,15,6,3,8,16,6,4,2,4,0,0,1,0,1,5,27,9,24,10,6,0
"20241109CRYFUL",2024-11-09,"England Premier League","Crystal Palace","Fulham",0,2,"A",13,17,5,7,10,11,1,8,1,1,1,0,0,0,0,2,30,12,21,9,2,1
"20241109WESEVE",2024-11-09,"England Premier League","West Ham","Everton",0,0,"D",11,18,6,4,10,9,7,6,1,2,0,0,0,0,0,0,29,10,19,13,3,0
"20241109WOLSOU",2024-11-09,"England Premier League","Wolves","Southampton",2,0,"H",8,9,4,0,14,12,1,9,1,4,0,0,0,0,0,2,17,4,26,10,5,0
"20241109BRIMAN",2024-11-09,"England Premier League","Brighton","Man City",2,1,"H",10,15,4,6,12,10,0,4,3,3,0,0,0,0,0,3,25,10,22,4,6,0
"20241109LIVAST",2024-11-09,"England Premier League","Liverpool","Aston Villa",2,0,"H",14,12,5,2,11,15,2,9,0,3,0,0,0,0,0,2,26,7,26,11,3,0
"20241110MANLEI",2024-11-10,"England Premier League","Man United","Leicester",3,0,"H",13,6,3,5,9,5,1,5,0,1,0,0,0,0,0,3,19,8,14,6,1,0
"20241110NOTNEW",2024-11-10,"England Premier League","Nott'm Forest","Newcastle",1,3,"A",9,17,3,6,13,6,4,5,1,1,0,0,0,0,0,4,26,9,19,9,2,0
"20241110TOTIPS",2024-11-10,"England Premier League","Tottenham","Ipswich",1,2,"A",17,8,5,3,10,19,12,2,1,5,0,0,0,0,0,3,25,8,29,14,6,0
"20241110CHEARS",2024-11-10,"England Premier League","Chelsea","Arsenal",1,1,"D",17,13,3,3,12,12,4,3,4,2,0,0,0,0,0,2,30,6,24,7,6,0
"20241123LEICHE",2024-11-23,"England Premier League","Leicester","Chelsea",1,2,"A",4,16,1,7,15,12,2,9,4,3,0,0,0,0,0,3,20,8,27,11,7,0
"20241123ARSNOT",2024-11-23,"England Premier League","Arsenal","Nott'm Forest",3,0,"H",19,7,7,0,10,1,8,1,3,2,0,0,0,0,0,3,26,7,11,9,5,0
"20241123ASTCRY",2024-11-23,"England Premier League","Aston Villa","Crystal Palace",2,2,"D",17,13,5,6,10,11,10,1,3,2,0,0,0,0,0,4,30,11,21,11,5,0
"20241123BOUBRI",2024-11-23,"England Premier League","Bournemouth","Brighton",1,2,"A",19,6,5,4,13,10,7,0,2,2,0,1,0,0,0,3,25,9,23,7,4,1
"20241123EVEBRE",2024-11-23,"England Premier League","Everton","Brentford",0,0,"D",27,9,5,2,8,10,10,4,0,0,0,1,0,0,0,0,36,7,18,14,0,1
"20241123FULWOL",2024-11-23,"England Premier League","Fulham","Wolves",1,4,"A",10,10,3,5,14,14,7,2,3,0,0,0,0,0,0,5,20,8,28,9,3,0
"20241123MANTOT",2024-11-23,"England Premier League","Man City","Tottenham",0,4,"A",23,9,5,7,19,9,9,3,4,2,0,0,0,0,0,4,32,12,28,12,6,0
"20241124SOULIV",2024-11-24,"England Premier League","Southampton","Liverpool",2,3,"A",7,27,5,11,11,9,3,10,3,4,0,0,0,0,0,5,34,16,20,13,7,0
"20241124IPSMAN",2024-11-24,"England Premier League","Ipswich","Man United",1,1,"D",11,11,6,4,11,10,4,3,0,0,0,0,0,0,0,2,22,10,21,7,0,0
"20241125NEWWES",2024-11-25,"England Premier League","Newcastle","West Ham",0,2,"A",18,15,2,6,11,8,8,3,1,0,0,0,0,0,0,2,33,8,19,11,1,0
"20241129BRISOU",2024-11-29,"England Premier League","Brighton","Southampton",1,1,"D",22,10,5,2,20,16,7,6,2,4,0,0,0,0,0,2,32,7,36,13,6,0
"20241130BRELEI",2024-11-30,"England Premier League","Brentford","Leicester",4,1,"H",13,7,6,3,9,10,5,4,1,1,0,0,0,0,0,5,20,9,19,9,2,0
"20241130CRYNEW",2024-11-30,"England Premier League","Crystal Palace","Newcastle",1,1,"D",16,1,4,0,12,11,8,9,3,3,0,0,0,0,0,2,17,4,23,17,6,0
"20241130NOTIPS",2024-11-30,"England Premier League","Nott'm Forest","Ipswich",1,0,"H",12,7,5,3,5,16,8,7,1,3,0,0,0,0,0,1,19,8,21,15,4,0
"20241130WOLBOU",2024-11-30,"England Premier League","Wolves","Bournemouth",2,4,"A",10,12,3,8,13,11,3,4,4,1,0,0,0,0,0,6,22,11,24,7,5,0
"20241130WESARS",2024-11-30,"England Premier League","West Ham","Arsenal",2,5,"A",12,16,5,7,10,13,2,10,4,1,0,0,0,0,0,7,28,12,23,12,5,0
"20241201CHEAST",2024-12-01,"England Premier League","Chelsea","Aston Villa",3,0,"H",17,10,8,4,21,6,3,4,2,2,0,0,0,0,0,3,27,12,27,7,4,0
"20241201MANEVE",2024-12-01,"England Premier League","Man United","Everton",4,0,"H",11,8,5,2,12,12,2,2,2,3,0,0,0,0,0,4,19,7,24,4,5,0
"20241201TOTFUL",2024-12-01,"England Premier League","Tottenham","Fulham",1,1,"D",8,14,3,6,4,14,7,11,0,1,0,1,0,0,0,2,22,9,18,18,1,1
"20241201LIVMAN",2024-12-01,"England Premier League","Liverpool","Man City",2,0,"H",18,8,7,2,9,8,7,4,1,3,0,0,0,0,0,2,26,9,17,11,4,0
"20241203IPSCRY",2024-12-03,"England Premier League","Ipswich","Crystal Palace",0,1,"A",9,13,2,3,14,13,4,7,2,4,0,0,0,0,0,1,22,5,27,11,6,0
"20241203LEIWES",2024-12-03,"England Premier League","Leicester","West Ham",3,1,"H",8,31,6,10,9,7,3,9,2,2,0,0,0,0,0,4,39,16,16,12,4,0
"20241204EVEWOL",2024-12-04,"England Premier League","Everton","Wolves",4,0,"H",13,6,4,2,10,8,3,4,2,0,0,0,0,0,0,4,19,6,18,7,2,0
"20241204MANNOT",2024-12-04,"England Premier League","Man City","Nott'm Forest",3,0,"H",17,12,7,3,7,15,8,2,2,4,0,0,0,0,0,3,29,10,22,10,6,0
"20241204NEWLIV",2024-12-04,"England Premier League","Newcastle","Liverpool",3,3,"D",17,16,6,5,9,17,5,6,2,5,0,0,0,0,0,6,33,11,26,11,7,0
"20241204SOUCHE",2024-12-04,"England Premier League","Southampton","Chelsea",1,5,"A",6,26,4,13,7,14,5,7,1,0,1,0,1,1,0,6,32,17,21,12,1,1
"20241204ARSMAN",2024-12-04,"England Premier League","Arsenal","Man United",2,0,"H",14,5,6,2,12,8,13,0,1,3,0,0,0,0,0,2,19,8,20,13,4,0
"20241204ASTBRE",2024-12-04,"England Premier League","Aston Villa","Brentford",3,1,"H",20,9,10,1,11,15,10,5,2,2,0,0,0,0,0,4,29,11,26,15,4,0
"20241205FULBRI",2024-12-05,"England Premier League","Fulham","Brighton",3,1,"H",6,13,2,3,7,8,5,6,2,2,0,0,0,0,0,4,19,5,15,11,4,0
"20241205BOUTOT",2024-12-05,"England Premier League","Bournemouth","Tottenham",1,0,"H",21,12,8,4,15,8,5,9,2,2,0,0,0,0,0,1,33,12,23,14,4,0
"20241207ASTSOU",2024-12-07,"England Premier League","Aston Villa","Southampton",1,0,"H",18,4,5,0,18,15,14,1,1,3,0,0,0,0,0,1,22,5,33,15,4,0
"20241207BRENEW",2024-12-07,"England Premier League","Brentford","Newcastle",4,2,"H",11,16,8,3,10,7,3,4,3,0,0,0,0,0,0,6,27,11,17,7,3,0
"20241207CRYMAN",2024-12-07,"England Premier League","Crystal Palace","Man City",2,2,"D",12,12,3,4,4,10,6,8,1,0,0,1,0,0,0,4,24,7,14,14,1,1
"20241207MANNOT",2024-12-07,"England Premier League","Man United","Nott'm Forest",2,3,"A",17,11,7,3,10,13,5,3,0,2,0,0,0,0,0,5,28,10,23,8,2,0
"20241208FULARS",2024-12-08,"England Premier League","Fulham","Arsenal",1,1,"D",2,12,2,4,10,9,0,6,4,2,0,0,0,0,0,2,14,6,19,6,6,0
"20241208IPSBOU",2024-12-08,"England Premier League","Ipswich","Bournemouth",1,2,"A",18,22,5,6,9,13,6,13,2,1,0,0,0,0,0,3,40,11,22,19,3,0
"20241208LEIBRI",2024-12-08,"England Premier League","Leicester","Brighton",2,2,"D",10,16,3,7,9,10,5,5,1,2,0,0,0,0,0,4,26,10,19,10,3,0
"20241208TOTCHE",2024-12-08,"England Premier League","Tottenham","Chelsea",3,4,"A",13,17,5,8,17,11,5,10,2,2,0,0,0,0,0,7,30,13,28,15,4,0
"20241209WESWOL",2024-12-09,"England Premier League","West Ham","Wolves",2,1,"H",19,19,4,5,12,17,11,0,5,4,0,0,0,0,0,3,38,9,29,11,9,0
"20241214ARSEVE",2024-12-14,"England Premier League","Arsenal","Everton",0,0,"D",13,2,5,0,6,9,8,2,0,3,0,0,0,0,0,0,15,5,15,10,3,0
"20241214LIVFUL",2024-12-14,"England Premier League","Liverpool","Fulham",2,2,"D",16,12,4,3,10,7,5,4,3,4,1,0,0,0,0,4,28,7,17,9,7,1
"20241214NEWLEI",2024-12-14,"England Premier League","Newcastle","Leicester",4,0,"H",27,4,11,1,7,16,5,2,3,3,0,0,0,0,0,4,31,12,23,7,6,0
"20241214WOLIPS",2024-12-14,"England Premier League","Wolves","Ipswich",1,2,"A",16,10,6,5,13,9,7,3,0,2,1,0,0,0,0,3,26,11,22,10,2,1
"20241214NOTAST",2024-12-14,"England Premier League","Nott'm Forest","Aston Villa",2,1,"H",17,8,6,2,12,6,4,3,0,1,0,0,0,0,0,3,25,8,18,7,1,0
"20241215BRICRY",2024-12-15,"England Premier League","Brighton","Crystal Palace",1,3,"A",17,13,5,5,11,15,8,5,1,4,0,0,0,0,0,4,30,10,26,13,5,0
"20241215MANMAN",2024-12-15,"England Premier League","Man City","Man United",1,2,"A",10,10,3,3,5,14,8,2,1,1,0,0,0,0,0,3,20,6,19,10,2,0
"20241215CHEBRE",2024-12-15,"England Premier League","Chelsea","Brentford",2,1,"H",26,9,8,4,11,7,8,5,0,2,1,0,0,0,0,3,35,12,18,13,2,1
"20241215SOUTOT",2024-12-15,"England Premier League","Southampton","Tottenham",0,5,"A",9,18,3,9,8,15,2,5,1,3,0,0,0,0,0,5,27,12,23,7,4,0
"20241216BOUWES",2024-12-16,"England Premier League","Bournemouth","West Ham",1,1,"D",29,16,9,3,6,11,12,6,0,2,0,0,0,0,0,2,45,12,17,18,2,0
"20241221ASTMAN",2024-12-21,"England Premier League","Aston Villa","Man City",2,1,"H",11,12,6,6,14,7,5,4,3,3,0,0,0,0,0,3,23,12,21,9,6,0
"20241221BRENOT",2024-12-21,"England Premier League","Brentford","Nott'm Forest",0,2,"A",7,10,3,6,9,14,9,5,3,4,0,0,0,0,0,2,17,9,23,14,7,0
"20241221IPSNEW",2024-12-21,"England Premier League","Ipswich","Newcastle",0,4,"A",10,15,2,7,9,7,2,1,2,0,0,0,0,0,0,4,25,9,16,3,2,0
"20241221WESBRI",2024-12-21,"England Premier League","West Ham","Brighton",1,1,"D",11,12,4,6,14,20,8,4,2,2,0,0,0,0,0,2,23,10,34,12,4,0
"20241221CRYARS",2024-12-21,"England Premier League","Crystal Palace","Arsenal",1,5,"A",15,14,6,6,9,8,3,3,2,2,0,0,0,0,0,6,29,12,17,6,4,0
"20241222EVECHE",2024-12-22,"England Premier League","Everton","Chelsea",0,0,"D",5,12,4,5,20,12,2,5,4,1,0,0,0,0,0,0,17,9,32,7,5,0
"20241222FULSOU",2024-12-22,"England Premier League","Fulham","Southampton",0,0,"D",16,5,5,1,8,15,6,5,1,3,0,0,0,0,0,0,21,6,23,11,4,0
"20241222LEIWOL",2024-12-22,"England Premier League","Leicester","Wolves",0,3,"A",9,8,5,4,15,16,6,1,2,0,0,0,0,0,0,3,17,9,31,7,2,0
"20241222MANBOU",2024-12-22,"England Premier League","Man United","Bournemouth",0,3,"A",23,10,7,5,11,11,13,1,1,3,0,0,0,0,0,3,33,12,22,14,4,0
"20241222TOTLIV",2024-12-22,"England Premier League","Tottenham","Liverpool",3,6,"A",9,24,5,12,7,9,7,5,1,2,0,0,0,0,0,9,33,17,16,12,3,0
"20241226MANEVE",2024-12-26,"England Premier League","Man City","Everton",1,1,"D",24,8,5,3,5,10,8,5,1,4,0,0,0,0,0,2,32,8,15,13,5,0
"20241226BOUCRY",2024-12-26,"England Premier League","Bournemouth","Crystal Palace",0,0,"D",18,10,4,4,13,12,5,2,2,2,0,0,0,0,0,0,28,8,25,7,4,0
"20241226CHEFUL",2024-12-26,"England Premier League","Chelsea","Fulham",1,2,"A",12,14,8,7,13,13,3,1,1,3,0,0,0,0,0,3,26,15,26,4,4,0
"20241226NEWAST",2024-12-26,"England Premier League","Newcastle","Aston Villa",3,0,"H",22,4,8,1,15,10,9,6,2,1,0,1,0,0,0,3,26,9,25,15,3,1
"20241226NOTTOT",2024-12-26,"England Premier League","Nott'm Forest","Tottenham",1,0,"H",10,13,3,4,12,13,2,7,3,2,0,1,0,0,0,1,23,7,25,9,5,1
"20241226SOUWES",2024-12-26,"England Premier League","Southampton","West Ham",0,1,"A",18,16,5,2,15,8,2,2,1,2,0,0,0,0,0,1,34,7,23,4,3,0
"20241226WOLMAN",2024-12-26,"England Premier League","Wolves","Man United",2,0,"H",7,11,4,4,12,12,4,4,2,2,0,1,0,0,0,2,18,8,24,8,4,1
"20241226LIVLEI",2024-12-26,"England Premier League","Liverpool","Leicester",3,1,"H",19,4,7,1,17,5,14,1,3,2,0,0,0,0,0,4,23,8,22,15,5,0
"20241227BRIBRE",2024-12-27,"England Premier League","Brighton","Brentford",0,0,"D",24,8,7,3,6,12,5,3,0,2,0,0,0,0,0,0,32,10,18,8,2,0
"20241227ARSIPS",2024-12-27,"England Premier League","Arsenal","Ipswich",1,0,"H",13,3,5,0,7,12,5,1,1,1,0,0,0,0,0,1,16,5,19,6,2,0
"20241229LEIMAN",2024-12-29,"England Premier League","Leicester","Man City",0,2,"A",11,14,4,5,11,6,4,4,2,1,0,0,1,1,0,2,25,9,17,8,3,0
"20241229CRYSOU",2024-12-29,"England Premier League","Crystal Palace","Southampton",2,1,"H",19,7,10,3,18,19,8,7,2,3,0,0,0,0,0,3,26,13,37,15,5,0
"20241229EVENOT",2024-12-29,"England Premier League","Everton","Nott'm Forest",0,2,"A",13,11,2,7,13,10,5,4,4,1,0,0,0,0,0,2,24,9,23,9,5,0
"20241229FULBOU",2024-12-29,"England Premier League","Fulham","Bournemouth",2,2,"D",11,16,6,9,7,16,1,7,1,3,0,0,0,0,0,4,27,15,23,8,4,0
"20241229TOTWOL",2024-12-29,"England Premier League","Tottenham","Wolves",2,2,"D",13,11,3,3,9,10,5,5,1,2,0,0,0,0,0,4,24,6,19,10,3,0
"20241229WESLIV",2024-12-29,"England Premier League","West Ham","Liverpool",0,5,"A",7,22,0,13,7,10,3,6,0,0,0,0,0,0,0,5,29,13,17,9,0,0
"20241230ASTBRI",2024-12-30,"England Premier League","Aston Villa","Brighton",2,2,"D",20,13,4,4,9,14,12,3,2,3,0,0,0,0,0,4,33,8,23,15,5,0
"20241230IPSCHE",2024-12-30,"England Premier League","Ipswich","Chelsea",2,0,"H",9,20,6,5,9,5,4,7,4,4,0,0,0,0,0,2,29,11,14,11,8,0
"20241230MANNEW",2024-12-30,"England Premier League","Man United","Newcastle",0,2,"A",10,12,0,4,13,8,2,3,1,1,0,0,0,0,0,2,22,4,21,5,2,0
"20220117CELHIB",2022-01-17,"Scotland Premiership","Celtic","Hibernian",2,0,"H",21,5,5,0,14,9,8,1,1,2,0,0,0,0,0,2,26,5,23,9,3,0
"20220118ABERAN",2022-01-18,"Scotland Premiership","Aberdeen","Rangers",1,1,"D",15,7,3,4,7,21,6,4,4,3,0,1,0,0,0,2,22,7,28,10,7,1
"20220118DUNST ",2022-01-18,"Scotland Premiership","Dundee United","St Mirren",1,2,"A",16,11,4,3,17,10,8,8,3,1,0,0,0,0,0,3,27,7,27,16,4,0
"20220118HEAST ",2022-01-18,"Scotland Premiership","Hearts","St Johnstone",2,0,"H",16,14,8,6,9,11,4,2,2,3,0,0,0,0,0,2,30,14,20,6,5,0
"20220118LIVDUN",2022-01-18,"Scotland Premiership","Livingston","Dundee",2,0,"H",13,9,5,4,10,12,4,9,3,3,0,0,0,0,0,2,22,9,22,13,6,0
"20220118ROSMOT",2022-01-18,"Scotland Premiership","Ross County","Motherwell",3,1,"H",5,13,2,3,14,9,5,6,1,2,1,0,0,0,0,4,18,5,23,11,3,1
"20220125ST ABE",2022-01-25,"Scotland Premiership","St Mirren","Aberdeen",1,0,"H",4,11,1,0,8,13,4,4,1,1,0,0,0,0,0,1,15,1,21,8,2,0
"20220126DUNROS",2022-01-26,"Scotland Premiership","Dundee United","Ross County",2,1,"H",24,16,5,5,10,14,6,6,1,4,0,0,0,0,0,3,40,10,24,12,5,0
"20220126HEACEL",2022-01-26,"Scotland Premiership","Hearts","Celtic",1,2,"A",8,20,1,8,14,12,4,10,3,3,0,0,0,0,0,3,28,9,26,14,6,0
"20220126MOTHIB",2022-01-26,"Scotland Premiership","Motherwell","Hibernian",0,0,"D",9,4,2,0,14,14,4,5,2,2,1,0,0,0,0,0,13,2,28,9,4,1
"20220126RANLIV",2022-01-26,"Scotland Premiership","Rangers","Livingston",1,0,"H",18,6,6,2,11,9,10,4,1,2,0,0,1,0,1,1,24,8,20,14,3,0
"20220126ST DUN",2022-01-26,"Scotland Premiership","St Johnstone","Dundee",0,0,"D",9,10,4,2,14,12,8,2,1,1,0,0,0,0,0,0,19,6,26,10,2,0
"20220129ROSRAN",2022-01-29,"Scotland Premiership","Ross County","Rangers",3,3,"D",6,26,4,12,10,7,4,8,3,0,0,0,0,0,0,6,32,16,17,12,3,0
"20220129CELDUN",2022-01-29,"Scotland Premiership","Celtic","Dundee United",1,0,"H",21,7,8,0,10,7,14,2,1,2,1,0,0,0,0,1,28,8,17,16,3,1
"20220129HEAMOT",2022-01-29,"Scotland Premiership","Hearts","Motherwell",2,0,"H",11,8,5,2,12,16,5,2,1,2,0,0,0,0,0,2,19,7,28,7,3,0
"20220129HIBLIV",2022-01-29,"Scotland Premiership","Hibernian","Livingston",2,3,"A",11,19,5,9,11,8,4,4,1,1,0,0,0,0,0,5,30,14,19,8,2,0
"20220201DUNDUN",2022-02-01,"Scotland Premiership","Dundee","Dundee United",0,0,"D",12,11,5,0,16,14,11,6,1,0,0,0,0,0,0,0,23,5,30,17,1,0
"20220201HIBHEA",2022-02-01,"Scotland Premiership","Hibernian","Hearts",0,0,"D",11,12,2,4,13,13,3,5,2,3,0,0,0,0,0,0,23,6,26,8,5,0
"20220201LIVST ",2022-02-01,"Scotland Premiership","Livingston","St Johnstone",1,2,"A",13,10,2,5,13,14,4,6,3,2,1,0,0,0,0,3,23,7,27,10,5,1
"20220201ROSABE",2022-02-01,"Scotland Premiership","Ross County","Aberdeen",1,1,"D",5,19,2,7,22,21,2,5,5,3,0,0,0,0,0,2,24,9,43,7,8,0
"20220201ST MOT",2022-02-01,"Scotland Premiership","St Mirren","Motherwell",1,1,"D",7,14,3,7,7,15,6,1,0,1,0,0,0,0,0,2,21,10,22,7,1,0
"20220202CELRAN",2022-02-02,"Scotland Premiership","Celtic","Rangers",3,0,"H",11,9,7,2,14,10,10,2,2,3,0,0,0,0,0,3,20,9,24,12,5,0
"20220205DUNROS",2022-02-05,"Scotland Premiership","Dundee","Ross County",1,2,"A",11,10,3,6,17,10,7,6,2,4,1,0,0,0,0,3,21,9,27,13,6,1
"20220205HIBST ",2022-02-05,"Scotland Premiership","Hibernian","St Mirren",0,1,"A",17,9,6,4,11,12,8,2,2,1,0,0,0,0,0,1,26,10,23,10,3,0
"20220205LIVABE",2022-02-05,"Scotland Premiership","Livingston","Aberdeen",2,1,"H",8,14,4,6,24,10,7,5,6,4,1,0,0,0,0,3,22,10,34,12,10,1
"20220205ST DUN",2022-02-05,"Scotland Premiership","St Johnstone","Dundee United",0,0,"D",7,14,2,3,8,9,7,13,1,2,1,0,0,0,0,0,21,5,17,20,3,1
"20220206MOTCEL",2022-02-06,"Scotland Premiership","Motherwell","Celtic",0,4,"A",7,18,1,10,17,13,4,10,3,1,0,0,0,0,0,4,25,11,30,14,4,0
"20220206RANHEA",2022-02-06,"Scotland Premiership","Rangers","Hearts",5,0,"H",22,9,11,3,12,12,4,3,2,2,0,0,0,0,0,5,31,14,24,7,4,0
"20220209ABECEL",2022-02-09,"Scotland Premiership","Aberdeen","Celtic",2,3,"A",8,12,4,5,11,17,1,3,2,1,0,0,0,0,0,5,20,9,28,4,3,0
"20220209DUNMOT",2022-02-09,"Scotland Premiership","Dundee United","Motherwell",2,0,"H",8,17,2,2,14,15,3,5,0,2,0,0,0,0,0,2,25,4,29,8,2,0
"20220209HEADUN",2022-02-09,"Scotland Premiership","Hearts","Dundee",1,2,"A",17,12,9,3,9,9,9,4,0,3,0,0,0,0,0,3,29,12,18,13,3,0
"20220209RANHIB",2022-02-09,"Scotland Premiership","Rangers","Hibernian",2,0,"H",18,12,4,4,14,15,7,8,3,2,0,0,0,0,0,2,30,8,29,15,5,0
"20220209ROSLIV",2022-02-09,"Scotland Premiership","Ross County","Livingston",1,1,"D",9,17,4,4,12,11,8,6,2,3,0,0,0,0,0,2,26,8,23,14,5,0
"20220209ST ST ",2022-02-09,"Scotland Premiership","St Mirren","St Johnstone",2,1,"H",13,9,4,4,6,14,5,5,2,3,0,0,0,0,0,3,22,8,20,10,5,0
"20220215ABEST ",2022-02-15,"Scotland Premiership","Aberdeen","St Johnstone",1,1,"D",20,7,9,2,10,18,7,4,1,2,0,0,0,0,0,2,27,11,28,11,3,0
"20220219HIBROS",2022-02-19,"Scotland Premiership","Hibernian","Ross County",2,0,"H",15,4,6,3,14,13,7,4,3,4,0,0,0,0,0,2,19,9,27,11,7,0
"20220219LIVST ",2022-02-19,"Scotland Premiership","Livingston","St Mirren",1,1,"D",14,4,2,1,14,15,5,1,2,0,0,1,0,0,0,2,18,3,29,6,2,1
"20220219MOTABE",2022-02-19,"Scotland Premiership","Motherwell","Aberdeen",1,1,"D",20,6,4,5,15,19,9,3,4,3,0,0,0,0,0,2,26,9,34,12,7,0
"20220219ST HEA",2022-02-19,"Scotland Premiership","St Johnstone","Hearts",2,1,"H",14,13,4,5,11,9,6,8,2,0,0,0,0,0,0,3,27,9,20,14,2,0
"20220220DUNRAN",2022-02-20,"Scotland Premiership","Dundee United","Rangers",1,1,"D",5,29,2,3,12,6,6,11,3,1,0,0,0,0,0,2,34,5,18,17,4,0
"20220220CELDUN",2022-02-20,"Scotland Premiership","Celtic","Dundee",3,2,"H",19,4,6,2,9,7,11,2,1,1,0,0,0,0,0,5,23,8,16,13,2,0
"20220226ABEDUN",2022-02-26,"Scotland Premiership","Aberdeen","Dundee United",1,1,"D",13,6,5,3,10,17,3,3,2,2,0,0,0,0,0,2,19,8,27,6,4,0
"20220226DUNLIV",2022-02-26,"Scotland Premiership","Dundee","Livingston",0,4,"A",9,17,1,6,11,13,5,4,2,0,0,0,0,0,0,4,26,7,24,9,2,0
"20220226ROSST ",2022-02-26,"Scotland Premiership","Ross County","St Johnstone",3,1,"H",6,15,3,3,11,13,5,8,1,2,0,0,0,0,0,4,21,6,24,13,3,0
"20220226ST HEA",2022-02-26,"Scotland Premiership","St Mirren","Hearts",0,2,"A",6,19,0,9,5,11,8,9,2,4,1,0,0,0,0,2,25,9,16,17,6,1
"20220227HIBCEL",2022-02-27,"Scotland Premiership","Hibernian","Celtic",0,0,"D",2,13,0,3,9,16,3,9,5,2,0,0,0,0,0,0,15,3,25,12,7,0
"20220227RANMOT",2022-02-27,"Scotland Premiership","Rangers","Motherwell",2,2,"D",30,5,10,3,8,16,15,1,2,3,0,0,0,0,0,4,35,13,24,16,5,0
"20220302CELST ",2022-03-02,"Scotland Premiership","Celtic","St Mirren",2,0,"H",21,4,6,1,9,7,9,0,2,2,0,0,0,0,0,2,25,7,16,9,4,0
"20220302DUNHIB",2022-03-02,"Scotland Premiership","Dundee","Hibernian",0,0,"D",5,12,1,4,8,12,3,8,2,3,0,1,0,0,0,0,17,5,20,11,5,1
"20220302HEAABE",2022-03-02,"Scotland Premiership","Hearts","Aberdeen",2,0,"H",13,7,4,4,15,11,6,1,1,1,0,0,0,0,0,2,20,8,26,7,2,0
"20220302LIVDUN",2022-03-02,"Scotland Premiership","Livingston","Dundee United",2,1,"H",21,8,5,2,12,11,3,2,0,1,0,0,0,0,0,3,29,7,23,5,1,0
"20220302MOTROS",2022-03-02,"Scotland Premiership","Motherwell","Ross County",0,1,"A",17,6,4,3,12,14,6,1,0,1,0,0,0,0,0,1,23,7,26,7,1,0
"20220302ST RAN",2022-03-02,"Scotland Premiership","St Johnstone","Rangers",0,1,"A",3,12,1,3,9,10,2,1,1,1,0,0,0,0,0,1,15,4,19,3,2,0
"20220305DUNHEA",2022-03-05,"Scotland Premiership","Dundee United","Hearts",2,2,"D",8,14,2,3,14,7,2,5,4,2,0,0,0,0,0,4,22,5,21,7,6,0
"20220305HIBST ",2022-03-05,"Scotland Premiership","Hibernian","St Johnstone",0,0,"D",13,5,3,0,15,16,9,3,3,3,0,0,0,0,0,0,18,3,31,12,6,0
"20220305MOTDUN",2022-03-05,"Scotland Premiership","Motherwell","Dundee",1,1,"D",16,11,5,3,11,10,3,3,0,2,0,0,0,0,0,2,27,8,21,6,2,0
"20220305RANABE",2022-03-05,"Scotland Premiership","Rangers","Aberdeen",1,0,"H",20,2,2,0,12,16,11,2,1,3,0,0,0,0,0,1,22,2,28,13,4,0
"20220305ROSST ",2022-03-05,"Scotland Premiership","Ross County","St Mirren",1,0,"H",7,8,2,2,15,9,2,3,0,1,0,0,0,0,0,1,15,4,24,5,1,0
"20220306LIVCEL",2022-03-06,"Scotland Premiership","Livingston","Celtic",1,3,"A",6,24,3,7,15,13,5,8,3,1,0,0,0,0,0,4,30,10,28,13,4,0
"20220309DUNST ",2022-03-09,"Scotland Premiership","Dundee","St Mirren",0,1,"A",7,12,1,3,8,10,5,4,0,2,0,0,0,0,0,1,19,4,18,9,2,0
"20220319ABEHIB",2022-03-19,"Scotland Premiership","Aberdeen","Hibernian",3,1,"H",14,7,5,2,17,14,4,5,2,4,0,1,0,0,0,4,21,7,31,9,6,1
"20220319CELROS",2022-03-19,"Scotland Premiership","Celtic","Ross County",4,0,"H",24,3,10,1,9,10,16,5,0,1,0,1,0,0,0,4,27,11,19,21,1,1
"20220319HEALIV",2022-03-19,"Scotland Premiership","Hearts","Livingston",2,0,"H",14,6,5,2,8,11,6,5,0,4,0,0,0,0,0,2,20,7,19,11,4,0
"20220319ST MOT",2022-03-19,"Scotland Premiership","St Johnstone","Motherwell",2,1,"H",8,7,2,4,14,11,3,6,3,2,0,0,0,0,0,3,15,6,25,9,5,0
"20220319ST DUN",2022-03-19,"Scotland Premiership","St Mirren","Dundee United",1,2,"A",10,14,1,5,8,8,11,9,3,0,1,0,0,0,0,3,24,6,16,20,3,1
"20220320DUNRAN",2022-03-20,"Scotland Premiership","Dundee","Rangers",1,2,"A",3,19,1,8,17,10,1,8,3,1,0,0,0,0,0,3,22,9,27,9,4,0
"20220402DUNABE",2022-04-02,"Scotland Premiership","Dundee","Aberdeen",2,2,"D",13,21,5,8,11,17,2,7,1,1,0,0,0,0,0,4,34,13,28,9,2,0
"20220402HIBDUN",2022-04-02,"Scotland Premiership","Hibernian","Dundee United",1,1,"D",21,6,4,1,13,10,7,4,1,2,0,0,0,0,0,2,27,5,23,11,3,0
"20220402MOTST ",2022-04-02,"Scotland Premiership","Motherwell","St Mirren",4,2,"H",13,10,6,4,12,10,8,6,0,1,0,0,0,0,0,6,23,10,22,14,1,0
"20220402ROSHEA",2022-04-02,"Scotland Premiership","Ross County","Hearts",1,1,"D",18,19,5,4,16,13,6,4,3,1,0,0,0,0,0,2,37,9,29,10,4,0
"20220402ST LIV",2022-04-02,"Scotland Premiership","St Johnstone","Livingston",1,0,"H",6,11,3,4,10,13,1,6,2,3,0,0,0,0,0,1,17,7,23,7,5,0
"20220403RANCEL",2022-04-03,"Scotland Premiership","Rangers","Celtic",1,2,"A",16,11,6,5,7,13,4,4,1,4,0,0,0,0,0,3,27,11,20,8,5,0
"20220409ABEROS",2022-04-09,"Scotland Premiership","Aberdeen","Ross County",0,1,"A",15,4,2,1,11,14,3,1,2,3,0,0,0,0,0,1,19,3,25,4,5,0
"20220409CELST ",2022-04-09,"Scotland Premiership","Celtic","St Johnstone",7,0,"H",23,1,10,0,3,5,7,2,0,0,0,0,0,0,0,7,24,10,8,9,0,0
"20220409DUNDUN",2022-04-09,"Scotland Premiership","Dundee United","Dundee",2,2,"D",11,13,3,7,16,12,1,5,3,2,0,0,0,0,0,4,24,10,28,6,5,0
"20220409HEAHIB",2022-04-09,"Scotland Premiership","Hearts","Hibernian",3,1,"H",15,8,4,1,11,13,5,1,1,3,0,0,0,0,0,4,23,5,24,6,4,0
"20220409LIVMOT",2022-04-09,"Scotland Premiership","Livingston","Motherwell",2,2,"D",12,6,4,2,7,18,6,6,1,2,0,0,0,0,0,4,18,6,25,12,3,0
"20220410ST RAN",2022-04-10,"Scotland Premiership","St Mirren","Rangers",0,4,"A",7,22,3,8,9,3,4,5,1,0,0,0,0,0,0,4,29,11,12,9,1,0
"20220423MOTRAN",2022-04-23,"Scotland Premiership","Motherwell","Rangers",1,3,"A",8,9,2,5,13,14,5,2,3,1,0,1,0,0,0,4,17,7,27,7,4,1
"20220423ABELIV",2022-04-23,"Scotland Premiership","Aberdeen","Livingston",1,2,"A",18,9,5,4,12,11,12,6,3,2,1,0,0,0,0,3,27,9,23,18,5,1
"20220423DUNST ",2022-04-23,"Scotland Premiership","Dundee","St Johnstone",1,1,"D",10,18,1,5,16,13,4,7,1,2,0,0,0,0,0,2,28,6,29,11,3,0
"20220423ST HIB",2022-04-23,"Scotland Premiership","St Mirren","Hibernian",0,1,"A",11,7,2,2,9,16,5,3,1,2,0,0,0,0,0,1,18,4,25,8,3,0
"20220424ROSCEL",2022-04-24,"Scotland Premiership","Ross County","Celtic",0,2,"A",6,22,1,5,13,9,2,11,2,0,0,0,0,0,0,2,28,6,22,13,2,0
"20220424DUNHEA",2022-04-24,"Scotland Premiership","Dundee United","Hearts",2,3,"A",11,20,6,7,8,10,5,9,2,4,0,0,0,0,0,5,31,13,18,14,6,0
"20220430ABEDUN",2022-04-30,"Scotland Premiership","Aberdeen","Dundee",1,0,"H",19,11,5,4,10,16,6,6,1,1,0,0,0,0,0,1,30,9,26,12,2,0
"20220430DUNMOT",2022-04-30,"Scotland Premiership","Dundee United","Motherwell",1,0,"H",8,12,3,2,11,19,8,4,3,3,0,0,0,0,0,1,20,5,30,12,6,0
"20220430HEAROS",2022-04-30,"Scotland Premiership","Hearts","Ross County",0,0,"D",17,6,3,3,7,15,7,1,0,4,0,0,0,0,0,0,23,6,22,8,4,0
"20220430LIVHIB",2022-04-30,"Scotland Premiership","Livingston","Hibernian",1,0,"H",9,18,3,0,13,18,5,9,3,2,0,0,0,0,0,1,27,3,31,14,5,0
"20220430ST ST ",2022-04-30,"Scotland Premiership","St Johnstone","St Mirren",0,1,"A",5,12,0,3,12,13,6,5,1,2,0,0,0,0,0,1,17,3,25,11,3,0
"20220501CELRAN",2022-05-01,"Scotland Premiership","Celtic","Rangers",1,1,"D",9,14,1,5,14,9,2,7,3,4,0,0,0,0,0,2,23,6,23,9,7,0
"20220507CELHEA",2022-05-07,"Scotland Premiership","Celtic","Hearts",4,1,"H",21,6,12,3,17,8,3,3,0,2,0,0,0,0,0,5,27,15,25,6,2,0
"20220507HIBABE",2022-05-07,"Scotland Premiership","Hibernian","Aberdeen",1,1,"D",17,8,5,2,12,11,10,4,0,1,0,0,0,0,0,2,25,7,23,14,1,0
"20220507LIVST ",2022-05-07,"Scotland Premiership","Livingston","St Johnstone",1,1,"D",11,8,3,5,16,17,3,2,1,2,0,0,0,0,0,2,19,8,33,5,3,0
"20220507ROSMOT",2022-05-07,"Scotland Premiership","Ross County","Motherwell",0,1,"A",14,9,4,2,12,10,13,5,2,3,0,0,0,0,0,1,23,6,22,18,5,0
"20220507ST DUN",2022-05-07,"Scotland Premiership","St Mirren","Dundee",2,0,"H",14,12,5,1,17,7,11,6,4,1,0,0,0,0,0,2,26,6,24,17,5,0
"20220508RANDUN",2022-05-08,"Scotland Premiership","Rangers","Dundee United",2,0,"H",20,3,5,0,7,8,8,1,1,2,0,0,0,0,0,2,23,5,15,9,3,0
"20220510DUNHIB",2022-05-10,"Scotland Premiership","Dundee","Hibernian",3,1,"H",14,16,9,6,15,13,4,6,2,3,0,0,0,0,0,4,30,15,28,10,5,0
"20220511DUNCEL",2022-05-11,"Scotland Premiership","Dundee United","Celtic",1,1,"D",10,13,2,2,3,11,1,10,0,1,0,0,0,0,0,2,23,4,14,11,1,0
"20220511MOTHEA",2022-05-11,"Scotland Premiership","Motherwell","Hearts",2,1,"H",8,15,3,5,14,6,3,6,1,0,0,0,0,0,0,3,23,8,20,9,1,0
"20220511RANROS",2022-05-11,"Scotland Premiership","Rangers","Ross County",4,1,"H",33,3,8,1,5,11,8,1,0,3,0,0,0,0,0,5,36,9,16,9,3,0
"20220511ST ABE",2022-05-11,"Scotland Premiership","St Johnstone","Aberdeen",1,0,"H",9,9,2,2,17,15,6,3,5,2,0,0,0,0,0,1,18,4,32,9,7,0
"20220511ST LIV",2022-05-11,"Scotland Premiership","St Mirren","Livingston",0,0,"D",10,10,1,3,14,10,6,4,1,3,0,0,0,0,0,0,20,4,24,10,4,0
"20220514CELMOT",2022-05-14,"Scotland Premiership","Celtic","Motherwell",6,0,"H",15,6,8,1,16,6,15,3,0,1,0,0,0,0,0,6,21,9,22,18,1,0
"20220514HEARAN",2022-05-14,"Scotland Premiership","Hearts","Rangers",1,3,"A",9,12,3,6,6,10,6,3,1,2,0,0,0,0,0,4,21,9,16,9,3,0
"20220514ROSDUN",2022-05-14,"Scotland Premiership","Ross County","Dundee United",1,2,"A",10,16,4,4,10,9,2,5,1,0,0,0,0,0,0,3,26,8,19,7,1,0
"20220515ABEST ",2022-05-15,"Scotland Premiership","Aberdeen","St Mirren",0,0,"D",18,6,5,1,13,14,11,1,1,2,0,0,0,0,0,0,24,6,27,12,3,0
"20220515HIBST ",2022-05-15,"Scotland Premiership","Hibernian","St Johnstone",4,0,"H",14,11,6,4,11,11,4,6,1,2,0,0,0,0,0,4,25,10,22,10,3,0
"20220515LIVDUN",2022-05-15,"Scotland Premiership","Livingston","Dundee",2,1,"H",18,19,5,4,8,10,10,8,1,2,0,0,0,0,0,3,37,9,18,18,3,0
"20220730LIVRAN",2022-07-30,"Scotland Premiership","Livingston","Rangers",1,2,"A",5,21,2,6,17,15,0,8,3,4,0,0,1,1,0,3,26,8,32,8,7,0
"20220730HEAROS",2022-07-30,"Scotland Premiership","Hearts","Ross County",2,1,"H",15,12,4,3,6,15,4,2,1,2,0,0,0,0,0,3,27,7,21,6,3,0
"20220730KILDUN",2022-07-30,"Scotland Premiership","Kilmarnock","Dundee United",1,1,"D",18,7,5,5,11,11,4,4,2,0,0,1,0,0,0,2,25,10,22,8,2,1
"20220730ST HIB",2022-07-30,"Scotland Premiership","St Johnstone","Hibernian",0,1,"A",4,14,1,1,12,15,3,9,2,4,1,0,0,0,0,1,18,2,27,12,6,1
"20220731ST MOT",2022-07-31,"Scotland Premiership","St Mirren","Motherwell",0,1,"A",19,9,6,2,9,11,8,2,4,4,0,1,0,0,0,1,28,8,20,10,8,1
"20220731CELABE",2022-07-31,"Scotland Premiership","Celtic","Aberdeen",2,0,"H",21,5,9,3,11,12,9,3,1,2,0,0,0,0,0,2,26,12,23,12,3,0
"20220806ABEST ",2022-08-06,"Scotland Premiership","Aberdeen","St Mirren",4,1,"H",23,6,10,1,12,15,4,4,1,2,0,1,0,0,0,5,29,11,27,8,3,1
"20220806MOTST ",2022-08-06,"Scotland Premiership","Motherwell","St Johnstone",1,2,"A",12,10,2,3,17,9,4,6,1,3,0,0,0,0,0,3,22,5,26,10,4,0
"20220806RANKIL",2022-08-06,"Scotland Premiership","Rangers","Kilmarnock",2,0,"H",18,4,4,0,13,17,8,3,0,6,0,0,0,0,0,2,22,4,30,11,6,0
"20220806ROSCEL",2022-08-06,"Scotland Premiership","Ross County","Celtic",1,3,"A",5,23,2,7,10,4,3,12,4,2,0,0,0,0,0,4,28,9,14,15,6,0
"20220807HIBHEA",2022-08-07,"Scotland Premiership","Hibernian","Hearts",1,1,"D",12,12,3,6,18,13,7,9,3,1,0,0,0,0,0,2,24,9,31,16,4,0
"20220807DUNLIV",2022-08-07,"Scotland Premiership","Dundee United","Livingston",0,1,"A",10,11,3,4,11,14,9,4,2,3,0,0,0,0,0,1,21,7,25,13,5,0
"20220813ABEMOT",2022-08-13,"Scotland Premiership","Aberdeen","Motherwell",2,3,"A",14,19,3,6,9,10,5,12,1,2,0,0,1,1,0,5,33,9,19,17,3,0
"20220813LIVHIB",2022-08-13,"Scotland Premiership","Livingston","Hibernian",2,1,"H",12,23,6,5,15,10,3,14,1,2,0,0,0,0,0,3,35,11,25,17,3,0
"20220813RANST ",2022-08-13,"Scotland Premiership","Rangers","St Johnstone",4,0,"H",24,4,8,1,9,10,9,1,1,2,0,0,0,0,0,4,28,9,19,10,3,0
"20220813ST ROS",2022-08-13,"Scotland Premiership","St Mirren","Ross County",1,0,"H",8,5,2,1,10,10,6,5,1,1,0,0,0,0,0,1,13,3,20,11,2,0
"20220814KILCEL",2022-08-14,"Scotland Premiership","Kilmarnock","Celtic",0,5,"A",12,20,3,11,18,11,2,8,4,2,0,0,0,0,0,5,32,14,29,10,6,0
"20220814HEADUN",2022-08-14,"Scotland Premiership","Hearts","Dundee United",4,1,"H",13,10,12,2,8,11,3,2,0,4,0,0,0,0,0,5,23,14,19,5,4,0
"20220820HIBRAN",2022-08-20,"Scotland Premiership","Hibernian","Rangers",2,2,"D",14,9,5,2,19,7,5,3,4,2,0,2,0,0,0,4,23,7,26,8,6,2
"20220820DUNST ",2022-08-20,"Scotland Premiership","Dundee United","St Mirren",0,3,"A",13,12,3,5,10,17,6,7,3,2,0,0,0,0,0,3,25,8,27,13,5,0
"20220820MOTLIV",2022-08-20,"Scotland Premiership","Motherwell","Livingston",1,0,"H",13,5,2,1,15,16,2,1,1,0,0,1,0,0,0,1,18,3,31,3,1,1
"20220820ROSKIL",2022-08-20,"Scotland Premiership","Ross County","Kilmarnock",1,0,"H",8,14,5,2,15,16,1,7,3,4,1,0,0,0,0,1,22,7,31,8,7,1
"20220820ST ABE",2022-08-20,"Scotland Premiership","St Johnstone","Aberdeen",0,1,"A",7,15,1,4,18,12,5,5,5,0,0,0,0,0,0,1,22,5,30,10,5,0
"20220821CELHEA",2022-08-21,"Scotland Premiership","Celtic","Hearts",2,0,"H",15,4,7,0,11,12,4,6,0,3,0,2,0,0,0,2,19,7,23,10,3,2
"20220827ABELIV",2022-08-27,"Scotland Premiership","Aberdeen","Livingston",5,0,"H",20,7,6,3,2,11,8,3,0,4,0,1,0,0,0,5,27,9,13,11,4,1
"20220827KILMOT",2022-08-27,"Scotland Premiership","Kilmarnock","Motherwell",2,1,"H",21,10,4,6,11,20,8,4,2,1,0,0,0,0,0,3,31,10,31,12,3,0
"20220827RANROS",2022-08-27,"Scotland Premiership","Rangers","Ross County",4,0,"H",31,4,13,0,10,10,7,1,2,2,0,0,0,0,0,4,35,13,20,8,4,0
"20220827ST HIB",2022-08-27,"Scotland Premiership","St Mirren","Hibernian",1,0,"H",14,14,2,1,8,12,4,10,1,3,0,0,0,0,0,1,28,3,20,14,4,0
"20220828DUNCEL",2022-08-28,"Scotland Premiership","Dundee United","Celtic",0,9,"A",6,30,2,13,6,7,2,11,1,0,0,0,0,0,0,9,36,15,13,13,1,0
"20220828HEAST ",2022-08-28,"Scotland Premiership","Hearts","St Johnstone",3,2,"H",27,9,6,5,9,13,3,4,0,4,0,0,0,0,0,5,36,11,22,7,4,0
"20220903CELRAN",2022-09-03,"Scotland Premiership","Celtic","Rangers",4,0,"H",15,11,6,2,12,11,3,4,3,3,0,0,0,0,0,4,26,8,23,7,6,0
"20220903HIBKIL",2022-09-03,"Scotland Premiership","Hibernian","Kilmarnock",1,0,"H",25,7,8,1,12,10,7,3,2,3,0,1,0,0,0,1,32,9,22,10,5,1
"20220903LIVHEA",2022-09-03,"Scotland Premiership","Livingston","Hearts",1,0,"H",12,6,6,0,13,13,3,3,4,2,0,0,0,0,0,1,18,6,26,6,6,0
"20220903MOTDUN",2022-09-03,"Scotland Premiership","Motherwell","Dundee United",0,0,"D",21,11,5,3,16,15,3,6,2,1,0,0,0,0,0,0,32,8,31,9,3,0
"20220903ROSABE",2022-09-03,"Scotland Premiership","Ross County","Aberdeen",1,1,"D",11,11,2,5,8,5,3,13,0,2,0,0,0,0,0,2,22,7,13,16,2,0
"20220903ST ST ",2022-09-03,"Scotland Premiership","St Johnstone","St Mirren",3,0,"H",9,10,4,2,4,15,1,9,2,5,0,0,0,0,0,3,19,6,19,10,7,0
"20220917HIBABE",2022-09-17,"Scotland Premiership","Hibernian","Aberdeen",3,1,"H",25,5,8,1,19,14,10,2,2,4,0,1,0,0,0,4,30,9,33,12,6,1
"20220917LIVKIL",2022-09-17,"Scotland Premiership","Livingston","Kilmarnock",1,0,"H",9,3,1,1,14,12,5,4,1,2,0,0,0,0,0,1,12,2,26,9,3,0
"20220917RANDUN",2022-09-17,"Scotland Premiership","Rangers","Dundee United",2,1,"H",17,10,6,5,10,8,7,4,3,2,0,0,0,0,0,3,27,11,18,11,5,0
"20220917ST ROS",2022-09-17,"Scotland Premiership","St Johnstone","Ross County",0,0,"D",15,9,1,1,9,12,5,3,4,2,0,0,1,1,0,0,24,2,21,8,6,0
"20220918ST CEL",2022-09-18,"Scotland Premiership","St Mirren","Celtic",2,0,"H",4,18,2,4,15,11,6,7,3,2,0,0,0,0,0,2,22,6,26,13,5,0
"20220918MOTHEA",2022-09-18,"Scotland Premiership","Motherwell","Hearts",0,3,"A",25,10,5,6,12,13,6,2,3,2,0,0,0,0,0,3,35,11,25,8,5,0
"20221001HEARAN",2022-10-01,"Scotland Premiership","Hearts","Rangers",0,4,"A",7,20,1,7,11,12,5,7,1,2,1,0,0,0,0,4,27,8,23,12,3,1
"20221001ABEKIL",2022-10-01,"Scotland Premiership","Aberdeen","Kilmarnock",4,1,"H",16,7,8,3,12,11,5,5,1,2,0,0,0,0,0,5,23,11,23,10,3,0
"20221001CELMOT",2022-10-01,"Scotland Premiership","Celtic","Motherwell",2,1,"H",17,7,6,2,10,9,7,4,1,4,1,0,0,0,0,3,24,8,19,11,5,1
"20221001DUNST ",2022-10-01,"Scotland Premiership","Dundee United","St Johnstone",1,2,"A",19,12,6,3,11,11,9,0,5,3,0,0,0,0,0,3,31,9,22,9,8,0
"20221001ROSHIB",2022-10-01,"Scotland Premiership","Ross County","Hibernian",0,2,"A",9,24,2,9,13,14,6,11,1,0,0,0,0,0,0,2,33,11,27,17,1,0
"20221001ST LIV",2022-10-01,"Scotland Premiership","St Mirren","Livingston",2,1,"H",8,10,3,3,16,11,6,7,3,1,1,0,0,0,0,3,18,6,27,13,4,1
"20221004ROSMOT",2022-10-04,"Scotland Premiership","Ross County","Motherwell",0,5,"A",9,11,1,6,16,13,4,3,3,2,0,0,0,0,0,5,20,7,29,7,5,0
"20221005KILST ",2022-10-05,"Scotland Premiership","Kilmarnock","St Johnstone",2,1,"H",11,15,2,5,16,16,5,5,0,3,0,0,0,0,0,3,26,7,32,10,3,0
"20221008ST CEL",2022-10-08,"Scotland Premiership","St Johnstone","Celtic",1,2,"A",8,11,3,4,14,10,2,8,3,3,0,0,0,0,0,3,19,7,24,10,6,0
"20221008HIBMOT",2022-10-08,"Scotland Premiership","Hibernian","Motherwell",1,0,"H",14,9,5,1,16,10,3,7,2,4,0,1,0,0,0,1,23,6,26,10,6,1
"20221008LIVROS",2022-10-08,"Scotland Premiership","Livingston","Ross County",0,1,"A",22,5,3,1,10,18,9,2,0,3,0,0,0,0,0,1,27,4,28,11,3,0
"20221008RANST ",2022-10-08,"Scotland Premiership","Rangers","St Mirren",4,0,"H",19,9,8,3,10,10,8,5,0,2,0,0,1,0,1,4,28,11,20,13,2,0
"20221008DUNABE",2022-10-08,"Scotland Premiership","Dundee United","Aberdeen",4,0,"H",14,14,8,1,9,13,5,1,2,1,0,0,0,0,0,4,28,9,22,6,3,0
"20221009KILHEA",2022-10-09,"Scotland Premiership","Kilmarnock","Hearts",2,2,"D",14,11,6,5,21,13,6,3,2,1,0,0,0,0,0,4,25,11,34,9,3,0
"20221011DUNHIB",2022-10-11,"Scotland Premiership","Dundee United","Hibernian",1,0,"H",9,18,1,7,11,13,5,10,5,2,0,0,0,0,0,1,27,8,24,15,7,0
"20221015CELHIB",2022-10-15,"Scotland Premiership","Celtic","Hibernian",6,1,"H",20,9,9,5,17,7,7,2,1,0,0,0,0,0,0,7,29,14,24,9,1,0
"20221015LIVST ",2022-10-15,"Scotland Premiership","Livingston","St Johnstone",1,0,"H",14,10,4,3,20,18,8,2,3,3,0,0,0,0,0,1,24,7,38,10,6,0
"20221015ROSDUN",2022-10-15,"Scotland Premiership","Ross County","Dundee United",1,1,"D",6,14,1,3,12,11,4,10,1,0,0,0,0,0,0,2,20,4,23,14,1,0
"20221015ST KIL",2022-10-15,"Scotland Premiership","St Mirren","Kilmarnock",0,0,"D",14,14,3,4,20,12,6,8,3,2,0,0,0,0,0,0,28,7,32,14,5,0
"20221016MOTRAN",2022-10-16,"Scotland Premiership","Motherwell","Rangers",1,2,"A",5,7,2,4,15,18,3,3,3,4,0,0,0,0,0,3,12,6,33,6,7,0
"20221016ABEHEA",2022-10-16,"Scotland Premiership","Aberdeen","Hearts",2,0,"H",16,13,5,3,11,16,4,1,3,3,0,0,0,0,0,2,29,8,27,5,6,0
"20221021HIBST ",2022-10-21,"Scotland Premiership","Hibernian","St Johnstone",1,2,"A",15,7,5,5,17,10,1,1,4,1,1,0,0,0,0,3,22,10,27,2,5,1
"20221022HEACEL",2022-10-22,"Scotland Premiership","Hearts","Celtic",3,4,"A",15,11,7,6,9,15,3,6,2,1,0,0,0,0,0,7,26,13,24,9,3,0
"20221022KILROS",2022-10-22,"Scotland Premiership","Kilmarnock","Ross County",1,0,"H",11,10,6,4,9,9,5,7,2,2,0,0,0,0,0,1,21,10,18,12,4,0
"20221022MOTABE",2022-10-22,"Scotland Premiership","Motherwell","Aberdeen",1,2,"A",12,7,4,3,14,8,4,0,3,2,0,0,0,0,0,3,19,7,22,4,5,0
"20221022RANLIV",2022-10-22,"Scotland Premiership","Rangers","Livingston",1,1,"D",24,5,3,1,9,12,14,1,2,2,0,1,0,0,0,2,29,4,21,15,4,1
"20221022ST DUN",2022-10-22,"Scotland Premiership","St Mirren","Dundee United",2,1,"H",15,10,2,3,19,5,6,6,1,1,0,0,0,0,0,3,25,5,24,12,2,0
"20221029DUNMOT",2022-10-29,"Scotland Premiership","Dundee United","Motherwell",0,1,"A",10,9,3,2,13,14,10,5,0,1,1,0,0,0,0,1,19,5,27,15,1,1
"20221029HIBST ",2022-10-29,"Scotland Premiership","Hibernian","St Mirren",3,0,"H",16,11,4,3,12,16,6,6,2,3,0,0,0,0,0,3,27,7,28,12,5,0
"20221029RANABE",2022-10-29,"Scotland Premiership","Rangers","Aberdeen",4,1,"H",36,5,13,1,9,12,13,4,0,3,0,0,0,0,0,5,41,14,21,17,3,0
"20221029ST KIL",2022-10-29,"Scotland Premiership","St Johnstone","Kilmarnock",1,0,"H",8,7,2,2,15,10,3,6,5,1,0,0,0,0,0,1,15,4,25,9,6,0
"20221030LIVCEL",2022-10-30,"Scotland Premiership","Livingston","Celtic",0,3,"A",4,16,2,6,15,15,0,4,2,3,0,0,0,0,0,3,20,8,30,4,5,0
"20221030ROSHEA",2022-10-30,"Scotland Premiership","Ross County","Hearts",1,2,"A",15,12,7,3,11,4,6,1,3,2,0,0,0,0,0,3,27,10,15,7,5,0
"20221104ABEHIB",2022-11-04,"Scotland Premiership","Aberdeen","Hibernian",4,1,"H",7,17,6,6,10,7,5,4,2,2,0,0,0,0,0,5,24,12,17,9,4,0
"20221104KILLIV",2022-11-04,"Scotland Premiership","Kilmarnock","Livingston",2,3,"A",13,10,4,4,13,12,5,4,3,3,0,0,0,0,0,5,23,8,25,9,6,0
"20221105CELDUN",2022-11-05,"Scotland Premiership","Celtic","Dundee United",4,2,"H",24,6,12,3,9,9,11,2,3,2,0,0,0,0,0,6,30,15,18,13,5,0
"20221105ROSST ",2022-11-05,"Scotland Premiership","Ross County","St Mirren",3,2,"H",10,11,4,4,9,13,7,5,2,3,0,0,0,0,0,5,21,8,22,12,5,0
"20221106ST RAN",2022-11-06,"Scotland Premiership","St Johnstone","Rangers",2,1,"H",11,29,3,7,7,13,0,20,2,0,0,0,0,0,0,3,40,10,20,20,2,0
"20221106HEAMOT",2022-11-06,"Scotland Premiership","Hearts","Motherwell",3,2,"H",15,18,7,5,8,15,6,11,2,3,1,0,0,0,0,5,33,12,23,17,5,1
"20221108HIBROS",2022-11-08,"Scotland Premiership","Hibernian","Ross County",0,2,"A",21,6,4,3,10,19,4,3,1,3,0,0,0,0,0,2,27,7,29,7,4,0
"20221108LIVABE",2022-11-08,"Scotland Premiership","Livingston","Aberdeen",2,1,"H",8,24,3,10,11,9,7,8,4,3,0,0,0,0,0,3,32,13,20,15,7,0
"20221109DUNKIL",2022-11-09,"Scotland Premiership","Dundee United","Kilmarnock",4,0,"H",7,16,6,0,13,7,3,4,0,1,0,0,0,0,0,4,23,6,20,7,1,0
"20221109MOTCEL",2022-11-09,"Scotland Premiership","Motherwell","Celtic",1,2,"A",7,16,2,3,7,11,5,10,2,1,0,0,0,0,0,3,23,5,18,15,3,0
"20221109RANHEA",2022-11-09,"Scotland Premiership","Rangers","Hearts",1,0,"H",17,7,6,0,9,7,7,5,3,1,0,0,0,0,0,1,24,6,16,12,4,0
"20221109ST ST ",2022-11-09,"Scotland Premiership","St Mirren","St Johnstone",2,2,"D",11,8,4,2,9,7,6,3,4,3,0,1,2,0,2,4,19,6,16,9,7,1
"20221112ST RAN",2022-11-12,"Scotland Premiership","St Mirren","Rangers",1,1,"D",10,14,3,4,13,11,6,5,2,1,0,0,0,0,0,2,24,7,24,11,3,0
"20221112CELROS",2022-11-12,"Scotland Premiership","Celtic","Ross County",2,1,"H",22,2,7,2,14,5,9,0,1,4,0,0,1,1,0,3,24,9,19,9,5,0
"20221112HEALIV",2022-11-12,"Scotland Premiership","Hearts","Livingston",1,1,"D",15,18,6,7,9,10,11,6,1,1,1,0,0,0,0,2,33,13,19,17,2,1
"20221112KILHIB",2022-11-12,"Scotland Premiership","Kilmarnock","Hibernian",1,0,"H",6,15,1,1,12,13,0,5,2,3,0,0,0,0,0,1,21,2,25,5,5,0
"20221112ST MOT",2022-11-12,"Scotland Premiership","St Johnstone","Motherwell",1,1,"D",10,12,3,3,11,20,8,4,2,4,0,0,0,0,0,2,22,6,31,12,6,0
"20221112ABEDUN",2022-11-12,"Scotland Premiership","Aberdeen","Dundee United",1,0,"H",9,6,2,2,11,12,3,3,1,0,0,0,0,0,0,1,15,4,23,6,1,0
"20221215RANHIB",2022-12-15,"Scotland Premiership","Rangers","Hibernian",3,2,"H",22,8,9,5,10,10,8,4,1,3,0,0,0,0,0,5,30,14,20,12,4,0
"20221217ABECEL",2022-12-17,"Scotland Premiership","Aberdeen","Celtic",0,1,"A",2,33,0,10,8,8,0,7,1,0,0,0,0,0,0,1,35,10,16,7,1,0
"20221217HEAKIL",2022-12-17,"Scotland Premiership","Hearts","Kilmarnock",3,1,"H",13,14,5,5,17,17,7,2,1,1,0,0,0,0,0,4,27,10,34,9,2,0
"20221217ROSST ",2022-12-17,"Scotland Premiership","Ross County","St Johnstone",1,2,"A",3,21,1,7,9,8,0,6,1,1,1,0,0,0,0,3,24,8,17,6,2,1
"20221220ABERAN",2022-12-20,"Scotland Premiership","Aberdeen","Rangers",2,3,"A",8,14,2,8,8,13,3,5,5,5,0,0,0,0,0,5,22,10,21,8,10,0
"20221221CELLIV",2022-12-21,"Scotland Premiership","Celtic","Livingston",2,1,"H",23,3,10,2,10,8,10,1,2,3,0,0,0,0,0,3,26,12,18,11,5,0
"20221223ROSRAN",2022-12-23,"Scotland Premiership","Ross County","Rangers",0,1,"A",6,17,1,6,17,6,0,4,2,1,0,0,0,0,0,1,23,7,23,4,3,0
"20221223MOTKIL",2022-12-23,"Scotland Premiership","Motherwell","Kilmarnock",2,2,"D",15,3,4,2,15,12,13,1,2,0,0,1,0,0,0,4,18,6,27,14,2,1
"20221224CELST ",2022-12-24,"Scotland Premiership","Celtic","St Johnstone",4,1,"H",20,7,10,3,12,4,9,1,2,1,1,0,0,0,0,5,27,13,16,10,3,1
"20221224ST ABE",2022-12-24,"Scotland Premiership","St Mirren","Aberdeen",3,1,"H",16,11,4,5,16,8,8,5,4,1,0,1,0,0,0,4,27,9,24,13,5,1
"20221224DUNHEA",2022-12-24,"Scotland Premiership","Dundee United","Hearts",2,2,"D",11,14,6,3,15,8,6,9,4,2,0,0,0,0,0,4,25,9,23,15,6,0
"20221224HIBLIV",2022-12-24,"Scotland Premiership","Hibernian","Livingston",4,0,"H",27,8,11,3,13,14,9,1,2,4,0,1,0,0,0,4,35,14,27,10,6,1
"20221228DUNROS",2022-12-28,"Scotland Premiership","Dundee United","Ross County",3,0,"H",11,8,6,0,12,10,3,2,2,0,0,1,0,0,0,3,19,6,22,5,2,1
"20221228KILABE",2022-12-28,"Scotland Premiership","Kilmarnock","Aberdeen",2,1,"H",17,9,4,2,12,11,2,6,2,2,0,0,0,0,0,3,26,6,23,8,4,0
"20221228LIVST ",2022-12-28,"Scotland Premiership","Livingston","St Mirren",1,1,"D",8,16,3,4,8,17,4,5,1,2,1,1,1,1,0,2,24,7,25,9,3,2
"20221228RANMOT",2022-12-28,"Scotland Premiership","Rangers","Motherwell",3,0,"H",19,6,10,2,8,14,7,7,2,3,0,0,0,0,0,3,25,12,22,14,5,0
"20221228ST HEA",2022-12-28,"Scotland Premiership","St Johnstone","Hearts",2,3,"A",15,16,3,3,14,7,4,11,4,1,0,0,2,0,2,5,31,6,21,15,5,0
"20221228HIBCEL",2022-12-28,"Scotland Premiership","Hibernian","Celtic",0,4,"A",6,20,1,7,9,7,5,14,0,0,0,0,0,0,0,4,26,8,16,19,0,0
"20230102RANCEL",2023-01-02,"Scotland Premiership","Rangers","Celtic",2,2,"D",15,8,5,2,11,13,5,4,1,1,0,0,0,0,0,4,23,7,24,9,2,0
"20230102ABEROS",2023-01-02,"Scotland Premiership","Aberdeen","Ross County",0,0,"D",22,7,6,1,5,12,11,1,0,4,0,0,0,0,0,0,29,7,17,12,4,0
"20230102HEAHIB",2023-01-02,"Scotland Premiership","Hearts","Hibernian",3,0,"H",9,14,5,4,10,14,3,4,2,3,0,0,0,0,0,3,23,9,24,7,5,0
"20230102KILST ",2023-01-02,"Scotland Premiership","Kilmarnock","St Mirren",0,0,"D",12,6,3,0,8,11,6,4,2,3,0,1,0,0,0,0,18,3,19,10,5,1
"20230102LIVMOT",2023-01-02,"Scotland Premiership","Livingston","Motherwell",1,1,"D",11,16,6,5,8,15,5,4,3,2,0,0,0,0,0,2,27,11,23,9,5,0
"20230102ST DUN",2023-01-02,"Scotland Premiership","St Johnstone","Dundee United",0,1,"A",8,10,2,2,13,8,3,2,3,1,0,0,0,0,0,1,18,4,21,5,4,0
"20230107ABEST ",2023-01-07,"Scotland Premiership","Aberdeen","St Johnstone",2,0,"H",16,10,7,1,12,11,9,2,0,3,0,0,0,0,0,2,26,8,23,11,3,0
"20230107CELKIL",2023-01-07,"Scotland Premiership","Celtic","Kilmarnock",2,0,"H",24,2,10,0,9,11,4,3,0,0,0,0,0,0,0,2,26,10,20,7,0,0
"20230107ROSLIV",2023-01-07,"Scotland Premiership","Ross County","Livingston",0,2,"A",10,12,2,5,8,7,4,4,0,1,0,0,0,0,0,2,22,7,15,8,1,0
"20230107ST HEA",2023-01-07,"Scotland Premiership","St Mirren","Hearts",1,1,"D",13,10,5,3,18,7,3,4,2,2,1,0,0,0,0,2,23,8,25,7,4,1
"20230108MOTHIB",2023-01-08,"Scotland Premiership","Motherwell","Hibernian",2,3,"A",13,10,3,4,12,9,5,2,2,1,0,0,0,0,0,5,23,7,21,7,3,0
"20230108DUNRAN",2023-01-08,"Scotland Premiership","Dundee United","Rangers",0,2,"A",6,20,1,10,4,2,1,7,1,0,0,0,0,0,0,2,26,11,6,8,1,0
"20230113HEAST ",2023-01-13,"Scotland Premiership","Hearts","St Mirren",1,0,"H",12,19,3,4,8,13,5,5,2,4,0,0,0,0,0,1,31,7,21,10,6,0
"20230114HIBDUN",2023-01-14,"Scotland Premiership","Hibernian","Dundee United",2,2,"D",16,12,6,4,10,8,3,6,2,3,0,0,0,0,0,4,28,10,18,9,5,0
"20230114MOTROS",2023-01-14,"Scotland Premiership","Motherwell","Ross County",1,1,"D",11,12,3,5,15,9,7,3,2,3,0,0,0,0,0,2,23,8,24,10,5,0
"20230114ST LIV",2023-01-14,"Scotland Premiership","St Johnstone","Livingston",2,4,"A",15,11,5,5,13,10,5,3,1,1,0,0,0,0,0,6,26,10,23,8,2,0
"20230118CELST ",2023-01-18,"Scotland Premiership","Celtic","St Mirren",4,0,"H",17,9,6,3,5,5,8,2,0,0,0,0,0,0,0,4,26,9,10,10,0,0
"20230118HEAABE",2023-01-18,"Scotland Premiership","Hearts","Aberdeen",5,0,"H",12,9,6,2,18,15,3,8,1,1,0,0,0,0,0,5,21,8,33,11,2,0
"20230118KILRAN",2023-01-18,"Scotland Premiership","Kilmarnock","Rangers",2,3,"A",10,13,5,7,12,15,3,4,1,2,1,0,0,0,0,5,23,12,27,7,3,1
"20230128HIBABE",2023-01-28,"Scotland Premiership","Hibernian","Aberdeen",6,0,"H",12,11,8,0,17,12,6,9,2,3,0,1,0,0,0,6,23,8,29,15,5,1
"20230128RANST ",2023-01-28,"Scotland Premiership","Rangers","St Johnstone",2,0,"H",20,4,11,1,16,11,9,3,3,3,0,1,0,0,0,2,24,12,27,12,6,1
"20230128ROSKIL",2023-01-28,"Scotland Premiership","Ross County","Kilmarnock",3,0,"H",10,18,5,3,19,12,0,5,1,1,0,0,0,0,0,3,28,8,31,5,2,0
"20230128ST MOT",2023-01-28,"Scotland Premiership","St Mirren","Motherwell",1,0,"H",9,8,2,2,14,11,6,5,3,2,0,0,0,0,0,1,17,4,25,11,5,0
"20230129LIVHEA",2023-01-29,"Scotland Premiership","Livingston","Hearts",0,0,"D",5,8,4,5,16,15,1,5,0,2,0,0,0,0,0,0,13,9,31,6,2,0
"20230129DUNCEL",2023-01-29,"Scotland Premiership","Dundee United","Celtic",0,2,"A",4,18,2,6,7,12,1,3,2,0,0,0,0,0,0,2,22,8,19,4,2,0
"20230131ROSHIB",2023-01-31,"Scotland Premiership","Ross County","Hibernian",1,1,"D",11,12,2,3,10,11,3,3,3,4,0,0,0,0,0,2,23,5,21,6,7,0
"20230201ABEST ",2023-02-01,"Scotland Premiership","Aberdeen","St Mirren",1,3,"A",6,22,2,6,11,11,2,11,4,2,1,0,0,0,0,4,28,8,22,13,6,1
"20230201CELLIV",2023-02-01,"Scotland Premiership","Celtic","Livingston",3,0,"H",15,6,5,0,11,5,8,0,1,1,0,0,0,0,0,3,21,5,16,8,2,0
"20230201HEARAN",2023-02-01,"Scotland Premiership","Hearts","Rangers",0,3,"A",6,20,2,9,7,11,1,7,3,3,0,0,0,0,0,3,26,11,18,8,6,0
"20230201KILDUN",2023-02-01,"Scotland Premiership","Kilmarnock","Dundee United",1,0,"H",26,7,5,3,9,8,7,2,1,3,0,0,0,0,0,1,33,8,17,9,4,0
"20230201MOTST ",2023-02-01,"Scotland Premiership","Motherwell","St Johnstone",0,2,"A",5,12,1,4,15,10,1,3,2,1,0,0,0,0,0,2,17,5,25,4,3,0
"20230204ABEMOT",2023-02-04,"Scotland Premiership","Aberdeen","Motherwell",3,1,"H",12,4,7,1,9,18,9,2,4,3,0,0,0,0,0,4,16,8,27,11,7,0
"20230204HEADUN",2023-02-04,"Scotland Premiership","Hearts","Dundee United",3,1,"H",19,10,7,2,13,11,10,3,3,2,1,1,0,0,0,4,29,9,24,13,5,2
"20230204LIVKIL",2023-02-04,"Scotland Premiership","Livingston","Kilmarnock",3,1,"H",12,9,7,3,16,13,5,5,2,2,0,0,0,0,0,4,21,10,29,10,4,0
"20230204RANROS",2023-02-04,"Scotland Premiership","Rangers","Ross County",2,1,"H",26,10,7,3,8,9,4,6,4,2,0,0,0,0,0,3,36,10,17,10,6,0
"20230204ST HIB",2023-02-04,"Scotland Premiership","St Mirren","Hibernian",0,1,"A",8,9,3,3,13,6,5,4,1,2,0,0,0,0,0,1,17,6,19,9,3,0
"20230205ST CEL",2023-02-05,"Scotland Premiership","St Johnstone","Celtic",1,4,"A",6,12,2,4,5,11,3,4,2,2,1,0,0,0,0,5,18,6,16,7,4,1
"20230215MOTST ",2023-02-15,"Scotland Premiership","Motherwell","St Mirren",2,1,"H",7,10,4,4,7,20,3,2,2,4,0,0,0,0,0,3,17,8,27,5,6,0
"20230218CELABE",2023-02-18,"Scotland Premiership","Celtic","Aberdeen",4,0,"H",20,5,10,0,13,6,8,0,0,0,0,0,0,0,0,4,25,10,19,8,0,0
"20230218DUNST ",2023-02-18,"Scotland Premiership","Dundee United","St Johnstone",1,2,"A",19,9,4,5,7,12,11,6,2,2,0,0,1,1,0,3,28,9,19,17,4,0
"20230218HIBKIL",2023-02-18,"Scotland Premiership","Hibernian","Kilmarnock",2,0,"H",20,9,11,3,12,7,8,4,1,0,0,1,0,0,0,2,29,14,19,12,1,1
"20230218LIVRAN",2023-02-18,"Scotland Premiership","Livingston","Rangers",0,3,"A",6,13,1,8,15,8,2,9,2,1,1,0,0,0,0,3,19,9,23,11,3,1
"20230218ST ROS",2023-02-18,"Scotland Premiership","St Mirren","Ross County",1,0,"H",19,10,5,2,8,9,10,8,0,1,0,1,0,0,0,1,29,7,17,18,1,1
"20230219MOTHEA",2023-02-19,"Scotland Premiership","Motherwell","Hearts",2,0,"H",13,13,3,3,14,8,5,9,1,1,0,0,0,0,0,2,26,6,22,14,2,0
"20230225ABELIV",2023-02-25,"Scotland Premiership","Aberdeen","Livingston",1,0,"H",12,6,2,1,11,11,8,8,0,3,0,0,0,0,0,1,18,3,22,16,3,0
"20230225KILMOT",2023-02-25,"Scotland Premiership","Kilmarnock","Motherwell",1,1,"D",8,13,3,7,17,15,4,6,3,3,0,0,0,0,0,2,21,10,32,10,6,0
"20230225ROSDUN",2023-02-25,"Scotland Premiership","Ross County","Dundee United",4,0,"H",22,9,11,3,11,10,3,2,2,2,0,0,0,0,0,4,31,14,21,5,4,0
"20230225ST ST ",2023-02-25,"Scotland Premiership","St Johnstone","St Mirren",1,1,"D",7,21,2,5,8,8,5,2,1,0,1,0,0,0,0,2,28,7,16,7,1,1
"20230304HEAST ",2023-03-04,"Scotland Premiership","Hearts","St Johnstone",3,0,"H",12,15,7,5,7,8,8,7,0,0,0,0,0,0,0,3,27,12,15,15,0,0
"20230304LIVHIB",2023-03-04,"Scotland Premiership","Livingston","Hibernian",1,4,"A",9,12,1,7,10,15,4,3,3,3,1,0,0,0,0,5,21,8,25,7,6,1
"20230304RANKIL",2023-03-04,"Scotland Premiership","Rangers","Kilmarnock",3,1,"H",21,3,8,2,19,13,7,4,1,2,0,0,0,0,0,4,24,10,32,11,3,0
"20230304ROSMOT",2023-03-04,"Scotland Premiership","Ross County","Motherwell",0,2,"A",17,13,6,3,14,10,9,4,0,2,1,0,0,0,0,2,30,9,24,13,2,1
"20230304DUNABE",2023-03-04,"Scotland Premiership","Dundee United","Aberdeen",1,3,"A",24,9,6,4,10,5,10,5,2,3,0,0,0,0,0,4,33,10,15,15,5,0
"20230305ST CEL",2023-03-05,"Scotland Premiership","St Mirren","Celtic",1,5,"A",1,16,1,8,14,7,0,6,1,0,1,0,0,0,0,6,17,9,21,6,1,1
"20230308CELHEA",2023-03-08,"Scotland Premiership","Celtic","Hearts",3,1,"H",11,5,3,3,6,9,7,3,0,2,0,0,0,0,0,4,16,6,15,10,2,0
"20230308HIBRAN",2023-03-08,"Scotland Premiership","Hibernian","Rangers",1,4,"A",4,31,1,11,15,5,3,7,2,0,0,0,0,0,0,5,35,12,20,10,2,0
"20230308LIVDUN",2023-03-08,"Scotland Premiership","Livingston","Dundee United",1,1,"D",17,6,4,1,10,16,4,6,1,6,0,0,0,0,0,2,23,5,26,10,7,0
"20230318MOTRAN",2023-03-18,"Scotland Premiership","Motherwell","Rangers",2,4,"A",3,28,2,10,9,12,1,3,1,1,1,0,0,0,0,6,31,12,21,4,2,1
"20230318ABEHEA",2023-03-18,"Scotland Premiership","Aberdeen","Hearts",3,0,"H",22,8,6,0,12,10,7,7,3,3,0,0,0,0,0,3,30,6,22,14,6,0
"20230318CELHIB",2023-03-18,"Scotland Premiership","Celtic","Hibernian",3,1,"H",35,3,9,1,6,7,15,0,1,3,0,1,0,0,0,4,38,10,13,15,4,1
"20230318DUNST ",2023-03-18,"Scotland Premiership","Dundee United","St Mirren",1,1,"D",11,16,2,3,11,9,1,4,1,1,0,0,0,0,0,2,27,5,20,5,2,0
"20230318KILST ",2023-03-18,"Scotland Premiership","Kilmarnock","St Johnstone",1,1,"D",14,9,4,2,10,21,9,5,3,5,0,0,0,0,0,2,23,6,31,14,8,0
"20230318LIVROS",2023-03-18,"Scotland Premiership","Livingston","Ross County",2,1,"H",13,11,7,1,8,17,8,6,3,1,0,0,0,0,0,3,24,8,25,14,4,0
"20230401HIBMOT",2023-04-01,"Scotland Premiership","Hibernian","Motherwell",1,3,"A",11,17,3,5,12,7,6,5,3,1,0,0,0,0,0,4,28,8,19,11,4,0
"20230401KILHEA",2023-04-01,"Scotland Premiership","Kilmarnock","Hearts",2,1,"H",17,10,4,3,12,15,2,5,2,2,1,0,0,0,0,3,27,7,27,7,4,1
"20230401RANDUN",2023-04-01,"Scotland Premiership","Rangers","Dundee United",2,0,"H",28,9,7,4,11,8,10,2,1,1,0,0,0,0,0,2,37,11,19,12,2,0
"20230401ST ABE",2023-04-01,"Scotland Premiership","St Johnstone","Aberdeen",0,1,"A",14,12,6,3,6,8,7,7,3,2,1,1,0,0,0,1,26,9,14,14,5,2
"20230401ST LIV",2023-04-01,"Scotland Premiership","St Mirren","Livingston",3,0,"H",15,13,7,3,11,11,4,9,1,3,0,0,0,0,0,3,28,10,22,13,4,0
"20230402ROSCEL",2023-04-02,"Scotland Premiership","Ross County","Celtic",0,2,"A",8,28,2,9,7,6,2,9,0,0,0,0,0,0,0,2,36,11,13,11,0,0
"20230408CELRAN",2023-04-08,"Scotland Premiership","Celtic","Rangers",3,2,"H",9,8,7,3,19,12,4,3,4,2,0,0,0,0,0,5,17,10,31,7,6,0
"20230408ABEKIL",2023-04-08,"Scotland Premiership","Aberdeen","Kilmarnock",2,0,"H",13,16,3,2,12,5,5,8,1,1,0,0,0,0,0,2,29,5,17,13,2,0
"20230408HEAST ",2023-04-08,"Scotland Premiership","Hearts","St Mirren",0,2,"A",16,15,2,3,11,15,6,8,2,3,1,0,0,0,0,2,31,5,26,14,5,1
"20230408MOTLIV",2023-04-08,"Scotland Premiership","Motherwell","Livingston",3,0,"H",11,11,6,2,16,6,4,2,1,1,0,0,0,0,0,3,22,8,22,6,2,0
"20230408ST ROS",2023-04-08,"Scotland Premiership","St Johnstone","Ross County",0,2,"A",15,13,2,4,16,17,7,5,2,3,0,0,0,0,0,2,28,6,33,12,5,0
"20230409DUNHIB",2023-04-09,"Scotland Premiership","Dundee United","Hibernian",2,1,"H",10,14,3,3,10,15,0,4,0,2,0,0,0,0,0,3,24,6,25,4,2,0
"20230414ROSABE",2023-04-14,"Scotland Premiership","Ross County","Aberdeen",0,1,"A",14,11,4,1,8,12,10,2,1,2,0,1,0,0,0,1,25,5,20,12,3,1
"20230415HIBHEA",2023-04-15,"Scotland Premiership","Hibernian","Hearts",1,0,"H",11,11,3,4,14,8,5,7,6,4,0,0,0,0,0,1,22,7,22,12,10,0
"20230415LIVST ",2023-04-15,"Scotland Premiership","Livingston","St Johnstone",2,0,"H",12,11,5,2,19,16,2,3,2,1,0,0,0,0,0,2,23,7,35,5,3,0
"20230415MOTDUN",2023-04-15,"Scotland Premiership","Motherwell","Dundee United",1,2,"A",22,10,8,6,11,9,6,6,3,4,0,0,0,0,0,3,32,14,20,12,7,0
"20230415RANST ",2023-04-15,"Scotland Premiership","Rangers","St Mirren",5,2,"H",23,5,11,4,9,14,6,4,2,1,0,0,0,0,0,7,28,15,23,10,3,0
"20230416KILCEL",2023-04-16,"Scotland Premiership","Kilmarnock","Celtic",1,4,"A",14,16,5,6,13,15,4,5,0,2,0,0,0,0,0,5,30,11,28,9,2,0
"20230422HEAROS",2023-04-22,"Scotland Premiership","Hearts","Ross County",6,1,"H",30,7,12,1,7,10,8,5,1,3,0,0,0,0,0,7,37,13,17,13,4,0
"20230422CELMOT",2023-04-22,"Scotland Premiership","Celtic","Motherwell",1,1,"D",16,6,5,3,7,7,13,3,1,3,0,0,0,0,0,2,22,8,14,16,4,0
"20230422DUNLIV",2023-04-22,"Scotland Premiership","Dundee United","Livingston",2,0,"H",7,8,3,1,15,10,6,3,3,2,0,0,0,0,0,2,15,4,25,9,5,0
"20230422ST HIB",2023-04-22,"Scotland Premiership","St Johnstone","Hibernian",1,1,"D",14,6,7,3,11,12,8,1,2,2,0,1,0,0,0,2,20,10,23,9,4,1
"20230422ST KIL",2023-04-22,"Scotland Premiership","St Mirren","Kilmarnock",0,2,"A",6,16,1,6,12,11,5,1,1,1,1,0,0,0,0,2,22,7,23,6,2,1
"20230423ABERAN",2023-04-23,"Scotland Premiership","Aberdeen","Rangers",2,0,"H",11,20,4,3,17,7,3,7,2,1,0,0,0,0,0,2,31,7,24,10,3,0
"20230506HIBST ",2023-05-06,"Scotland Premiership","Hibernian","St Mirren",2,1,"H",13,13,6,4,11,11,3,5,2,1,0,0,0,0,0,3,26,10,22,8,3,0
"20230506MOTKIL",2023-05-06,"Scotland Premiership","Motherwell","Kilmarnock",2,0,"H",17,8,6,1,15,12,8,1,2,2,0,0,0,0,0,2,25,7,27,9,4,0
"20230506ROSLIV",2023-05-06,"Scotland Premiership","Ross County","Livingston",2,0,"H",6,10,2,0,15,7,5,3,2,2,0,1,0,0,0,2,16,2,22,8,4,1
"20230506ST DUN",2023-05-06,"Scotland Premiership","St Johnstone","Dundee United",1,0,"H",17,12,6,2,15,16,9,2,2,3,0,1,0,0,0,1,29,8,31,11,5,1
"20230507HEACEL",2023-05-07,"Scotland Premiership","Hearts","Celtic",0,2,"A",7,12,0,3,9,10,6,5,0,1,1,0,0,0,0,2,19,3,19,11,1,1
"20230507RANABE",2023-05-07,"Scotland Premiership","Rangers","Aberdeen",1,0,"H",19,11,7,4,4,8,12,6,1,2,0,0,0,0,0,1,30,11,12,18,3,0
"20230513RANCEL",2023-05-13,"Scotland Premiership","Rangers","Celtic",3,0,"H",16,8,8,1,15,4,5,5,1,1,0,0,0,0,0,3,24,9,19,10,2,0
"20230513ABEHIB",2023-05-13,"Scotland Premiership","Aberdeen","Hibernian",0,0,"D",8,17,2,5,10,17,3,8,2,5,0,0,0,0,0,0,25,7,27,11,7,0
"20230513DUNROS",2023-05-13,"Scotland Premiership","Dundee United","Ross County",1,3,"A",16,10,7,8,12,16,6,5,2,5,0,0,0,0,0,4,26,15,28,11,7,0
"20230513KILLIV",2023-05-13,"Scotland Premiership","Kilmarnock","Livingston",2,0,"H",11,7,6,2,17,17,2,5,1,3,0,0,1,0,1,2,18,8,34,7,4,0
"20230513ST MOT",2023-05-13,"Scotland Premiership","St Johnstone","Motherwell",0,2,"A",11,8,1,4,8,14,6,4,0,1,0,0,0,0,0,2,19,5,22,10,1,0
"20230513ST HEA",2023-05-13,"Scotland Premiership","St Mirren","Hearts",2,2,"D",13,11,7,6,19,13,7,4,2,4,0,1,0,0,0,4,24,13,32,11,6,1
"20230520HEAABE",2023-05-20,"Scotland Premiership","Hearts","Aberdeen",2,1,"H",30,9,8,4,6,15,5,2,1,4,0,0,0,0,0,3,39,12,21,7,5,0
"20230520CELST ",2023-05-20,"Scotland Premiership","Celtic","St Mirren",2,2,"D",21,10,6,2,4,9,14,2,0,0,0,0,0,0,0,4,31,8,13,16,0,0
"20230520KILST ",2023-05-20,"Scotland Premiership","Kilmarnock","St Johnstone",0,1,"A",10,17,1,7,10,11,3,8,1,3,1,0,0,0,0,1,27,8,21,11,4,1
"20230520LIVDUN",2023-05-20,"Scotland Premiership","Livingston","Dundee United",2,1,"H",14,17,7,4,16,11,1,12,2,1,0,1,0,0,0,3,31,11,27,13,3,1
"20230520MOTROS",2023-05-20,"Scotland Premiership","Motherwell","Ross County",1,0,"H",16,6,6,1,15,14,4,4,3,0,0,1,0,0,0,1,22,7,29,8,3,1
"20230521HIBRAN",2023-05-21,"Scotland Premiership","Hibernian","Rangers",1,3,"A",14,20,2,7,17,13,7,5,2,1,0,0,0,0,0,4,34,9,30,12,3,0
"20230524ABEST ",2023-05-24,"Scotland Premiership","Aberdeen","St Mirren",3,0,"H",15,6,6,4,13,14,2,2,0,1,0,1,0,0,0,3,21,10,27,4,1,1
"20230524DUNKIL",2023-05-24,"Scotland Premiership","Dundee United","Kilmarnock",0,3,"A",10,11,2,4,15,16,3,5,1,1,0,0,0,0,0,3,21,6,31,8,2,0
"20230524HIBCEL",2023-05-24,"Scotland Premiership","Hibernian","Celtic",4,2,"H",15,18,8,4,10,7,8,10,2,1,0,1,0,0,0,6,33,12,17,18,3,1
"20230524LIVMOT",2023-05-24,"Scotland Premiership","Livingston","Motherwell",1,1,"D",8,6,2,1,7,12,1,11,2,1,1,0,0,0,0,2,14,3,19,12,3,1
"20230524RANHEA",2023-05-24,"Scotland Premiership","Rangers","Hearts",2,2,"D",19,8,8,3,10,13,9,2,3,4,0,0,0,0,0,4,27,11,23,11,7,0
"20230524ROSST ",2023-05-24,"Scotland Premiership","Ross County","St Johnstone",3,3,"D",14,11,8,5,15,15,6,4,2,0,0,0,0,0,0,6,25,13,30,10,2,0
"20230527CELABE",2023-05-27,"Scotland Premiership","Celtic","Aberdeen",5,0,"H",20,0,8,0,9,8,10,2,1,2,0,0,0,0,0,5,20,8,17,12,3,0
"20230527HEAHIB",2023-05-27,"Scotland Premiership","Hearts","Hibernian",1,1,"D",3,17,1,6,12,15,4,9,3,5,1,0,2,1,1,2,20,7,27,13,8,1
"20230527ST RAN",2023-05-27,"Scotland Premiership","St Mirren","Rangers",0,3,"A",8,9,1,3,10,11,5,3,2,1,0,0,0,0,0,3,17,4,21,8,3,0
"20230528KILROS",2023-05-28,"Scotland Premiership","Kilmarnock","Ross County",3,1,"H",10,7,4,1,8,15,5,3,4,1,0,0,0,0,0,4,17,5,23,8,5,0
"20230528MOTDUN",2023-05-28,"Scotland Premiership","Motherwell","Dundee United",3,2,"H",23,10,6,7,17,6,9,0,2,0,0,0,0,0,0,5,33,13,23,9,2,0
"20230528ST LIV",2023-05-28,"Scotland Premiership","St Johnstone","Livingston",2,0,"H",9,9,3,4,9,11,4,2,0,3,0,0,0,0,0,2,18,7,20,6,3,0
"20230805CELROS",2023-08-05,"Scotland Premiership","Celtic","Ross County",4,2,"H",18,7,12,2,6,14,4,8,0,4,0,0,0,0,0,6,25,14,20,12,4,0
"20230805DUNMOT",2023-08-05,"Scotland Premiership","Dundee","Motherwell",1,1,"D",17,13,2,3,12,12,7,12,0,2,0,0,0,0,0,2,30,5,24,19,2,0
"20230805LIVABE",2023-08-05,"Scotland Premiership","Livingston","Aberdeen",0,0,"D",12,11,2,0,22,13,7,7,3,4,0,0,0,0,0,0,23,2,35,14,7,0
"20230805ST HEA",2023-08-05,"Scotland Premiership","St Johnstone","Hearts",0,2,"A",9,16,3,9,14,13,6,9,2,3,0,0,0,0,0,2,25,12,27,15,5,0
"20230805KILRAN",2023-08-05,"Scotland Premiership","Kilmarnock","Rangers",1,0,"H",10,18,3,4,7,10,2,8,0,0,0,0,0,0,0,1,28,7,17,10,0,0
"20230806HIBST ",2023-08-06,"Scotland Premiership","Hibernian","St Mirren",2,3,"A",14,8,7,4,14,7,2,7,2,2,0,0,0,0,0,5,22,11,21,9,4,0
"20230812RANLIV",2023-08-12,"Scotland Premiership","Rangers","Livingston",4,0,"H",21,6,9,2,9,9,5,4,1,1,0,0,0,0,0,4,27,11,18,9,2,0
"20230812ROSST ",2023-08-12,"Scotland Premiership","Ross County","St Johnstone",2,0,"H",19,12,8,3,11,14,6,7,2,2,0,0,1,1,0,2,31,11,25,13,4,0
"20230812ST DUN",2023-08-12,"Scotland Premiership","St Mirren","Dundee",2,1,"H",15,7,2,4,8,8,4,3,2,3,0,0,1,1,0,3,22,6,16,7,5,0
"20230813ABECEL",2023-08-13,"Scotland Premiership","Aberdeen","Celtic",1,3,"A",11,15,2,10,12,11,9,9,0,2,0,0,0,0,0,4,26,12,23,18,2,0
"20230813HEAKIL",2023-08-13,"Scotland Premiership","Hearts","Kilmarnock",0,0,"D",8,15,1,5,12,15,6,5,3,4,0,0,0,0,0,0,23,6,27,11,7,0
"20230813MOTHIB",2023-08-13,"Scotland Premiership","Motherwell","Hibernian",2,1,"H",10,4,3,1,14,16,5,2,1,4,0,0,0,0,0,3,14,4,30,7,5,0
"20230826ROSRAN",2023-08-26,"Scotland Premiership","Ross County","Rangers",0,2,"A",8,24,2,9,10,11,4,8,3,1,0,0,0,0,0,2,32,11,21,12,4,0
"20230826CELST ",2023-08-26,"Scotland Premiership","Celtic","St Johnstone",0,0,"D",19,5,5,2,9,12,19,1,1,3,0,0,0,0,0,0,24,7,21,20,4,0
"20230826HIBLIV",2023-08-26,"Scotland Premiership","Hibernian","Livingston",2,3,"A",13,8,3,4,12,10,9,3,2,4,0,0,0,0,0,5,21,7,22,12,6,0
"20230826MOTKIL",2023-08-26,"Scotland Premiership","Motherwell","Kilmarnock",2,1,"H",13,12,7,3,15,19,1,6,6,3,0,0,0,0,0,3,25,10,34,7,9,0
"20230827DUNHEA",2023-08-27,"Scotland Premiership","Dundee","Hearts",1,0,"H",12,10,4,5,16,10,3,8,1,1,0,0,0,0,0,1,22,9,26,11,2,0
"20230827ST ABE",2023-08-27,"Scotland Premiership","St Mirren","Aberdeen",2,2,"D",13,4,6,2,9,14,4,3,2,2,0,0,0,0,0,4,17,8,23,7,4,0
"20230902KILROS",2023-09-02,"Scotland Premiership","Kilmarnock","Ross County",0,1,"A",15,9,4,4,9,17,14,2,0,5,0,0,0,0,0,1,24,8,26,16,5,0
"20230902LIVST ",2023-09-02,"Scotland Premiership","Livingston","St Mirren",1,1,"D",13,8,2,4,17,13,6,2,3,1,0,0,0,0,0,2,21,6,30,8,4,0
"20230902ST DUN",2023-09-02,"Scotland Premiership","St Johnstone","Dundee",2,2,"D",8,12,3,4,13,11,4,6,3,0,0,0,0,0,0,4,20,7,24,10,3,0
"20230903RANCEL",2023-09-03,"Scotland Premiership","Rangers","Celtic",0,1,"A",17,7,3,5,15,15,6,2,1,1,0,0,0,0,0,1,24,8,30,8,2,0
"20230903ABEHIB",2023-09-03,"Scotland Premiership","Aberdeen","Hibernian",0,2,"A",10,15,3,7,15,11,7,5,2,4,0,0,0,0,0,2,25,10,26,12,6,0
"20230903HEAMOT",2023-09-03,"Scotland Premiership","Hearts","Motherwell",0,1,"A",18,8,1,4,10,16,16,5,1,2,0,1,0,0,0,1,26,5,26,21,3,1
"20230916ST RAN",2023-09-16,"Scotland Premiership","St Johnstone","Rangers",0,2,"A",3,20,0,6,13,13,3,5,5,2,0,0,0,0,0,2,23,6,26,8,7,0
"20230916CELDUN",2023-09-16,"Scotland Premiership","Celtic","Dundee",3,0,"H",19,4,7,1,6,7,9,1,0,0,0,0,0,0,0,3,23,8,13,10,0,0
"20230916HEAABE",2023-09-16,"Scotland Premiership","Hearts","Aberdeen",2,0,"H",12,11,4,5,11,12,9,3,4,2,0,0,0,0,0,2,23,9,23,12,6,0
"20230916KILHIB",2023-09-16,"Scotland Premiership","Kilmarnock","Hibernian",2,2,"D",16,11,5,4,16,8,4,4,5,4,0,0,0,0,0,4,27,9,24,8,9,0
"20230916MOTST ",2023-09-16,"Scotland Premiership","Motherwell","St Mirren",0,1,"A",20,9,7,3,6,18,8,3,0,5,0,0,0,0,0,1,29,10,24,11,5,0
"20230916ROSLIV",2023-09-16,"Scotland Premiership","Ross County","Livingston",1,1,"D",16,5,5,2,14,13,6,2,0,3,0,0,0,0,0,2,21,7,27,8,3,0
"20230923LIVCEL",2023-09-23,"Scotland Premiership","Livingston","Celtic",0,3,"A",15,14,4,7,17,6,2,4,5,2,0,1,0,0,0,3,29,11,23,6,7,1
"20230923DUNKIL",2023-09-23,"Scotland Premiership","Dundee","Kilmarnock",2,2,"D",10,23,3,3,8,12,4,7,1,3,1,0,0,0,0,4,33,6,20,11,4,1
"20230923HIBST ",2023-09-23,"Scotland Premiership","Hibernian","St Johnstone",2,0,"H",17,12,8,1,9,10,4,4,1,3,0,0,0,0,0,2,29,9,19,8,4,0
"20230923ST HEA",2023-09-23,"Scotland Premiership","St Mirren","Hearts",1,0,"H",13,11,5,3,13,12,4,8,2,1,0,0,0,0,0,1,24,8,25,12,3,0
"20230924ABEROS",2023-09-24,"Scotland Premiership","Aberdeen","Ross County",4,0,"H",13,11,6,2,9,10,5,5,0,4,0,0,0,0,0,4,24,8,19,10,4,0
"20230924RANMOT",2023-09-24,"Scotland Premiership","Rangers","Motherwell",1,0,"H",17,9,7,4,14,15,2,2,2,2,0,0,0,0,0,1,26,11,29,4,4,0
"20230930MOTCEL",2023-09-30,"Scotland Premiership","Motherwell","Celtic",1,2,"A",10,24,4,6,12,11,4,6,3,1,0,0,0,0,0,3,34,10,23,10,4,0
"20230930HIBDUN",2023-09-30,"Scotland Premiership","Hibernian","Dundee",0,0,"D",23,11,9,2,7,10,14,1,1,4,0,0,0,0,0,0,34,11,17,15,5,0
"20230930KILST ",2023-09-30,"Scotland Premiership","Kilmarnock","St Mirren",1,1,"D",12,8,2,3,15,16,7,6,2,3,0,0,1,1,0,2,20,5,31,13,5,0
"20230930RANABE",2023-09-30,"Scotland Premiership","Rangers","Aberdeen",1,3,"A",18,14,5,6,18,4,5,8,2,1,1,0,0,0,0,4,32,11,22,13,3,1
"20230930ROSHEA",2023-09-30,"Scotland Premiership","Ross County","Hearts",0,1,"A",9,17,1,3,15,10,5,5,3,2,0,0,2,1,1,1,26,4,25,10,5,0
"20230930ST LIV",2023-09-30,"Scotland Premiership","St Johnstone","Livingston",1,1,"D",12,7,2,3,14,14,5,2,2,2,1,0,0,0,0,2,19,5,28,7,4,1
"20231007CELKIL",2023-10-07,"Scotland Premiership","Celtic","Kilmarnock",3,1,"H",27,6,12,1,9,7,11,1,2,2,0,0,0,0,0,4,33,13,16,12,4,0
"20231007HEAHIB",2023-10-07,"Scotland Premiership","Hearts","Hibernian",2,2,"D",21,17,5,3,12,9,7,4,2,1,0,0,0,0,0,4,38,8,21,11,3,0
"20231007LIVMOT",2023-10-07,"Scotland Premiership","Livingston","Motherwell",2,0,"H",11,3,3,2,12,15,3,5,1,3,0,1,0,0,0,2,14,5,27,8,4,1
"20231008ST RAN",2023-10-08,"Scotland Premiership","St Mirren","Rangers",0,3,"A",3,13,0,8,8,16,3,10,1,2,1,0,0,0,0,3,16,8,24,13,3,1
"20231008ABEST ",2023-10-08,"Scotland Premiership","Aberdeen","St Johnstone",0,0,"D",10,9,3,0,11,11,5,3,0,2,0,0,0,0,0,0,19,3,22,8,2,0
"20231021KILLIV",2023-10-21,"Scotland Premiership","Kilmarnock","Livingston",3,1,"H",13,8,5,1,9,10,5,4,2,1,0,0,0,0,0,4,21,6,19,9,3,0
"20231021RANHIB",2023-10-21,"Scotland Premiership","Rangers","Hibernian",4,0,"H",23,7,8,1,12,5,5,4,1,2,0,0,0,0,0,4,30,9,17,9,3,0
"20231022HEACEL",2023-10-22,"Scotland Premiership","Hearts","Celtic",1,4,"A",13,19,6,7,16,11,3,5,2,1,0,0,0,0,0,5,32,13,27,8,3,0
"20231024DUNROS",2023-10-24,"Scotland Premiership","Dundee","Ross County",0,0,"D",15,6,9,4,7,13,7,4,1,6,0,0,0,0,0,0,21,13,20,11,7,0
"20231028HIBCEL",2023-10-28,"Scotland Premiership","Hibernian","Celtic",0,0,"D",6,21,1,4,4,12,3,6,0,2,0,0,0,0,0,0,27,5,16,9,2,0
"20231028LIVDUN",2023-10-28,"Scotland Premiership","Livingston","Dundee",0,2,"A",4,18,0,7,13,15,1,5,0,0,1,0,0,0,0,2,22,7,28,6,0,1
"20231028MOTROS",2023-10-28,"Scotland Premiership","Motherwell","Ross County",3,3,"D",13,13,3,6,10,9,6,4,2,2,0,0,0,0,0,6,26,9,19,10,4,0
"20231028ST ST ",2023-10-28,"Scotland Premiership","St Mirren","St Johnstone",4,0,"H",9,14,5,3,9,5,4,8,2,0,0,0,0,0,0,4,23,8,14,12,2,0
"20231029KILABE",2023-10-29,"Scotland Premiership","Kilmarnock","Aberdeen",2,0,"H",19,5,8,1,12,14,9,3,1,3,0,0,0,0,0,2,24,9,26,12,4,0
"20231029RANHEA",2023-10-29,"Scotland Premiership","Rangers","Hearts",2,1,"H",28,5,5,1,6,13,11,2,1,5,0,0,0,0,0,3,33,6,19,13,6,0
"20231031HIBROS",2023-10-31,"Scotland Premiership","Hibernian","Ross County",2,2,"D",7,8,2,3,12,16,5,5,1,2,0,0,0,0,0,4,15,5,28,10,3,0
"20231101CELST ",2023-11-01,"Scotland Premiership","Celtic","St Mirren",2,1,"H",23,6,8,2,9,12,12,2,2,2,0,0,0,0,0,3,29,10,21,14,4,0
"20231101DUNRAN",2023-11-01,"Scotland Premiership","Dundee","Rangers",0,5,"A",9,32,4,11,13,3,6,7,4,1,0,0,0,0,0,5,41,15,16,13,5,0
"20231101HEALIV",2023-11-01,"Scotland Premiership","Hearts","Livingston",1,0,"H",25,3,10,0,9,12,12,1,2,4,0,0,0,0,0,1,28,10,21,13,6,0
"20231101MOTABE",2023-11-01,"Scotland Premiership","Motherwell","Aberdeen",2,4,"A",9,15,2,6,14,6,1,4,6,1,0,0,0,0,0,6,24,8,20,5,7,0
"20231101ST KIL",2023-11-01,"Scotland Premiership","St Johnstone","Kilmarnock",2,1,"H",15,23,4,5,13,9,5,12,2,2,1,0,0,0,0,3,38,9,22,17,4,1
"20231104ROSCEL",2023-11-04,"Scotland Premiership","Ross County","Celtic",0,3,"A",3,39,0,16,9,10,2,13,0,1,1,0,0,0,0,3,42,16,19,15,1,1
"20231104KILMOT",2023-11-04,"Scotland Premiership","Kilmarnock","Motherwell",1,0,"H",20,11,8,1,9,12,9,3,2,1,0,0,0,0,0,1,31,9,21,12,3,0
"20231105DUNLIV",2023-11-05,"Scotland Premiership","Dundee","Livingston",1,0,"H",10,16,3,3,14,14,5,12,2,3,0,0,0,0,0,1,26,6,28,17,5,0
"20231107ST MOT",2023-11-07,"Scotland Premiership","St Johnstone","Motherwell",2,2,"D",10,11,3,5,11,18,6,7,1,2,0,0,0,0,0,4,21,8,29,13,3,0
"20231108ST HIB",2023-11-08,"Scotland Premiership","St Mirren","Hibernian",2,2,"D",18,9,4,4,9,9,3,1,3,2,0,0,0,0,0,4,27,8,18,4,5,0
"20231111DUNST ",2023-11-11,"Scotland Premiership","Dundee","St Mirren",4,0,"H",11,5,7,0,6,12,7,4,1,1,0,0,0,0,0,4,16,7,18,11,2,0
"20231111HIBKIL",2023-11-11,"Scotland Premiership","Hibernian","Kilmarnock",1,0,"H",7,9,5,1,6,14,5,10,2,5,0,0,0,0,0,1,16,6,20,15,7,0
"20231111MOTHEA",2023-11-11,"Scotland Premiership","Motherwell","Hearts",1,2,"A",8,14,1,3,13,12,4,10,4,2,0,0,0,0,0,3,22,4,25,14,6,0
"20231111ST ROS",2023-11-11,"Scotland Premiership","St Johnstone","Ross County",1,0,"H",10,8,3,2,11,13,3,4,4,3,0,0,0,0,0,1,18,5,24,7,7,0
"20231112LIVRAN",2023-11-12,"Scotland Premiership","Livingston","Rangers",0,2,"A",4,18,1,6,14,7,3,9,1,1,0,0,0,0,0,2,22,7,21,12,2,0
"20231112CELABE",2023-11-12,"Scotland Premiership","Celtic","Aberdeen",6,0,"H",21,3,10,1,5,8,11,0,0,3,0,0,1,1,0,6,24,11,13,11,3,0
"20231125CELMOT",2023-11-25,"Scotland Premiership","Celtic","Motherwell",1,1,"D",20,6,4,2,8,9,13,2,1,4,0,0,0,0,0,2,26,6,17,15,5,0
"20231125DUNHIB",2023-11-25,"Scotland Premiership","Dundee","Hibernian",1,2,"A",19,10,7,3,6,9,7,3,2,1,0,1,0,0,0,3,29,10,15,10,3,1
"20231125HEAST ",2023-11-25,"Scotland Premiership","Hearts","St Johnstone",1,0,"H",18,10,4,3,5,17,6,5,2,2,0,0,0,0,0,1,28,7,22,11,4,0
"20231125ROSKIL",2023-11-25,"Scotland Premiership","Ross County","Kilmarnock",0,0,"D",15,13,5,1,10,9,9,5,1,0,0,0,0,0,0,0,28,6,19,14,1,0
"20231125ST LIV",2023-11-25,"Scotland Premiership","St Mirren","Livingston",1,0,"H",15,11,1,1,13,10,7,3,1,0,0,0,0,0,0,1,26,2,23,10,1,0
"20231126ABERAN",2023-11-26,"Scotland Premiership","Aberdeen","Rangers",1,1,"D",5,22,4,10,16,11,0,5,4,1,0,0,0,0,0,2,27,14,27,5,5,0
"20231128ROSST ",2023-11-28,"Scotland Premiership","Ross County","St Mirren",1,0,"H",6,6,2,1,11,14,7,5,0,2,0,0,0,0,0,1,12,3,25,12,2,0
"20231202KILHEA",2023-12-02,"Scotland Premiership","Kilmarnock","Hearts",0,1,"A",17,11,3,1,14,12,7,3,2,1,0,0,0,0,0,1,28,4,26,10,3,0
"20231202MOTDUN",2023-12-02,"Scotland Premiership","Motherwell","Dundee",3,3,"D",9,16,4,4,6,9,4,4,3,2,1,0,0,0,0,6,25,8,15,8,5,1
"20231203ST CEL",2023-12-03,"Scotland Premiership","St Johnstone","Celtic",1,3,"A",5,25,3,7,8,7,2,12,2,1,0,0,0,0,0,4,30,10,15,14,3,0
"20231203HIBABE",2023-12-03,"Scotland Premiership","Hibernian","Aberdeen",2,0,"H",11,23,3,5,13,13,6,6,3,2,0,0,0,0,0,2,34,8,26,12,5,0
"20231203RANST ",2023-12-03,"Scotland Premiership","Rangers","St Mirren",2,0,"H",21,4,6,3,9,8,8,5,1,3,0,0,1,0,1,2,25,9,17,13,4,0
"20231205ROSMOT",2023-12-05,"Scotland Premiership","Ross County","Motherwell",3,0,"H",13,14,6,4,14,9,6,3,1,2,1,0,0,0,0,3,27,10,23,9,3,1
"20231206ABEKIL",2023-12-06,"Scotland Premiership","Aberdeen","Kilmarnock",0,1,"A",18,8,3,2,11,21,4,5,3,1,0,0,3,0,3,1,26,5,32,9,4,0
"20231206CELHIB",2023-12-06,"Scotland Premiership","Celtic","Hibernian",4,1,"H",26,6,12,3,10,8,11,4,2,2,0,0,0,0,0,5,32,15,18,15,4,0
"20231206ST ST ",2023-12-06,"Scotland Premiership","St Johnstone","St Mirren",1,0,"H",11,13,5,5,9,10,0,7,2,1,0,0,0,0,0,1,24,10,19,7,3,0
"20231206HEARAN",2023-12-06,"Scotland Premiership","Hearts","Rangers",0,1,"A",12,22,5,5,13,11,6,5,3,1,0,0,0,0,0,1,34,10,24,11,4,0
"20231209ABEHEA",2023-12-09,"Scotland Premiership","Aberdeen","Hearts",2,1,"H",14,5,6,3,13,20,3,8,3,7,0,0,0,0,0,3,19,9,33,11,10,0
"20231209LIVHIB",2023-12-09,"Scotland Premiership","Livingston","Hibernian",0,1,"A",14,4,3,2,11,13,6,0,3,1,0,0,0,0,0,1,18,5,24,6,4,0
"20231209MOTST ",2023-12-09,"Scotland Premiership","Motherwell","St Johnstone",1,1,"D",17,11,8,2,11,11,3,2,0,0,0,0,0,0,0,2,28,10,22,5,0,0
"20231209RANDUN",2023-12-09,"Scotland Premiership","Rangers","Dundee",3,1,"H",20,9,9,3,12,9,5,7,1,3,1,0,0,0,0,4,29,12,21,12,4,1
"20231209ST ROS",2023-12-09,"Scotland Premiership","St Mirren","Ross County",2,0,"H",15,9,6,2,9,12,10,4,2,0,0,0,0,0,0,2,24,8,21,14,2,0
"20231210KILCEL",2023-12-10,"Scotland Premiership","Kilmarnock","Celtic",2,1,"H",13,16,6,7,14,12,5,9,3,1,0,0,0,0,0,3,29,13,26,14,4,0
"20231216CELHEA",2023-12-16,"Scotland Premiership","Celtic","Hearts",0,2,"A",22,5,5,2,12,3,18,3,1,0,0,0,0,0,0,2,27,7,15,21,1,0
"20231216LIVKIL",2023-12-16,"Scotland Premiership","Livingston","Kilmarnock",0,0,"D",8,11,1,3,17,11,0,8,2,1,0,0,0,0,0,0,19,4,28,8,3,0
"20231216ROSDUN",2023-12-16,"Scotland Premiership","Ross County","Dundee",0,1,"A",10,17,3,3,10,10,2,9,1,2,0,0,0,0,0,1,27,6,20,11,3,0
"20231216ST HIB",2023-12-16,"Scotland Premiership","St Johnstone","Hibernian",1,0,"H",14,3,7,0,10,8,5,5,2,3,0,0,1,0,1,1,17,7,18,10,5,0
"20231216ST MOT",2023-12-16,"Scotland Premiership","St Mirren","Motherwell",0,0,"D",11,8,3,4,11,11,6,4,1,1,0,0,0,0,0,0,19,7,22,10,2,0
"20231220ABELIV",2023-12-20,"Scotland Premiership","Aberdeen","Livingston",2,1,"H",11,11,6,4,8,15,1,3,0,3,0,0,0,0,0,3,22,10,23,4,3,0
"20231220RANST ",2023-12-20,"Scotland Premiership","Rangers","St Johnstone",2,0,"H",28,2,8,0,7,11,10,2,2,2,0,1,0,0,0,2,30,8,18,12,4,1
"20231223CELLIV",2023-12-23,"Scotland Premiership","Celtic","Livingston",2,0,"H",22,0,7,0,5,4,14,0,0,1,0,0,0,0,0,2,22,7,9,14,1,0
"20231223HEAST ",2023-12-23,"Scotland Premiership","Hearts","St Mirren",2,0,"H",12,11,6,4,16,9,8,6,2,3,0,0,0,0,0,2,23,10,25,14,5,0
"20231223KILST ",2023-12-23,"Scotland Premiership","Kilmarnock","St Johnstone",2,1,"H",14,9,5,4,12,8,5,1,0,1,0,0,0,0,0,3,23,9,20,6,1,0
"20231224MOTRAN",2023-12-24,"Scotland Premiership","Motherwell","Rangers",0,2,"A",7,14,0,6,16,10,3,5,3,1,0,0,0,0,0,2,21,6,26,8,4,0
"20231226DUNCEL",2023-12-26,"Scotland Premiership","Dundee","Celtic",0,3,"A",5,38,1,7,3,9,1,23,1,1,0,0,0,0,0,3,43,8,12,24,2,0
"20231227LIVST ",2023-12-27,"Scotland Premiership","Livingston","St Johnstone",0,0,"D",14,4,3,2,12,12,6,3,2,2,0,0,0,0,0,0,18,5,24,9,4,0
"20231227ST KIL",2023-12-27,"Scotland Premiership","St Mirren","Kilmarnock",0,1,"A",11,12,6,3,7,10,4,4,3,2,0,0,0,0,0,1,23,9,17,8,5,0
"20231227HIBHEA",2023-12-27,"Scotland Premiership","Hibernian","Hearts",0,1,"A",16,10,3,3,11,10,6,5,2,3,0,0,0,0,0,1,26,6,21,11,5,0
"20231230CELRAN",2023-12-30,"Scotland Premiership","Celtic","Rangers",2,1,"H",12,14,5,3,18,14,4,2,7,3,0,1,0,0,0,3,26,8,32,6,10,1
"20231230ABEST ",2023-12-30,"Scotland Premiership","Aberdeen","St Mirren",0,3,"A",18,10,3,5,9,11,13,2,1,0,0,0,0,0,0,3,28,8,20,15,1,0
"20231230HEAROS",2023-12-30,"Scotland Premiership","Hearts","Ross County",2,2,"D",20,14,7,2,14,14,9,5,2,2,0,0,0,0,0,4,34,9,28,14,4,0
"20231230KILDUN",2023-12-30,"Scotland Premiership","Kilmarnock","Dundee",2,2,"D",11,7,4,2,12,10,7,8,2,1,0,0,0,0,0,4,18,6,22,15,3,0
"20231230MOTLIV",2023-12-30,"Scotland Premiership","Motherwell","Livingston",3,1,"H",7,10,4,1,12,14,4,3,4,3,0,0,0,0,0,4,17,5,26,7,7,0
"20240102HIBMOT",2024-01-02,"Scotland Premiership","Hibernian","Motherwell",2,2,"D",12,9,3,4,10,10,7,3,2,2,0,0,0,0,0,4,21,7,20,10,4,0
"20240102LIVHEA",2024-01-02,"Scotland Premiership","Livingston","Hearts",1,2,"A",10,10,3,5,12,16,2,3,1,3,0,0,0,0,0,3,20,8,28,5,4,0
"20240102RANKIL",2024-01-02,"Scotland Premiership","Rangers","Kilmarnock",3,1,"H",18,6,6,2,10,13,7,5,1,3,0,0,0,0,0,4,24,8,23,12,4,0
"20240102ROSABE",2024-01-02,"Scotland Premiership","Ross County","Aberdeen",0,3,"A",5,16,3,7,14,9,4,5,4,3,1,0,0,0,0,3,21,10,23,9,7,1
"20240102ST CEL",2024-01-02,"Scotland Premiership","St Mirren","Celtic",0,3,"A",3,24,0,11,9,8,1,12,0,0,1,0,0,0,0,3,27,11,17,13,0,1
"20240123HEADUN",2024-01-23,"Scotland Premiership","Hearts","Dundee",3,2,"H",15,8,6,4,10,12,7,1,1,6,0,0,0,0,0,5,23,10,22,8,7,0
"20240124HIBRAN",2024-01-24,"Scotland Premiership","Hibernian","Rangers",0,3,"A",9,22,3,8,6,7,4,10,1,0,0,0,0,0,0,3,31,11,13,14,1,0
"20240124ST ABE",2024-01-24,"Scotland Premiership","St Johnstone","Aberdeen",1,1,"D",14,8,5,4,20,8,1,4,4,1,0,0,0,0,0,2,22,9,28,5,5,0
"20240127ST RAN",2024-01-27,"Scotland Premiership","St Mirren","Rangers",0,1,"A",7,10,2,2,10,9,4,3,0,2,0,0,0,0,0,1,17,4,19,7,2,0
"20240127CELROS",2024-01-27,"Scotland Premiership","Celtic","Ross County",1,0,"H",17,7,7,1,12,14,7,7,1,1,0,0,0,0,0,1,24,8,26,14,2,0
"20240127HEAABE",2024-01-27,"Scotland Premiership","Hearts","Aberdeen",2,0,"H",15,16,5,1,10,14,7,7,1,2,0,0,1,0,1,2,31,6,24,14,3,0
"20240127KILHIB",2024-01-27,"Scotland Premiership","Kilmarnock","Hibernian",2,2,"D",12,15,1,5,15,11,7,3,2,1,1,0,0,0,0,4,27,6,26,10,3,1
"20240127LIVDUN",2024-01-27,"Scotland Premiership","Livingston","Dundee",1,4,"A",15,7,3,5,7,14,5,3,0,1,0,1,0,0,0,5,22,8,21,8,1,1
"20240127ST MOT",2024-01-27,"Scotland Premiership","St Johnstone","Motherwell",1,1,"D",7,11,4,2,13,16,0,6,2,3,0,0,0,0,0,2,18,6,29,6,5,0
"20240130ABEDUN",2024-01-30,"Scotland Premiership","Aberdeen","Dundee",1,1,"D",10,9,4,3,13,17,0,3,2,3,0,0,0,0,0,2,19,7,30,3,5,0
"20240130LIVROS",2024-01-30,"Scotland Premiership","Livingston","Ross County",2,2,"D",13,10,4,4,10,16,5,3,1,2,0,0,0,0,0,4,23,8,26,8,3,0
"20240203ABECEL",2024-02-03,"Scotland Premiership","Aberdeen","Celtic",1,1,"D",7,22,3,4,6,9,1,12,3,1,0,0,0,0,0,2,29,7,15,13,4,0
"20240203DUNHEA",2024-02-03,"Scotland Premiership","Dundee","Hearts",2,3,"A",14,18,8,6,7,6,8,5,3,1,0,0,2,1,1,5,32,14,13,13,4,0
"20240203HIBST ",2024-02-03,"Scotland Premiership","Hibernian","St Mirren",0,3,"A",6,13,1,5,11,17,6,7,3,3,0,0,0,0,0,3,19,6,28,13,6,0
"20240203MOTKIL",2024-02-03,"Scotland Premiership","Motherwell","Kilmarnock",1,1,"D",11,3,4,1,11,15,6,5,2,5,0,0,0,0,0,2,14,5,26,11,7,0
"20240203RANLIV",2024-02-03,"Scotland Premiership","Rangers","Livingston",3,0,"H",32,0,8,0,9,6,14,0,0,0,0,0,0,0,0,3,32,8,15,14,0,0
"20240203ROSST ",2024-02-03,"Scotland Premiership","Ross County","St Johnstone",0,1,"A",12,8,5,2,11,7,8,4,3,1,0,0,0,0,0,1,20,7,18,12,4,0
"20240206MOTROS",2024-02-06,"Scotland Premiership","Motherwell","Ross County",5,0,"H",17,12,8,2,10,11,3,6,2,2,0,0,0,0,0,5,29,10,21,9,4,0
"20240206RANABE",2024-02-06,"Scotland Premiership","Rangers","Aberdeen",2,1,"H",23,9,7,4,7,10,13,2,0,2,1,0,0,0,0,3,32,11,17,15,2,1
"20240207KILLIV",2024-02-07,"Scotland Premiership","Kilmarnock","Livingston",1,0,"H",12,11,6,4,8,9,9,2,0,2,0,0,0,0,0,1,23,10,17,11,2,0
"20240207ST HEA",2024-02-07,"Scotland Premiership","St Johnstone","Hearts",0,1,"A",10,8,2,4,9,10,2,4,4,1,0,0,0,0,0,1,18,6,19,6,5,0
"20240207ST DUN",2024-02-07,"Scotland Premiership","St Mirren","Dundee",2,0,"H",19,5,6,0,9,9,6,5,0,1,1,0,0,0,0,2,24,6,18,11,1,1
"20240207HIBCEL",2024-02-07,"Scotland Premiership","Hibernian","Celtic",1,2,"A",12,8,4,3,14,18,4,5,4,2,0,0,0,0,0,3,20,7,32,9,6,0
"20240211DUNST ",2024-02-11,"Scotland Premiership","Dundee","St Johnstone",2,1,"H",26,15,6,3,6,15,13,7,4,3,0,0,1,0,1,3,41,9,21,20,7,0
"20240214ABEMOT",2024-02-14,"Scotland Premiership","Aberdeen","Motherwell",3,3,"D",14,11,7,7,6,14,7,3,2,4,0,0,0,0,0,6,25,14,20,10,6,0
"20240214RANROS",2024-02-14,"Scotland Premiership","Rangers","Ross County",3,1,"H",43,5,23,1,10,12,20,3,1,3,0,0,0,0,0,4,48,24,22,23,4,0
"20240217ABEHIB",2024-02-17,"Scotland Premiership","Aberdeen","Hibernian",2,2,"D",22,7,12,6,13,14,4,2,1,3,0,0,0,0,0,4,29,18,27,6,4,0
"20240217CELKIL",2024-02-17,"Scotland Premiership","Celtic","Kilmarnock",1,1,"D",15,13,5,6,12,8,8,4,0,3,0,0,0,0,0,2,28,11,20,12,3,0
"20240217DUNROS",2024-02-17,"Scotland Premiership","Dundee","Ross County",2,0,"H",14,17,4,3,9,15,6,2,2,2,0,0,0,0,0,2,31,7,24,8,4,0
"20240217HEAMOT",2024-02-17,"Scotland Premiership","Hearts","Motherwell",2,0,"H",22,10,7,3,9,14,9,7,1,2,0,0,0,0,0,2,32,10,23,16,3,0
"20240217LIVST ",2024-02-17,"Scotland Premiership","Livingston","St Mirren",1,0,"H",6,21,3,3,12,11,4,9,1,1,0,0,0,0,0,1,27,6,23,13,2,0
"20240218ST RAN",2024-02-18,"Scotland Premiership","St Johnstone","Rangers",0,3,"A",4,15,0,5,24,6,3,1,3,0,0,0,0,0,0,3,19,5,30,4,3,0
"20240224HIBDUN",2024-02-24,"Scotland Premiership","Hibernian","Dundee",2,1,"H",16,7,9,1,11,11,10,2,0,2,0,0,0,0,0,3,23,10,22,12,2,0
"20240224KILABE",2024-02-24,"Scotland Premiership","Kilmarnock","Aberdeen",2,0,"H",20,9,9,1,17,15,5,3,1,0,0,0,0,0,0,2,29,10,32,8,1,0
"20240224RANHEA",2024-02-24,"Scotland Premiership","Rangers","Hearts",5,0,"H",17,11,12,5,17,9,4,2,2,2,0,0,0,0,0,5,28,17,26,6,4,0
"20240224ROSLIV",2024-02-24,"Scotland Premiership","Ross County","Livingston",3,2,"H",12,18,6,6,11,15,6,4,2,1,0,0,0,0,0,5,30,12,26,10,3,0
"20240224ST ST ",2024-02-24,"Scotland Premiership","St Mirren","St Johnstone",2,0,"H",15,5,5,2,10,12,5,6,1,2,0,0,0,0,0,2,20,7,22,11,3,0
"20240225MOTCEL",2024-02-25,"Scotland Premiership","Motherwell","Celtic",1,3,"A",10,18,3,7,7,10,4,4,1,2,0,0,0,0,0,4,28,10,17,8,3,0
"20240227ROSST ",2024-02-27,"Scotland Premiership","Ross County","St Mirren",1,1,"D",6,9,1,3,13,6,3,4,2,2,0,0,0,0,0,2,15,4,19,7,4,0
"20240228ABEST ",2024-02-28,"Scotland Premiership","Aberdeen","St Johnstone",0,2,"A",17,8,5,4,7,11,11,7,0,4,0,0,0,0,0,2,25,9,18,18,4,0
"20240228CELDUN",2024-02-28,"Scotland Premiership","Celtic","Dundee",7,1,"H",17,9,10,2,7,5,5,5,2,1,0,1,0,0,0,8,26,12,12,10,3,1
"20240228HEAHIB",2024-02-28,"Scotland Premiership","Hearts","Hibernian",1,1,"D",14,21,2,5,8,9,4,9,2,1,0,0,0,0,0,2,35,7,17,13,3,0
"20240228KILRAN",2024-02-28,"Scotland Premiership","Kilmarnock","Rangers",1,2,"A",10,14,3,5,8,16,8,6,3,2,0,0,0,0,0,3,24,8,24,14,5,0
"20240228LIVMOT",2024-02-28,"Scotland Premiership","Livingston","Motherwell",1,3,"A",14,15,4,5,12,8,1,4,1,1,0,0,0,0,0,4,29,9,20,5,2,0
"20240302DUNKIL",2024-03-02,"Scotland Premiership","Dundee","Kilmarnock",2,2,"D",14,9,5,7,11,10,4,6,3,4,0,1,0,0,0,4,23,12,21,10,7,1
"20240302HIBROS",2024-03-02,"Scotland Premiership","Hibernian","Ross County",2,0,"H",14,4,6,2,9,14,8,2,0,1,0,0,0,0,0,2,18,8,23,10,1,0
"20240302RANMOT",2024-03-02,"Scotland Premiership","Rangers","Motherwell",1,2,"A",31,15,11,5,9,10,15,2,0,3,0,0,0,0,0,3,46,16,19,17,3,0
"20240302ST LIV",2024-03-02,"Scotland Premiership","St Johnstone","Livingston",1,1,"D",10,8,3,4,15,16,2,2,2,2,0,0,0,0,0,2,18,7,31,4,4,0
"20240302ST ABE",2024-03-02,"Scotland Premiership","St Mirren","Aberdeen",2,1,"H",14,9,5,3,16,22,3,2,1,4,0,0,0,0,0,3,23,8,38,5,5,0
"20240303HEACEL",2024-03-03,"Scotland Premiership","Hearts","Celtic",2,0,"H",14,17,6,6,10,11,7,7,2,2,0,1,0,0,0,2,31,12,21,14,4,1
"20240313DUNABE",2024-03-13,"Scotland Premiership","Dundee","Aberdeen",1,0,"H",18,10,6,2,12,8,6,4,2,1,0,0,0,0,0,1,28,8,20,10,3,0
"20240313ROSHIB",2024-03-13,"Scotland Premiership","Ross County","Hibernian",2,2,"D",6,11,3,6,7,12,2,6,1,2,0,0,0,0,0,4,17,9,19,8,3,0
"20240316CELST ",2024-03-16,"Scotland Premiership","Celtic","St Johnstone",3,1,"H",22,6,9,2,6,13,10,2,0,3,0,0,0,0,0,4,28,11,19,12,3,0
"20240316HIBLIV",2024-03-16,"Scotland Premiership","Hibernian","Livingston",3,0,"H",14,9,4,3,13,16,3,2,0,6,0,0,0,0,0,3,23,7,29,5,6,0
"20240316KILST ",2024-03-16,"Scotland Premiership","Kilmarnock","St Mirren",5,2,"H",13,7,8,2,15,13,1,3,3,1,0,0,1,1,0,7,20,10,28,4,4,0
"20240316MOTABE",2024-03-16,"Scotland Premiership","Motherwell","Aberdeen",0,1,"A",14,14,5,4,13,10,6,6,1,2,0,0,0,0,0,1,28,9,23,12,3,0
"20240316ROSHEA",2024-03-16,"Scotland Premiership","Ross County","Hearts",2,1,"H",11,21,3,6,7,6,2,15,2,1,0,0,0,0,0,3,32,9,13,17,3,0
"20240330ABEROS",2024-03-30,"Scotland Premiership","Aberdeen","Ross County",2,1,"H",10,10,4,3,12,16,2,8,2,4,0,0,0,0,0,3,20,7,28,10,6,0
"20240330HEAKIL",2024-03-30,"Scotland Premiership","Hearts","Kilmarnock",1,1,"D",16,12,6,4,5,12,7,7,2,2,0,0,0,0,0,2,28,10,17,14,4,0
"20240330MOTST ",2024-03-30,"Scotland Premiership","Motherwell","St Mirren",1,1,"D",16,17,4,4,9,8,4,4,1,1,0,0,0,0,0,2,33,8,17,8,2,0
"20240330RANHIB",2024-03-30,"Scotland Premiership","Rangers","Hibernian",3,1,"H",24,6,8,1,14,7,9,4,3,3,0,0,0,0,0,4,30,9,21,13,6,0
"20240330ST DUN",2024-03-30,"Scotland Premiership","St Johnstone","Dundee",1,2,"A",15,10,4,3,8,9,11,2,5,1,0,0,0,0,0,3,25,7,17,13,6,0
"20240331LIVCEL",2024-03-31,"Scotland Premiership","Livingston","Celtic",0,3,"A",5,21,1,10,7,8,0,8,1,0,0,0,0,0,0,3,26,11,15,8,1,0
"20240406DUNMOT",2024-04-06,"Scotland Premiership","Dundee","Motherwell",2,3,"A",6,20,2,5,7,4,3,11,2,0,0,0,0,0,0,5,26,7,11,14,2,0
"20240406HIBST ",2024-04-06,"Scotland Premiership","Hibernian","St Johnstone",1,2,"A",13,6,6,2,6,6,13,3,1,2,0,0,0,0,0,3,19,8,12,16,3,0
"20240406KILROS",2024-04-06,"Scotland Premiership","Kilmarnock","Ross County",1,0,"H",14,10,5,4,6,15,4,3,4,4,0,0,0,0,0,1,24,9,21,7,8,0
"20240406LIVABE",2024-04-06,"Scotland Premiership","Livingston","Aberdeen",0,0,"D",9,5,1,3,15,7,2,5,2,0,0,0,0,0,0,0,14,4,22,7,2,0
"20240406ST HEA",2024-04-06,"Scotland Premiership","St Mirren","Hearts",1,2,"A",6,10,1,2,14,5,8,7,1,2,0,0,0,0,0,3,16,3,19,15,3,0
"20240407RANCEL",2024-04-07,"Scotland Premiership","Rangers","Celtic",3,3,"D",12,14,5,7,10,23,3,2,0,4,0,0,0,0,0,6,26,12,33,5,4,0
"20240413ABEDUN",2024-04-13,"Scotland Premiership","Aberdeen","Dundee",0,0,"D",12,18,5,3,14,17,3,5,0,3,1,0,0,0,0,0,30,8,31,8,3,1
"20240413CELST ",2024-04-13,"Scotland Premiership","Celtic","St Mirren",3,0,"H",18,2,9,0,7,12,11,1,0,2,0,0,1,1,0,3,20,9,19,12,2,0
"20240413HEALIV",2024-04-13,"Scotland Premiership","Hearts","Livingston",4,2,"H",13,8,5,3,9,17,5,5,1,0,0,1,0,0,0,6,21,8,26,10,1,1
"20240413MOTHIB",2024-04-13,"Scotland Premiership","Motherwell","Hibernian",1,1,"D",8,8,1,4,7,10,4,6,2,4,0,0,1,0,1,2,16,5,17,10,6,0
"20240413ST KIL",2024-04-13,"Scotland Premiership","St Johnstone","Kilmarnock",0,2,"A",11,17,3,5,8,14,2,6,0,0,0,0,0,0,0,2,28,8,22,8,0,0
"20240414ROSRAN",2024-04-14,"Scotland Premiership","Ross County","Rangers",3,2,"H",13,28,6,7,6,10,3,17,3,1,0,0,0,0,0,5,41,13,16,20,4,0
"20240417DUNRAN",2024-04-17,"Scotland Premiership","Dundee","Rangers",0,0,"D",7,17,1,5,11,13,2,9,1,0,0,0,0,0,0,0,24,6,24,11,1,0
"20240427ABEMOT",2024-04-27,"Scotland Premiership","Aberdeen","Motherwell",1,0,"H",23,8,5,3,9,14,10,7,1,0,0,1,0,0,0,1,31,8,23,17,1,1
"20240427KILHEA",2024-04-27,"Scotland Premiership","Kilmarnock","Hearts",0,0,"D",16,14,2,4,9,6,8,4,4,0,0,0,0,0,0,0,30,6,15,12,4,0
"20240427LIVROS",2024-04-27,"Scotland Premiership","Livingston","Ross County",2,0,"H",6,14,4,4,13,13,4,5,1,0,0,0,0,0,0,2,20,8,26,9,1,0
"20240427ST HIB",2024-04-27,"Scotland Premiership","St Johnstone","Hibernian",1,3,"A",9,16,3,8,11,8,1,7,0,1,0,0,0,0,0,4,25,11,19,8,1,0
"20240428ST RAN",2024-04-28,"Scotland Premiership","St Mirren","Rangers",1,2,"A",12,20,5,6,12,12,4,8,1,1,0,0,0,0,0,3,32,11,24,12,2,0
"20240428DUNCEL",2024-04-28,"Scotland Premiership","Dundee","Celtic",1,2,"A",11,13,6,6,10,7,8,8,0,1,0,0,0,0,0,3,24,12,17,16,1,0
"20240504ABEST ",2024-05-04,"Scotland Premiership","Aberdeen","St Johnstone",1,0,"H",15,12,6,5,10,15,7,4,1,2,0,0,1,1,0,1,27,11,25,11,3,0
"20240504CELHEA",2024-05-04,"Scotland Premiership","Celtic","Hearts",3,0,"H",17,5,8,2,13,7,17,8,0,2,0,0,0,0,0,3,22,10,20,25,2,0
"20240504DUNST ",2024-05-04,"Scotland Premiership","Dundee","St Mirren",1,3,"A",10,12,4,7,8,9,4,8,2,1,0,0,0,0,0,4,22,11,17,12,3,0
"20240504MOTLIV",2024-05-04,"Scotland Premiership","Motherwell","Livingston",4,1,"H",14,5,6,1,2,2,6,2,2,0,0,0,0,0,0,5,19,7,4,8,2,0
"20240504ROSHIB",2024-05-04,"Scotland Premiership","Ross County","Hibernian",2,1,"H",12,20,4,5,3,8,5,7,1,0,0,0,0,0,0,3,32,9,11,12,1,0
"20240505RANKIL",2024-05-05,"Scotland Premiership","Rangers","Kilmarnock",4,1,"H",41,5,15,2,11,9,16,1,0,2,0,1,0,0,0,5,46,17,20,17,2,1
"20240511CELRAN",2024-05-11,"Scotland Premiership","Celtic","Rangers",2,1,"H",22,8,6,1,14,17,10,5,3,0,0,1,0,0,0,3,30,7,31,15,3,1
"20240511HEADUN",2024-05-11,"Scotland Premiership","Hearts","Dundee",3,0,"H",16,15,8,4,8,8,2,5,0,3,0,0,0,0,0,3,31,12,16,7,3,0
"20240511LIVST ",2024-05-11,"Scotland Premiership","Livingston","St Johnstone",2,1,"H",15,25,8,7,12,9,4,8,2,1,0,0,0,0,0,3,40,15,21,12,3,0
"20240511ROSMOT",2024-05-11,"Scotland Premiership","Ross County","Motherwell",1,5,"A",14,14,2,7,14,4,8,5,3,2,0,0,0,0,0,6,28,9,18,13,5,0
"20240511ST KIL",2024-05-11,"Scotland Premiership","St Mirren","Kilmarnock",0,1,"A",10,15,2,4,10,13,8,5,0,2,0,0,0,0,0,1,25,6,23,13,2,0
"20240512HIBABE",2024-05-12,"Scotland Premiership","Hibernian","Aberdeen",0,4,"A",16,16,4,4,13,5,8,3,2,1,0,0,0,0,0,4,32,8,18,11,3,0
"20240514RANDUN",2024-05-14,"Scotland Premiership","Rangers","Dundee",5,2,"H",31,11,13,5,6,6,6,5,0,0,0,0,0,0,0,7,42,18,12,11,0,0
"20240515KILCEL",2024-05-15,"Scotland Premiership","Kilmarnock","Celtic",0,5,"A",12,30,2,12,7,12,2,9,2,0,0,0,0,0,0,5,42,14,19,11,2,0
"20240515ABELIV",2024-05-15,"Scotland Premiership","Aberdeen","Livingston",5,1,"H",17,9,7,3,13,18,6,3,2,2,0,0,0,0,0,6,26,10,31,9,4,0
"20240515HIBMOT",2024-05-15,"Scotland Premiership","Hibernian","Motherwell",3,0,"H",12,9,5,3,6,5,8,4,1,1,0,0,0,0,0,3,21,8,11,12,2,0
"20240515ST ROS",2024-05-15,"Scotland Premiership","St Johnstone","Ross County",1,1,"D",9,10,3,5,6,11,4,4,1,4,0,0,0,0,0,2,19,8,17,8,5,0
"20240515ST HEA",2024-05-15,"Scotland Premiership","St Mirren","Hearts",2,2,"D",14,10,5,4,7,10,4,3,0,0,0,0,0,0,0,4,24,9,17,7,0,0
"20240518CELST ",2024-05-18,"Scotland Premiership","Celtic","St Mirren",3,2,"H",12,9,4,3,7,9,11,3,0,0,0,0,0,0,0,5,21,7,16,14,0,0
"20240518DUNKIL",2024-05-18,"Scotland Premiership","Dundee","Kilmarnock",1,1,"D",11,11,2,3,7,10,4,3,1,3,0,1,0,0,0,2,22,5,17,7,4,1
"20240518HEARAN",2024-05-18,"Scotland Premiership","Hearts","Rangers",3,3,"D",13,22,4,10,10,11,2,6,1,1,0,0,0,0,0,6,35,14,21,8,2,0
"20240519LIVHIB",2024-05-19,"Scotland Premiership","Livingston","Hibernian",1,1,"D",4,13,2,3,6,8,4,9,0,1,0,0,0,0,0,2,17,5,14,13,1,0
"20240519MOTST ",2024-05-19,"Scotland Premiership","Motherwell","St Johnstone",1,2,"A",13,9,5,4,7,9,7,3,0,1,0,0,0,0,0,3,22,9,16,10,1,0
"20240519ROSABE",2024-05-19,"Scotland Premiership","Ross County","Aberdeen",2,2,"D",15,11,6,4,14,10,3,7,4,1,0,1,0,0,0,4,26,10,24,10,5,1
"20240803HEARAN",2024-08-03,"Scotland Premiership","Hearts","Rangers",0,0,"D",17,7,3,3,14,11,8,7,3,1,0,0,0,0,0,0,24,6,25,15,4,0
"20240803MOTROS",2024-08-03,"Scotland Premiership","Motherwell","Ross County",0,0,"D",11,13,6,3,5,13,9,3,0,2,0,0,0,0,0,0,24,9,18,12,2,0
"20240804DUNDUN",2024-08-04,"Scotland Premiership","Dundee United","Dundee",2,2,"D",9,10,5,6,7,6,5,6,2,0,0,0,0,0,0,4,19,11,13,11,2,0
"20240804ST HIB",2024-08-04,"Scotland Premiership","St Mirren","Hibernian",3,0,"H",11,14,3,1,9,0,4,8,3,1,0,0,0,0,0,3,25,4,9,12,4,0
"20240804CELKIL",2024-08-04,"Scotland Premiership","Celtic","Kilmarnock",4,0,"H",20,4,10,2,7,12,10,1,0,2,0,0,0,0,0,4,24,12,19,11,2,0
"20240805ST ABE",2024-08-05,"Scotland Premiership","St Johnstone","Aberdeen",1,2,"A",18,21,8,10,11,13,12,7,2,1,0,0,0,0,0,3,39,18,24,19,3,0
"20240810RANMOT",2024-08-10,"Scotland Premiership","Rangers","Motherwell",2,1,"H",19,7,9,1,9,8,6,4,2,0,0,0,0,0,0,3,26,10,17,10,2,0
"20240810ROSDUN",2024-08-10,"Scotland Premiership","Ross County","Dundee United",1,1,"D",21,12,5,2,11,13,7,5,1,2,0,0,0,0,0,2,33,7,24,12,3,0
"20240810DUNHEA",2024-08-10,"Scotland Premiership","Dundee","Hearts",3,1,"H",11,14,6,3,8,12,2,10,3,4,0,0,0,0,0,4,25,9,20,12,7,0
"20240811HIBCEL",2024-08-11,"Scotland Premiership","Hibernian","Celtic",0,2,"A",4,19,0,7,11,10,3,5,2,1,0,0,0,0,0,2,23,7,21,8,3,0
"20240811ABEST ",2024-08-11,"Scotland Premiership","Aberdeen","St Mirren",3,1,"H",11,10,3,5,15,14,6,2,2,3,0,0,0,0,0,4,21,8,29,8,5,0
"20240811KILST ",2024-08-11,"Scotland Premiership","Kilmarnock","St Johnstone",0,3,"A",14,12,2,7,14,14,4,4,3,4,1,0,0,0,0,3,26,9,28,8,7,1
"20240824DUNST ",2024-08-24,"Scotland Premiership","Dundee United","St Johnstone",2,0,"H",3,10,2,1,14,11,2,6,2,2,0,1,0,0,0,2,13,3,25,8,4,1
"20240824HIBDUN",2024-08-24,"Scotland Premiership","Hibernian","Dundee",2,2,"D",13,9,2,5,14,15,5,4,4,4,0,0,0,0,0,4,22,7,29,9,8,0
"20240824RANROS",2024-08-24,"Scotland Premiership","Rangers","Ross County",6,0,"H",17,4,9,2,10,12,5,0,1,3,0,0,0,0,0,6,21,11,22,5,4,0
"20240825ST CEL",2024-08-25,"Scotland Premiership","St Mirren","Celtic",0,3,"A",3,21,1,8,12,7,2,10,2,1,0,0,0,0,0,3,24,9,19,12,3,0
"20240825ABEKIL",2024-08-25,"Scotland Premiership","Aberdeen","Kilmarnock",2,0,"H",12,7,3,2,14,12,8,6,3,0,0,1,0,0,0,2,19,5,26,14,3,1
"20240825MOTHEA",2024-08-25,"Scotland Premiership","Motherwell","Hearts",3,1,"H",14,9,6,3,8,17,8,7,1,4,0,0,0,0,0,4,23,9,25,15,5,0
"20240831DUNST ",2024-08-31,"Scotland Premiership","Dundee","St Mirren",2,2,"D",14,14,5,6,9,16,6,1,2,4,0,0,0,0,0,4,28,11,25,7,6,0
"20240831ST MOT",2024-08-31,"Scotland Premiership","St Johnstone","Motherwell",1,2,"A",13,14,5,6,12,11,4,13,1,0,1,0,0,0,0,3,27,11,23,17,1,1
"20240831ROSABE",2024-08-31,"Scotland Premiership","Ross County","Aberdeen",0,1,"A",8,9,4,3,11,13,1,12,3,1,0,0,0,0,0,1,17,7,24,13,4,0
"20240901CELRAN",2024-09-01,"Scotland Premiership","Celtic","Rangers",3,0,"H",14,13,4,4,12,11,7,4,4,5,0,0,0,0,0,3,27,8,23,11,9,0
"20240901HEADUN",2024-09-01,"Scotland Premiership","Hearts","Dundee United",0,1,"A",14,12,2,3,15,6,6,4,2,4,0,0,0,0,0,1,26,5,21,10,6,0
"20240901KILHIB",2024-09-01,"Scotland Premiership","Kilmarnock","Hibernian",1,1,"D",14,9,3,4,10,17,4,7,2,3,0,0,0,0,0,2,23,7,27,11,5,0
"20240914ABEMOT",2024-09-14,"Scotland Premiership","Aberdeen","Motherwell",2,1,"H",11,13,4,4,14,16,6,5,4,5,0,0,0,0,0,3,24,8,30,11,9,0
"20240914CELHEA",2024-09-14,"Scotland Premiership","Celtic","Hearts",2,0,"H",18,7,6,3,9,11,5,3,1,1,0,0,0,0,0,2,25,9,20,8,2,0
"20240914HIBST ",2024-09-14,"Scotland Premiership","Hibernian","St Johnstone",2,0,"H",17,5,4,1,6,17,5,7,1,4,0,1,0,0,0,2,22,5,23,12,5,1
"20240914ROSDUN",2024-09-14,"Scotland Premiership","Ross County","Dundee",2,0,"H",9,8,5,3,13,12,3,8,2,1,0,0,0,0,0,2,17,8,25,11,3,0
"20240914ST KIL",2024-09-14,"Scotland Premiership","St Mirren","Kilmarnock",2,2,"D",14,11,2,3,15,9,3,10,2,3,0,1,0,0,0,4,25,5,24,13,5,1
"20240915DUNRAN",2024-09-15,"Scotland Premiership","Dundee United","Rangers",0,1,"A",5,11,0,6,11,13,4,4,4,6,0,0,0,0,0,1,16,6,24,8,10,0
"20240921ROSST ",2024-09-21,"Scotland Premiership","Ross County","St Johnstone",3,3,"D",14,8,6,3,13,15,1,3,2,4,0,0,0,0,0,6,22,9,28,4,6,0
"20240921ST HEA",2024-09-21,"Scotland Premiership","St Mirren","Hearts",2,1,"H",11,9,2,2,14,9,5,4,3,3,0,0,0,0,0,3,20,4,23,9,6,0
"20240928DUNABE",2024-09-28,"Scotland Premiership","Dundee","Aberdeen",1,2,"A",14,8,6,2,6,8,10,4,0,3,0,0,0,0,0,3,22,8,14,14,3,0
"20240928HEAROS",2024-09-28,"Scotland Premiership","Hearts","Ross County",1,1,"D",21,13,8,2,8,8,11,5,1,4,0,0,0,0,0,2,34,10,16,16,5,0
"20240928KILDUN",2024-09-28,"Scotland Premiership","Kilmarnock","Dundee United",3,3,"D",15,19,3,8,8,12,7,3,1,2,0,0,0,0,0,6,34,11,20,10,3,0
"20240928MOTST ",2024-09-28,"Scotland Premiership","Motherwell","St Mirren",2,1,"H",9,15,4,9,12,13,9,6,4,2,1,1,0,0,0,3,24,13,25,15,6,2
"20240928ST CEL",2024-09-28,"Scotland Premiership","St Johnstone","Celtic",0,6,"A",5,19,1,11,9,8,3,13,1,1,0,0,0,0,0,6,24,12,17,16,2,0
"20240929RANHIB",2024-09-29,"Scotland Premiership","Rangers","Hibernian",1,0,"H",18,18,4,3,11,12,4,7,2,2,0,0,0,0,0,1,36,7,23,11,4,0
"20241005DUNKIL",2024-10-05,"Scotland Premiership","Dundee","Kilmarnock",2,3,"A",10,25,3,5,13,9,2,10,1,1,1,0,0,0,0,5,35,8,22,12,2,1
"20241005HIBMOT",2024-10-05,"Scotland Premiership","Hibernian","Motherwell",1,2,"A",17,11,7,5,18,6,10,5,3,3,1,0,0,0,0,3,28,12,24,15,6,1
"20241005ST DUN",2024-10-05,"Scotland Premiership","St Mirren","Dundee United",0,1,"A",16,12,3,3,4,6,3,3,0,3,0,0,0,0,0,1,28,6,10,6,3,0
"20241006ROSCEL",2024-10-06,"Scotland Premiership","Ross County","Celtic",1,2,"A",8,23,5,6,11,11,1,9,3,1,0,0,0,0,0,3,31,11,22,10,4,0
"20241006ABEHEA",2024-10-06,"Scotland Premiership","Aberdeen","Hearts",3,2,"H",11,11,3,3,8,17,2,5,1,4,0,1,0,0,0,5,22,6,25,7,5,1
"20241006RANST ",2024-10-06,"Scotland Premiership","Rangers","St Johnstone",2,0,"H",21,10,6,2,22,12,7,3,1,1,0,0,0,0,0,2,31,8,34,10,2,0
"20241019CELABE",2024-10-19,"Scotland Premiership","Celtic","Aberdeen",2,2,"D",32,8,7,4,12,15,19,2,1,5,0,0,0,0,0,4,40,11,27,21,6,0
"20241019DUNHIB",2024-10-19,"Scotland Premiership","Dundee United","Hibernian",3,2,"H",8,8,4,4,14,14,5,5,2,2,0,1,0,0,0,5,16,8,28,10,4,1
"20241019HEAST ",2024-10-19,"Scotland Premiership","Hearts","St Mirren",4,0,"H",12,5,4,0,10,15,1,6,0,5,0,0,0,0,0,4,17,4,25,7,5,0
"20241019MOTDUN",2024-10-19,"Scotland Premiership","Motherwell","Dundee",0,1,"A",10,15,3,4,10,13,3,5,0,2,0,0,0,0,0,1,25,7,23,8,2,0
"20241019ST ROS",2024-10-19,"Scotland Premiership","St Johnstone","Ross County",3,0,"H",18,7,7,1,8,12,5,3,1,0,0,2,0,0,0,3,25,8,20,8,1,2
"20241020KILRAN",2024-10-20,"Scotland Premiership","Kilmarnock","Rangers",1,0,"H",10,15,3,3,12,13,1,6,1,3,0,0,0,0,0,1,25,6,25,7,4,0
"20241026DUNST ",2024-10-26,"Scotland Premiership","Dundee","St Johnstone",1,2,"A",8,20,4,4,10,10,2,3,3,2,0,0,0,0,0,3,28,8,20,5,5,0
"20241026ROSKIL",2024-10-26,"Scotland Premiership","Ross County","Kilmarnock",2,1,"H",14,9,3,2,10,10,5,5,1,2,0,1,0,0,0,3,23,5,20,10,3,1
"20241026ABEDUN",2024-10-26,"Scotland Premiership","Aberdeen","Dundee United",1,0,"H",12,8,5,0,9,18,8,2,1,3,0,0,0,0,0,1,20,5,27,10,4,0
"20241027HIBHEA",2024-10-27,"Scotland Premiership","Hibernian","Hearts",1,1,"D",12,11,7,2,11,12,1,6,2,3,0,0,0,0,0,2,23,9,23,7,5,0
"20241027MOTCEL",2024-10-27,"Scotland Premiership","Motherwell","Celtic",0,3,"A",9,21,2,10,11,9,3,10,1,2,1,0,0,0,0,3,30,12,20,13,3,1
"20241027RANST ",2024-10-27,"Scotland Premiership","Rangers","St Mirren",2,1,"H",16,8,7,3,10,9,7,3,2,2,0,0,0,0,0,3,24,10,19,10,4,0
"20241030CELDUN",2024-10-30,"Scotland Premiership","Celtic","Dundee",2,0,"H",24,3,5,1,12,7,7,2,1,2,0,0,0,0,0,2,27,6,19,9,3,0
"20241030DUNMOT",2024-10-30,"Scotland Premiership","Dundee United","Motherwell",1,2,"A",17,9,5,3,11,12,11,3,3,4,0,0,0,0,0,3,26,8,23,14,7,0
"20241030HEAKIL",2024-10-30,"Scotland Premiership","Hearts","Kilmarnock",1,2,"A",18,15,5,4,14,9,10,1,1,3,0,0,0,0,0,3,33,9,23,11,4,0
"20241030ROSHIB",2024-10-30,"Scotland Premiership","Ross County","Hibernian",0,0,"D",13,12,2,2,10,13,4,2,1,1,0,0,0,0,0,0,25,4,23,6,2,0
"20241030ST ST ",2024-10-30,"Scotland Premiership","St Mirren","St Johnstone",3,1,"H",17,5,5,2,14,9,9,2,2,1,0,0,0,0,0,4,22,7,23,11,3,0
"20241030ABERAN",2024-10-30,"Scotland Premiership","Aberdeen","Rangers",2,1,"H",19,17,6,3,6,20,4,6,5,3,0,0,0,0,0,3,36,9,26,10,8,0
"20241102ST HEA",2024-11-02,"Scotland Premiership","St Johnstone","Hearts",1,2,"A",13,13,5,2,13,12,6,9,2,4,0,0,0,0,0,3,26,7,25,15,6,0
"20241102ST ROS",2024-11-02,"Scotland Premiership","St Mirren","Ross County",0,0,"D",11,7,3,3,13,8,6,5,2,1,0,0,0,0,0,0,18,6,21,11,3,0
"20241103DUNKIL",2024-11-03,"Scotland Premiership","Dundee","Kilmarnock",3,2,"H",17,15,5,4,16,8,7,1,2,1,0,0,0,0,0,5,32,9,24,8,3,0
"20241103HIBDUN",2024-11-03,"Scotland Premiership","Hibernian","Dundee United",1,1,"D",15,8,3,2,10,12,13,2,0,2,1,0,0,0,0,2,23,5,22,15,2,1
"20241109DUNROS",2024-11-09,"Scotland Premiership","Dundee United","Ross County",3,0,"H",15,9,4,0,11,10,5,3,1,1,0,0,0,0,0,3,24,4,21,8,2,0
"20241109HIBST ",2024-11-09,"Scotland Premiership","Hibernian","St Mirren",1,2,"A",12,15,2,5,11,13,5,5,2,2,0,0,0,0,0,3,27,7,24,10,4,0
"20241109MOTST ",2024-11-09,"Scotland Premiership","Motherwell","St Johnstone",2,1,"H",15,12,4,4,14,10,3,3,1,0,0,0,0,0,0,3,27,8,24,6,1,0
"20241109ABEDUN",2024-11-09,"Scotland Premiership","Aberdeen","Dundee",4,1,"H",18,13,8,5,12,16,7,4,3,1,0,0,0,0,0,5,31,13,28,11,4,0
"20241110KILCEL",2024-11-10,"Scotland Premiership","Kilmarnock","Celtic",0,2,"A",18,10,6,6,14,10,6,4,3,3,0,0,0,0,0,2,28,12,24,10,6,0
"20241110RANHEA",2024-11-10,"Scotland Premiership","Rangers","Hearts",1,0,"H",20,5,3,0,8,9,9,6,2,3,0,0,0,0,0,1,25,3,17,15,5,0
"20241123ST KIL",2024-11-23,"Scotland Premiership","St Johnstone","Kilmarnock",1,0,"H",10,12,4,1,11,10,4,14,2,1,0,1,0,0,0,1,22,5,21,18,3,1
"20241123ROSMOT",2024-11-23,"Scotland Premiership","Ross County","Motherwell",2,1,"H",16,8,4,3,18,13,12,3,1,1,0,0,0,0,0,3,24,7,31,15,2,0
"20241123RANDUN",2024-11-23,"Scotland Premiership","Rangers","Dundee United",1,1,"D",29,5,9,1,5,13,9,1,1,3,0,0,0,0,0,2,34,10,18,10,4,0
"20241123ST ABE",2024-11-23,"Scotland Premiership","St Mirren","Aberdeen",2,1,"H",16,15,6,4,11,12,7,3,3,5,0,0,0,0,0,3,31,10,23,10,8,0
"20241123DUNHIB",2024-11-23,"Scotland Premiership","Dundee","Hibernian",4,1,"H",17,12,6,1,6,14,8,2,3,1,0,1,0,0,0,5,29,7,20,10,4,1
"20241123HEACEL",2024-11-23,"Scotland Premiership","Hearts","Celtic",1,4,"A",9,13,4,9,7,8,1,6,1,1,0,0,0,0,0,5,22,13,15,7,2,0
"20241126HIBABE",2024-11-26,"Scotland Premiership","Hibernian","Aberdeen",3,3,"D",21,15,4,6,14,10,9,6,3,1,0,0,0,0,0,6,36,10,24,15,4,0
"20241130CELROS",2024-11-30,"Scotland Premiership","Celtic","Ross County",5,0,"H",25,2,9,1,11,6,19,0,0,1,0,0,0,0,0,5,27,10,17,19,1,0
"20241130DUNST ",2024-11-30,"Scotland Premiership","Dundee United","St Mirren",2,0,"H",15,10,6,1,5,12,4,8,2,2,0,1,0,0,0,2,25,7,17,12,4,1
"20241130KILDUN",2024-11-30,"Scotland Premiership","Kilmarnock","Dundee",1,1,"D",20,10,5,4,9,11,6,3,2,2,0,0,0,0,0,2,30,9,20,9,4,0
"20241130MOTHIB",2024-11-30,"Scotland Premiership","Motherwell","Hibernian",0,3,"A",7,17,3,8,10,14,3,4,0,0,0,0,0,0,0,3,24,11,24,7,0,0
"20241201ST RAN",2024-12-01,"Scotland Premiership","St Johnstone","Rangers",0,1,"A",4,17,1,10,9,14,3,5,2,2,0,0,0,0,0,1,21,11,23,8,4,0
"20241201HEAABE",2024-12-01,"Scotland Premiership","Hearts","Aberdeen",1,1,"D",16,8,2,3,9,17,9,6,1,5,0,0,0,0,0,2,24,5,26,15,6,0
"20241204DUNMOT",2024-12-04,"Scotland Premiership","Dundee","Motherwell",4,1,"H",9,24,4,6,12,15,4,10,2,2,0,0,0,0,0,5,33,10,27,14,4,0
"20241204RANKIL",2024-12-04,"Scotland Premiership","Rangers","Kilmarnock",6,0,"H",28,1,11,0,6,8,7,4,0,2,0,0,0,0,0,6,29,11,14,11,2,0
"20241204ABECEL",2024-12-04,"Scotland Premiership","Aberdeen","Celtic",0,1,"A",8,15,4,4,12,11,2,10,3,1,0,0,0,0,0,1,23,8,23,12,4,0
"20241207ABEST ",2024-12-07,"Scotland Premiership","Aberdeen","St Johnstone",1,1,"D",7,6,2,3,10,19,6,1,5,4,0,0,0,0,0,2,13,5,29,7,9,0
"20241207CELHIB",2024-12-07,"Scotland Premiership","Celtic","Hibernian",3,0,"H",21,14,11,9,8,7,14,7,1,2,0,0,0,0,0,3,35,20,15,21,3,0
"20241207DUNKIL",2024-12-07,"Scotland Premiership","Dundee United","Kilmarnock",1,1,"D",22,14,7,7,14,7,9,1,3,1,0,0,0,0,0,2,36,14,21,10,4,0
"20241207HEADUN",2024-12-07,"Scotland Premiership","Hearts","Dundee",2,0,"H",19,6,8,0,11,13,6,4,2,3,0,0,0,0,0,2,25,8,24,10,5,0
"20241207ST MOT",2024-12-07,"Scotland Premiership","St Mirren","Motherwell",0,1,"A",11,9,6,4,16,15,7,2,3,3,1,0,0,0,0,1,20,10,31,9,6,1
"20241208ROSRAN",2024-12-08,"Scotland Premiership","Ross County","Rangers",0,3,"A",10,19,2,9,9,13,8,10,1,1,0,0,0,0,0,3,29,11,22,18,2,0
"20241214HIBROS",2024-12-14,"Scotland Premiership","Hibernian","Ross County",3,1,"H",19,13,7,4,7,9,9,15,1,4,0,0,0,0,0,4,32,11,16,24,5,0
"20241214MOTDUN",2024-12-14,"Scotland Premiership","Motherwell","Dundee United",4,3,"H",12,17,6,9,8,16,2,3,2,3,0,0,0,0,0,7,29,15,24,5,5,0
"20241214ST ST ",2024-12-14,"Scotland Premiership","St Johnstone","St Mirren",2,3,"A",9,8,3,4,11,14,1,2,2,2,0,0,0,0,0,5,17,7,25,3,4,0
"20241215KILHEA",2024-12-15,"Scotland Premiership","Kilmarnock","Hearts",1,0,"H",7,14,5,4,6,11,3,6,1,2,1,0,0,0,0,1,21,9,17,9,3,1
"20241220MOTKIL",2024-12-20,"Scotland Premiership","Motherwell","Kilmarnock",1,1,"D",4,12,1,5,14,17,2,8,1,4,1,0,0,0,0,2,16,6,31,10,5,1
"20241221ABEHIB",2024-12-21,"Scotland Premiership","Aberdeen","Hibernian",1,3,"A",14,7,2,4,6,12,5,6,2,2,0,0,0,0,0,4,21,6,18,11,4,0
"20241221RANDUN",2024-12-21,"Scotland Premiership","Rangers","Dundee",1,0,"H",21,5,4,1,12,3,6,3,2,2,0,0,0,0,0,1,26,5,15,9,4,0
"20241221ROSST ",2024-12-21,"Scotland Premiership","Ross County","St Mirren",1,2,"A",13,14,1,5,7,13,4,2,0,2,0,1,0,0,0,3,27,6,20,6,2,1
"20241222DUNCEL",2024-12-22,"Scotland Premiership","Dundee United","Celtic",0,0,"D",2,17,2,3,11,8,3,9,2,1,0,0,0,0,0,0,19,5,19,12,3,0
"20241222HEAST ",2024-12-22,"Scotland Premiership","Hearts","St Johnstone",2,1,"H",11,8,6,2,11,13,8,0,2,1,0,0,0,0,0,3,19,8,24,8,3,0
"20241226HEAHIB",2024-12-26,"Scotland Premiership","Hearts","Hibernian",1,2,"A",15,12,5,6,10,10,6,3,2,1,0,0,0,0,0,3,27,11,20,9,3,0
"20241226CELMOT",2024-12-26,"Scotland Premiership","Celtic","Motherwell",4,0,"H",23,2,7,0,10,10,6,3,1,5,0,0,0,0,0,4,25,7,20,9,6,0
"20241226DUNROS",2024-12-26,"Scotland Premiership","Dundee","Ross County",0,3,"A",9,22,2,7,9,8,5,5,0,2,0,0,0,0,0,3,31,9,17,10,2,0
"20241226KILABE",2024-12-26,"Scotland Premiership","Kilmarnock","Aberdeen",4,0,"H",22,7,8,3,11,13,7,3,0,4,0,0,0,0,0,4,29,11,24,10,4,0
"20241226ST DUN",2024-12-26,"Scotland Premiership","St Johnstone","Dundee United",1,2,"A",11,13,4,4,7,14,4,10,2,1,0,1,0,0,0,3,24,8,21,14,3,1
"20241226ST RAN",2024-12-26,"Scotland Premiership","St Mirren","Rangers",2,1,"H",7,21,3,5,9,9,7,6,1,3,0,0,0,0,0,3,28,8,18,13,4,0
"20241229CELST ",2024-12-29,"Scotland Premiership","Celtic","St Johnstone",4,0,"H",30,1,11,0,8,1,12,2,0,1,0,0,0,0,0,4,31,11,9,14,1,0
"20241229HIBKIL",2024-12-29,"Scotland Premiership","Hibernian","Kilmarnock",1,0,"H",7,6,2,3,8,13,5,10,1,2,0,1,0,0,0,1,13,5,21,15,3,1
"20241229MOTRAN",2024-12-29,"Scotland Premiership","Motherwell","Rangers",2,2,"D",8,23,4,9,12,13,3,6,4,3,0,0,0,0,0,4,31,13,25,9,7,0
"20241229ROSHEA",2024-12-29,"Scotland Premiership","Ross County","Hearts",2,2,"D",14,10,4,4,9,13,10,5,0,0,0,0,0,0,0,4,24,8,22,15,0,0
"20241229ST DUN",2024-12-29,"Scotland Premiership","St Mirren","Dundee",1,2,"A",14,8,5,5,10,5,5,9,1,2,0,0,0,0,0,3,22,10,15,14,3,0
"20241229DUNABE",2024-12-29,"Scotland Premiership","Dundee United","Aberdeen",1,0,"H",19,9,6,2,12,14,9,1,4,3,0,0,0,0,0,1,28,8,26,10,7,0
"20220101BLAHUL",2022-01-01,"England Championship","Blackpool","Hull",1,0,"H",8,14,3,6,7,14,1,2,0,2,0,0,0,0,0,1,22,9,21,3,2,0
"20220102BRIMIL",2022-01-02,"England Championship","Bristol City","Millwall",3,2,"H",12,11,8,3,14,11,5,3,4,2,0,0,0,0,0,5,23,11,25,8,6,0
"20220102BIRQPR",2022-01-02,"England Championship","Birmingham","QPR",1,2,"A",8,6,1,5,11,9,1,3,1,3,0,0,0,0,0,3,14,6,20,4,4,0
"20220102BLAHUD",2022-01-02,"England Championship","Blackburn","Huddersfield",0,0,"D",11,4,2,1,13,13,10,3,3,2,0,0,0,0,0,0,15,3,26,13,5,0
"20220102WESCAR",2022-01-02,"England Championship","West Brom","Cardiff",1,1,"D",13,6,3,1,9,14,5,1,2,2,2,1,0,0,0,2,19,4,23,6,4,3
"20220103READER",2022-01-03,"England Championship","Reading","Derby",2,2,"D",9,16,3,5,14,7,3,10,1,2,0,0,0,0,0,4,25,8,21,13,3,0
"20220103STOPRE",2022-01-03,"England Championship","Stoke","Preston",1,2,"A",14,6,2,3,11,8,4,6,3,2,0,0,0,0,0,3,20,5,19,10,5,0
"20220111REAFUL",2022-01-11,"England Championship","Reading","Fulham",0,7,"A",3,22,1,13,6,6,2,11,1,0,0,0,0,0,0,7,25,14,12,13,1,0
"20220115CARBLA",2022-01-15,"England Championship","Cardiff","Blackburn",0,1,"A",11,4,2,2,10,13,7,2,4,5,0,1,0,0,0,1,15,4,23,9,9,1
"20220115LUTBOU",2022-01-15,"England Championship","Luton","Bournemouth",3,2,"H",15,12,7,6,7,10,4,6,0,2,0,0,0,0,0,5,27,13,17,10,2,0
"20220115DERSHE",2022-01-15,"England Championship","Derby","Sheffield United",2,0,"H",5,8,2,2,7,13,1,0,1,1,0,0,0,0,0,2,13,4,20,1,2,0
"20220115FULBRI",2022-01-15,"England Championship","Fulham","Bristol City",6,2,"H",18,8,8,5,8,8,6,4,0,2,0,0,0,0,0,8,26,13,16,10,2,0
"20220115HUDSWA",2022-01-15,"England Championship","Huddersfield","Swansea",1,1,"D",11,18,8,11,8,3,4,7,0,0,0,0,0,0,0,2,29,19,11,11,0,0
"20220115MIDREA",2022-01-15,"England Championship","Middlesbrough","Reading",2,1,"H",10,10,5,4,11,17,5,5,1,3,0,0,0,0,0,3,20,9,28,10,4,0
"20220115MILNOT",2022-01-15,"England Championship","Millwall","Nott'm Forest",0,1,"A",12,24,4,7,6,8,7,7,1,2,0,0,0,0,0,1,36,11,14,14,3,0
"20220115PETCOV",2022-01-15,"England Championship","Peterboro","Coventry",1,4,"A",9,22,4,9,13,10,3,8,3,1,0,0,0,0,0,5,31,13,23,11,4,0
"20220115PREBIR",2022-01-15,"England Championship","Preston","Birmingham",1,1,"D",15,16,5,3,10,9,7,7,1,1,0,0,0,0,0,2,31,8,19,14,2,0
"20220115QPRWES",2022-01-15,"England Championship","QPR","West Brom",1,0,"H",9,12,4,2,12,12,2,5,2,1,0,0,0,0,0,1,21,6,24,7,3,0
"20220116HULSTO",2022-01-16,"England Championship","Hull","Stoke",0,2,"A",5,22,1,9,17,10,7,5,3,1,0,0,0,0,0,2,27,10,27,12,4,0
"20220118FULBIR",2022-01-18,"England Championship","Fulham","Birmingham",6,2,"H",15,14,11,6,7,10,6,5,1,1,0,0,0,0,0,8,29,17,17,11,2,0
"20220118PRESHE",2022-01-18,"England Championship","Preston","Sheffield United",2,2,"D",12,18,8,7,6,8,4,11,1,2,1,0,0,0,0,4,30,15,14,15,3,1
"20220119HULBLA",2022-01-19,"England Championship","Hull","Blackburn",2,0,"H",14,15,5,4,11,9,4,10,0,3,0,0,0,0,0,2,29,9,20,14,3,0
"20220119REALUT",2022-01-19,"England Championship","Reading","Luton",0,2,"A",8,16,4,4,9,13,6,4,2,0,0,0,0,0,0,2,24,8,22,10,2,0
"20220122BRICAR",2022-01-22,"England Championship","Bristol City","Cardiff",3,2,"H",12,16,6,5,8,10,3,6,1,2,0,0,0,0,0,5,28,11,18,9,3,0
"20220122NOTDER",2022-01-22,"England Championship","Nott'm Forest","Derby",2,1,"H",13,4,6,1,17,22,4,2,2,5,0,1,0,0,0,3,17,7,39,6,7,1
"20220122BIRBAR",2022-01-22,"England Championship","Birmingham","Barnsley",2,1,"H",11,9,5,4,9,11,5,3,1,2,0,0,0,0,0,3,20,9,20,8,3,0
"20220122BLAMIL",2022-01-22,"England Championship","Blackpool","Millwall",1,0,"H",14,9,5,3,8,10,6,2,1,0,0,0,0,0,0,1,23,8,18,8,1,0
"20220122BOUHUL",2022-01-22,"England Championship","Bournemouth","Hull",0,1,"A",17,6,6,4,11,11,4,7,2,2,0,0,0,0,0,1,23,10,22,11,4,0
"20220122COVQPR",2022-01-22,"England Championship","Coventry","QPR",1,2,"A",21,8,7,3,12,7,13,2,2,1,0,0,0,0,0,3,29,10,19,15,3,0
"20220122REAHUD",2022-01-22,"England Championship","Reading","Huddersfield",3,4,"A",14,19,4,7,13,11,4,4,3,1,0,0,0,0,0,7,33,11,24,8,4,0
"20220122SHELUT",2022-01-22,"England Championship","Sheffield United","Luton",2,0,"H",25,4,7,2,14,8,8,1,0,0,0,1,0,0,0,2,29,9,22,9,0,1
"20220122STOFUL",2022-01-22,"England Championship","Stoke","Fulham",2,3,"A",6,12,3,6,7,11,3,5,2,0,0,0,0,0,0,5,18,9,18,8,2,0
"20220122SWAPRE",2022-01-22,"England Championship","Swansea","Preston",1,0,"H",10,9,4,1,16,11,2,9,3,3,0,0,0,0,0,1,19,5,27,11,6,0
"20220122WESPET",2022-01-22,"England Championship","West Brom","Peterboro",3,0,"H",27,1,6,0,11,8,10,1,1,1,0,0,0,0,0,3,28,6,19,11,2,0
"20220124BLAMID",2022-01-24,"England Championship","Blackburn","Middlesbrough",1,0,"H",15,9,3,1,14,14,6,7,4,6,0,0,0,0,0,1,24,4,28,13,10,0
"20220125BIRPET",2022-01-25,"England Championship","Birmingham","Peterboro",2,2,"D",12,10,3,4,15,12,3,4,0,1,0,0,0,0,0,4,22,7,27,7,1,0
"20220125COVSTO",2022-01-25,"England Championship","Coventry","Stoke",1,0,"H",14,7,4,0,6,9,5,5,2,1,0,0,0,0,0,1,21,4,15,10,3,0
"20220125LUTBRI",2022-01-25,"England Championship","Luton","Bristol City",2,1,"H",8,12,3,3,11,9,8,9,2,2,0,0,0,0,0,3,20,6,20,17,4,0
"20220125NOTBAR",2022-01-25,"England Championship","Nott'm Forest","Barnsley",3,0,"H",18,9,6,2,9,15,12,0,2,3,0,0,0,0,0,3,27,8,24,12,5,0
"20220125QPRSWA",2022-01-25,"England Championship","QPR","Swansea",0,0,"D",6,12,2,5,15,15,4,3,3,3,0,1,0,0,0,0,18,7,30,7,6,1
"20220126WESPRE",2022-01-26,"England Championship","West Brom","Preston",0,2,"A",8,10,0,3,13,19,3,4,2,4,0,0,0,0,0,2,18,3,32,7,6,0
"20220128HUDSTO",2022-01-28,"England Championship","Huddersfield","Stoke",1,1,"D",13,16,5,8,8,10,3,5,2,3,0,0,0,0,0,2,29,13,18,8,5,0
"20220129BARBOU",2022-01-29,"England Championship","Barnsley","Bournemouth",0,1,"A",14,15,7,3,4,14,2,9,0,2,0,1,0,0,0,1,29,10,18,11,2,1
"20220129FULBLA",2022-01-29,"England Championship","Fulham","Blackpool",1,1,"D",19,10,6,4,13,15,9,3,4,2,0,0,0,0,0,2,29,10,28,12,6,0
"20220129HULSWA",2022-01-29,"England Championship","Hull","Swansea",2,0,"H",5,15,2,5,7,10,1,2,0,2,0,0,0,0,0,2,20,7,17,3,2,0
"20220129LUTBLA",2022-01-29,"England Championship","Luton","Blackburn",0,0,"D",8,7,2,2,16,14,6,5,3,2,0,0,0,0,0,0,15,4,30,11,5,0
"20220129MIDCOV",2022-01-29,"England Championship","Middlesbrough","Coventry",1,0,"H",9,15,3,5,10,17,6,8,2,1,0,0,0,0,0,1,24,8,27,14,3,0
"20220129MILWES",2022-01-29,"England Championship","Millwall","West Brom",2,0,"H",9,6,3,2,16,13,2,4,1,1,0,0,0,0,0,2,15,5,29,6,2,0
"20220129PREBRI",2022-01-29,"England Championship","Preston","Bristol City",2,2,"D",10,12,4,3,9,10,3,6,0,0,0,0,0,0,0,4,22,7,19,9,0,0
"20220129QPRREA",2022-01-29,"England Championship","QPR","Reading",4,0,"H",16,18,8,3,19,10,6,8,4,2,0,0,0,0,0,4,34,11,29,14,6,0
"20220129PETSHE",2022-01-29,"England Championship","Peterboro","Sheffield United",0,2,"A",3,20,2,5,9,13,0,9,0,1,0,0,0,0,0,2,23,7,22,9,1,0
"20220130DERBIR",2022-01-30,"England Championship","Derby","Birmingham",2,2,"D",16,13,6,4,4,18,7,6,0,4,0,0,1,0,1,4,29,10,22,13,4,0
"20220130CARNOT",2022-01-30,"England Championship","Cardiff","Nott'm Forest",2,1,"H",10,6,4,1,14,7,3,2,2,1,0,0,0,0,0,3,16,5,21,5,3,0
"20220201MILPRE",2022-02-01,"England Championship","Millwall","Preston",0,0,"D",7,4,2,1,8,8,2,3,3,1,0,0,0,0,0,0,11,3,16,5,4,0
"20220201SWALUT",2022-02-01,"England Championship","Swansea","Luton",0,1,"A",16,13,4,2,7,9,7,4,2,4,0,0,0,0,0,1,29,6,16,11,6,0
"20220202BARCAR",2022-02-02,"England Championship","Barnsley","Cardiff",0,1,"A",8,5,1,1,14,11,6,0,2,4,0,0,0,0,0,1,13,2,25,6,6,0
"20220202HUDDER",2022-02-02,"England Championship","Huddersfield","Derby",2,0,"H",16,1,6,0,11,9,4,3,1,3,0,1,0,0,0,2,17,6,20,7,4,1
"20220204BIRSHE",2022-02-04,"England Championship","Birmingham","Sheffield United",1,2,"A",7,9,2,5,14,8,1,6,4,1,0,0,0,0,0,3,16,7,22,7,5,0
"20220205BLABRI",2022-02-05,"England Championship","Blackpool","Bristol City",3,1,"H",7,9,5,4,11,4,6,4,4,4,0,0,0,0,0,4,16,9,15,10,8,0
"20220205HULPRE",2022-02-05,"England Championship","Hull","Preston",0,1,"A",10,7,2,4,14,15,7,4,0,2,0,0,0,0,0,1,17,6,29,11,2,0
"20220205SWABLA",2022-02-05,"England Championship","Swansea","Blackburn",1,0,"H",4,17,2,4,9,13,0,13,2,2,1,0,0,0,0,1,21,6,22,13,4,1
"20220208COVBLA",2022-02-08,"England Championship","Coventry","Blackpool",1,1,"D",20,10,4,4,10,9,9,4,4,1,0,0,0,0,0,2,30,8,19,13,5,0
"20220208DERHUL",2022-02-08,"England Championship","Derby","Hull",3,1,"H",11,9,5,2,9,16,2,10,2,3,0,0,1,0,1,4,20,7,25,12,5,0
"20220208FULMIL",2022-02-08,"England Championship","Fulham","Millwall",3,0,"H",20,8,6,2,12,14,6,4,1,3,0,0,0,0,0,3,28,8,26,10,4,0
"20220208LUTBAR",2022-02-08,"England Championship","Luton","Barnsley",2,1,"H",8,7,4,2,11,12,9,4,1,2,0,0,0,0,0,3,15,6,23,13,3,0
"20220208STOSWA",2022-02-08,"England Championship","Stoke","Swansea",3,0,"H",22,3,7,1,7,14,8,1,2,4,0,1,1,0,1,3,25,8,21,9,6,1
"20220209BLANOT",2022-02-09,"England Championship","Blackburn","Nott'm Forest",0,2,"A",13,14,8,5,20,11,5,4,3,3,1,0,0,0,0,2,27,13,31,9,6,1
"20220209BOUBIR",2022-02-09,"England Championship","Bournemouth","Birmingham",3,1,"H",9,10,5,5,10,16,5,8,0,5,1,0,0,0,0,4,19,10,26,13,5,1
"20220209BRIREA",2022-02-09,"England Championship","Bristol City","Reading",2,1,"H",10,18,4,4,20,7,5,6,4,1,0,0,0,0,0,3,28,8,27,11,5,0
"20220209CARPET",2022-02-09,"England Championship","Cardiff","Peterboro",4,0,"H",14,5,4,1,17,10,7,6,3,1,0,0,0,0,0,4,19,5,27,13,4,0
"20220209PREHUD",2022-02-09,"England Championship","Preston","Huddersfield",0,0,"D",16,8,4,1,12,7,1,2,1,2,0,0,0,0,0,0,24,5,19,3,3,0
"20220209QPRMID",2022-02-09,"England Championship","QPR","Middlesbrough",2,2,"D",7,18,4,5,9,10,3,8,0,1,0,0,0,0,0,4,25,9,19,11,1,0
"20220209SHEWES",2022-02-09,"England Championship","Sheffield United","West Brom",2,0,"H",12,13,5,3,10,10,3,2,1,1,0,1,0,0,0,2,25,8,20,5,2,1
"20220212HUDSHE",2022-02-12,"England Championship","Huddersfield","Sheffield United",0,0,"D",12,9,3,6,5,13,9,2,1,4,0,0,0,0,0,0,21,9,18,11,5,0
"20220212BARQPR",2022-02-12,"England Championship","Barnsley","QPR",1,0,"H",19,12,5,3,11,11,2,4,1,1,0,0,0,0,0,1,31,8,22,6,2,0
"20220212BIRLUT",2022-02-12,"England Championship","Birmingham","Luton",3,0,"H",9,8,6,2,8,12,0,7,0,0,0,0,0,0,0,3,17,8,20,7,0,0
"20220212BLABOU",2022-02-12,"England Championship","Blackpool","Bournemouth",1,2,"A",15,13,7,7,14,11,6,7,2,1,0,0,0,0,0,3,28,14,25,13,3,0
"20220212HULFUL",2022-02-12,"England Championship","Hull","Fulham",0,1,"A",8,11,2,4,14,15,1,4,2,1,0,0,0,0,0,1,19,6,29,5,3,0
"20220212MIDDER",2022-02-12,"England Championship","Middlesbrough","Derby",4,1,"H",14,6,9,1,13,12,6,7,3,2,0,0,0,0,0,5,20,10,25,13,5,0
"20220212MILCAR",2022-02-12,"England Championship","Millwall","Cardiff",2,1,"H",12,17,3,5,14,10,6,5,1,0,0,0,0,0,0,3,29,8,24,11,1,0
"20220212NOTSTO",2022-02-12,"England Championship","Nott'm Forest","Stoke",2,2,"D",11,19,6,7,15,14,5,5,3,3,1,0,0,0,0,4,30,13,29,10,6,1
"20220212PETPRE",2022-02-12,"England Championship","Peterboro","Preston",0,1,"A",16,7,6,2,10,15,3,5,0,2,0,0,0,0,0,1,23,8,25,8,2,0
"20220212REACOV",2022-02-12,"England Championship","Reading","Coventry",2,3,"A",12,13,4,4,9,9,4,5,1,5,1,0,0,0,0,5,25,8,18,9,6,1
"20220213SWABRI",2022-02-13,"England Championship","Swansea","Bristol City",3,1,"H",16,10,6,3,5,17,6,5,2,5,0,0,0,0,0,4,26,9,22,11,7,0
"20220214WESBLA",2022-02-14,"England Championship","West Brom","Blackburn",0,0,"D",13,10,3,3,8,10,3,7,0,1,0,0,0,0,0,0,23,6,18,10,1,0
"20220215CARCOV",2022-02-15,"England Championship","Cardiff","Coventry",2,0,"H",8,11,6,3,10,6,4,2,2,1,0,0,0,0,0,2,19,9,16,6,3,0
"20220215MILQPR",2022-02-15,"England Championship","Millwall","QPR",2,0,"H",13,10,8,2,7,10,2,5,2,1,0,0,0,0,0,2,23,10,17,7,3,0
"20220215SHEHUL",2022-02-15,"England Championship","Sheffield United","Hull",0,0,"D",21,8,3,1,11,13,12,3,2,2,0,0,0,0,0,0,29,4,24,15,4,0
"20220216PETREA",2022-02-16,"England Championship","Peterboro","Reading",0,0,"D",16,8,9,4,17,16,8,3,3,2,0,0,0,0,0,0,24,13,33,11,5,0
"20220219FULHUD",2022-02-19,"England Championship","Fulham","Huddersfield",1,2,"A",20,6,6,4,5,9,12,2,2,1,0,0,0,0,0,3,26,10,14,14,3,0
"20220219BRIMID",2022-02-19,"England Championship","Bristol City","Middlesbrough",2,1,"H",5,21,4,10,19,6,0,13,2,1,0,0,0,0,0,3,26,14,25,13,3,0
"20220219CARBLA",2022-02-19,"England Championship","Cardiff","Blackpool",1,1,"D",11,6,2,2,15,11,3,2,3,1,0,0,0,0,0,2,17,4,26,5,4,0
"20220219COVBAR",2022-02-19,"England Championship","Coventry","Barnsley",1,0,"H",19,6,7,0,11,14,3,3,0,2,0,0,0,0,0,1,25,7,25,6,2,0
"20220219DERPET",2022-02-19,"England Championship","Derby","Peterboro",1,0,"H",25,5,5,0,10,13,8,1,5,4,1,1,0,0,0,1,30,5,23,9,9,2
"20220219LUTWES",2022-02-19,"England Championship","Luton","West Brom",2,0,"H",6,16,3,6,13,5,4,4,2,3,0,0,0,0,0,2,22,9,18,8,5,0
"20220219PREREA",2022-02-19,"England Championship","Preston","Reading",2,3,"A",18,13,2,9,11,5,5,6,1,0,0,0,0,0,0,5,31,11,16,11,1,0
"20220219QPRHUL",2022-02-19,"England Championship","QPR","Hull",1,1,"D",13,6,4,2,8,4,5,2,2,1,0,0,0,0,0,2,19,6,12,7,3,0
"20220219SHESWA",2022-02-19,"England Championship","Sheffield United","Swansea",4,0,"H",12,6,6,2,18,7,5,2,2,0,0,0,0,0,0,4,18,8,25,7,2,0
"20220219STOBIR",2022-02-19,"England Championship","Stoke","Birmingham",2,2,"D",10,8,3,3,8,10,5,2,0,0,0,0,0,0,0,4,18,6,18,7,0,0
"20220222BRICOV",2022-02-22,"England Championship","Bristol City","Coventry",1,2,"A",13,12,4,4,5,13,4,4,1,3,0,0,0,0,0,3,25,8,18,8,4,0
"20220222HULBAR",2022-02-22,"England Championship","Hull","Barnsley",0,2,"A",6,8,3,5,4,18,6,4,1,0,0,0,0,0,0,2,14,8,22,10,1,0
"20220222MIDWES",2022-02-22,"England Championship","Middlesbrough","West Brom",2,1,"H",8,8,3,2,16,8,2,3,2,3,0,0,0,0,0,3,16,5,24,5,5,0
"20220222PRENOT",2022-02-22,"England Championship","Preston","Nott'm Forest",0,0,"D",15,7,4,2,10,8,11,3,3,2,0,0,0,0,0,0,22,6,18,14,5,0
"20220222REABIR",2022-02-22,"England Championship","Reading","Birmingham",2,1,"H",9,16,3,7,7,14,0,6,0,3,0,0,0,0,0,3,25,10,21,6,3,0
"20220223DERMIL",2022-02-23,"England Championship","Derby","Millwall",1,2,"A",14,8,3,4,11,11,9,1,1,1,0,0,0,0,0,3,22,7,22,10,2,0
"20220223FULPET",2022-02-23,"England Championship","Fulham","Peterboro",2,1,"H",25,6,11,2,5,6,10,4,0,1,0,0,0,0,0,3,31,13,11,14,1,0
"20220223HUDCAR",2022-02-23,"England Championship","Huddersfield","Cardiff",2,1,"H",14,10,4,7,5,9,12,2,2,7,0,0,0,0,0,3,24,11,14,14,9,0
"20220223QPRBLA",2022-02-23,"England Championship","QPR","Blackpool",2,1,"H",8,7,5,2,7,11,3,1,3,2,1,0,0,0,0,3,15,7,18,4,5,1
"20220223SHEBLA",2022-02-23,"England Championship","Sheffield United","Blackburn",1,0,"H",13,11,6,4,15,9,7,5,3,2,1,0,0,0,0,1,24,10,24,12,5,1
"20220223STOLUT",2022-02-23,"England Championship","Stoke","Luton",1,2,"A",5,12,2,4,8,11,6,6,1,6,0,0,0,0,0,3,17,6,19,12,7,0
"20220226BLAQPR",2022-02-26,"England Championship","Blackburn","QPR",1,0,"H",11,7,7,2,15,12,9,1,3,2,0,0,0,0,0,1,18,9,27,10,5,0
"20220226BARMID",2022-02-26,"England Championship","Barnsley","Middlesbrough",3,2,"H",7,16,5,4,14,12,2,12,3,0,0,0,0,0,0,5,23,9,26,14,3,0
"20220226BIRHUD",2022-02-26,"England Championship","Birmingham","Huddersfield",0,2,"A",11,7,2,5,9,14,6,2,0,0,0,0,0,0,0,2,18,7,23,8,0,0
"20220226BLAREA",2022-02-26,"England Championship","Blackpool","Reading",4,1,"H",15,15,8,3,14,3,7,2,1,0,0,0,0,0,0,5,30,11,17,9,1,0
"20220226BOUSTO",2022-02-26,"England Championship","Bournemouth","Stoke",2,1,"H",16,8,5,3,16,11,6,3,4,3,0,1,0,0,0,3,24,8,27,9,7,1
"20220226CARFUL",2022-02-26,"England Championship","Cardiff","Fulham",0,1,"A",9,11,4,3,12,10,8,9,2,2,0,0,0,0,0,1,20,7,22,17,4,0
"20220226COVPRE",2022-02-26,"England Championship","Coventry","Preston",1,1,"D",10,14,3,6,10,20,4,8,2,3,1,1,0,0,0,2,24,9,30,12,5,2
"20220226LUTDER",2022-02-26,"England Championship","Luton","Derby",1,0,"H",8,6,5,1,13,16,7,4,2,2,0,0,0,0,0,1,14,6,29,11,4,0
"20220226MILSHE",2022-02-26,"England Championship","Millwall","Sheffield United",1,0,"H",6,8,2,3,7,13,4,2,0,4,0,0,0,0,0,1,14,5,20,6,4,0
"20220226NOTBRI",2022-02-26,"England Championship","Nott'm Forest","Bristol City",2,0,"H",16,5,6,1,9,14,11,5,1,4,0,0,0,0,0,2,21,7,23,16,5,0
"20220226PETHUL",2022-02-26,"England Championship","Peterboro","Hull",0,3,"A",5,11,1,6,8,4,5,1,3,0,0,0,0,0,0,3,16,7,12,6,3,0
"20220228WESSWA",2022-02-28,"England Championship","West Brom","Swansea",0,2,"A",12,15,1,4,7,8,4,7,0,2,0,0,0,0,0,2,27,5,15,11,2,0
"20220301CARDER",2022-03-01,"England Championship","Cardiff","Derby",1,0,"H",14,9,4,1,11,10,3,6,2,4,0,0,0,0,0,1,23,5,21,9,6,0
"20220304HUDPET",2022-03-04,"England Championship","Huddersfield","Peterboro",3,0,"H",16,10,7,1,9,7,4,4,0,1,0,0,0,0,0,3,26,8,16,8,1,0
"20220304SHENOT",2022-03-04,"England Championship","Sheffield United","Nott'm Forest",1,1,"D",8,13,6,4,17,12,6,12,4,1,0,0,0,0,0,2,21,10,29,18,5,0
"20220305FULBLA",2022-03-05,"England Championship","Fulham","Blackburn",2,0,"H",14,4,6,1,10,14,5,5,2,2,0,0,0,0,0,2,18,7,24,10,4,0
"20220305BRIBIR",2022-03-05,"England Championship","Bristol City","Birmingham",1,2,"A",11,13,4,6,6,8,4,5,2,1,0,0,0,0,0,3,24,10,14,9,3,0
"20220305DERBAR",2022-03-05,"England Championship","Derby","Barnsley",2,0,"H",9,9,2,3,8,9,4,4,0,2,0,0,0,0,0,2,18,5,17,8,2,0
"20220305HULWES",2022-03-05,"England Championship","Hull","West Brom",0,2,"A",13,7,2,5,9,10,5,3,2,2,0,0,0,0,0,2,20,7,19,8,4,0
"20220305MIDLUT",2022-03-05,"England Championship","Middlesbrough","Luton",2,1,"H",8,9,3,5,10,20,4,2,2,3,0,0,0,0,0,3,17,8,30,6,5,0
"20220305PREBOU",2022-03-05,"England Championship","Preston","Bournemouth",2,1,"H",13,8,5,3,11,10,2,4,4,1,0,1,0,0,0,3,21,8,21,6,5,1
"20220305QPRCAR",2022-03-05,"England Championship","QPR","Cardiff",1,2,"A",18,11,3,4,8,12,8,2,1,0,0,0,0,0,0,3,29,7,20,10,1,0
"20220305REAMIL",2022-03-05,"England Championship","Reading","Millwall",0,1,"A",11,7,3,2,11,13,6,2,2,2,0,0,1,1,0,1,18,5,24,8,4,0
"20220305STOBLA",2022-03-05,"England Championship","Stoke","Blackpool",0,1,"A",10,9,2,4,15,10,2,2,3,3,0,0,0,0,0,1,19,6,25,4,6,0
"20220305SWACOV",2022-03-05,"England Championship","Swansea","Coventry",3,1,"H",8,12,3,4,9,11,1,4,2,2,0,0,0,0,0,4,20,7,20,5,4,0
"20220308BARSTO",2022-03-08,"England Championship","Barnsley","Stoke",1,1,"D",7,12,2,2,15,11,2,8,2,0,0,0,0,0,0,2,19,4,26,10,2,0
"20220308BLAMIL",2022-03-08,"England Championship","Blackburn","Millwall",0,0,"D",12,0,3,0,3,13,10,2,1,2,0,0,0,0,0,0,12,3,16,12,3,0
"20220308BOUPET",2022-03-08,"England Championship","Bournemouth","Peterboro",1,1,"D",22,6,2,2,6,9,3,7,2,1,0,0,0,0,0,2,28,4,15,10,3,0
"20220308COVLUT",2022-03-08,"England Championship","Coventry","Luton",0,1,"A",12,6,3,3,7,16,2,2,3,5,0,0,0,0,0,1,18,6,23,4,8,0
"20220308SHEMID",2022-03-08,"England Championship","Sheffield United","Middlesbrough",4,1,"H",12,7,5,2,15,7,5,3,3,3,0,0,0,0,0,5,19,7,22,8,6,0
"20220308SWAFUL",2022-03-08,"England Championship","Swansea","Fulham",1,5,"A",5,12,3,7,6,10,2,5,0,0,1,0,0,0,0,6,17,10,16,7,0,1
"20220311WESHUD",2022-03-11,"England Championship","West Brom","Huddersfield",2,2,"D",13,15,4,9,12,6,6,7,3,2,0,0,0,0,0,4,28,13,18,13,5,0
"20220312BARFUL",2022-03-12,"England Championship","Barnsley","Fulham",1,1,"D",8,16,3,3,15,13,4,5,4,3,0,0,0,0,0,2,24,6,28,9,7,0
"20220312BIRHUL",2022-03-12,"England Championship","Birmingham","Hull",0,0,"D",13,8,2,2,10,15,5,6,0,1,0,0,0,0,0,0,21,4,25,11,1,0
"20220312BLABRI",2022-03-12,"England Championship","Blackburn","Bristol City",0,1,"A",14,8,7,3,11,12,7,3,1,3,0,0,0,0,0,1,22,10,23,10,4,0
"20220312BLASWA",2022-03-12,"England Championship","Blackpool","Swansea",1,0,"H",11,8,4,1,11,10,7,3,0,2,0,0,0,0,0,1,19,5,21,10,2,0
"20220312BOUDER",2022-03-12,"England Championship","Bournemouth","Derby",2,0,"H",14,8,7,3,11,6,7,4,3,2,0,0,0,0,0,2,22,10,17,11,5,0
"20220312CARPRE",2022-03-12,"England Championship","Cardiff","Preston",0,0,"D",9,9,3,3,7,5,5,2,2,2,0,0,0,0,0,0,18,6,12,7,4,0
"20220312COVSHE",2022-03-12,"England Championship","Coventry","Sheffield United",4,1,"H",27,12,14,4,13,4,5,7,0,0,0,0,0,0,0,5,39,18,17,12,0,0
"20220312MILMID",2022-03-12,"England Championship","Millwall","Middlesbrough",0,0,"D",10,7,2,4,12,7,8,6,4,1,0,0,0,0,0,0,17,6,19,14,5,0
"20220312NOTREA",2022-03-12,"England Championship","Nott'm Forest","Reading",4,0,"H",10,7,5,3,18,14,2,4,2,4,0,0,0,0,0,4,17,8,32,6,6,0
"20220312PETSTO",2022-03-12,"England Championship","Peterboro","Stoke",2,2,"D",6,14,3,2,18,10,3,3,1,2,0,0,0,0,0,4,20,5,28,6,3,0
"20220313LUTQPR",2022-03-13,"England Championship","Luton","QPR",1,2,"A",13,5,4,3,10,7,4,4,0,3,0,0,0,0,0,3,18,7,17,8,3,0
"20220315BARBRI",2022-03-15,"England Championship","Barnsley","Bristol City",2,0,"H",12,16,5,3,10,7,7,3,0,0,0,0,0,0,0,2,28,8,17,10,0,0
"20220315BIRMID",2022-03-15,"England Championship","Birmingham","Middlesbrough",0,2,"A",8,10,0,5,14,11,5,7,1,2,1,0,0,0,0,2,18,5,25,12,3,1
"20220315BLADER",2022-03-15,"England Championship","Blackburn","Derby",3,1,"H",12,11,5,2,6,6,9,1,1,1,0,0,1,0,1,4,23,7,12,10,2,0
"20220315BOUREA",2022-03-15,"England Championship","Bournemouth","Reading",1,1,"D",10,8,6,3,21,8,5,7,2,1,0,0,0,0,0,2,18,9,29,12,3,0
"20220315WESFUL",2022-03-15,"England Championship","West Brom","Fulham",1,0,"H",9,8,5,1,7,7,8,8,1,1,0,0,0,0,0,1,17,6,14,16,2,0
"20220316BLASHE",2022-03-16,"England Championship","Blackpool","Sheffield United",0,0,"D",10,8,1,2,6,12,2,5,1,2,0,0,0,0,0,0,18,3,18,7,3,0
"20220316CARSTO",2022-03-16,"England Championship","Cardiff","Stoke",2,1,"H",12,7,6,4,11,10,9,8,1,0,0,0,0,0,0,3,19,10,21,17,1,0
"20220316COVHUL",2022-03-16,"England Championship","Coventry","Hull",0,2,"A",17,12,5,6,9,6,12,5,2,0,0,0,0,0,0,2,29,11,15,17,2,0
"20220316LUTPRE",2022-03-16,"England Championship","Luton","Preston",4,0,"H",12,10,5,2,8,13,4,3,1,2,0,0,0,0,0,4,22,7,21,7,3,0
"20220316MILHUD",2022-03-16,"England Championship","Millwall","Huddersfield",2,0,"H",19,13,7,3,8,7,7,3,2,0,0,0,0,0,0,2,32,10,15,10,2,0
"20220316NOTQPR",2022-03-16,"England Championship","Nott'm Forest","QPR",3,1,"H",16,6,8,1,11,18,6,2,2,5,0,0,0,0,0,4,22,9,29,8,7,0
"20220316PETSWA",2022-03-16,"England Championship","Peterboro","Swansea",2,3,"A",5,16,2,9,10,11,3,4,1,5,0,0,0,0,0,5,21,11,21,7,6,0
"20220319DERCOV",2022-03-19,"England Championship","Derby","Coventry",1,1,"D",15,13,6,6,4,15,7,10,1,3,0,0,0,0,0,2,28,12,19,17,4,0
"20220319SHEBAR",2022-03-19,"England Championship","Sheffield United","Barnsley",2,0,"H",12,10,4,3,7,19,7,6,1,1,0,0,0,0,0,2,22,7,26,13,2,0
"20220319BRIWES",2022-03-19,"England Championship","Bristol City","West Brom",2,2,"D",8,7,3,2,17,18,3,5,1,1,0,0,0,0,0,4,15,5,35,8,2,0
"20220319HUDBOU",2022-03-19,"England Championship","Huddersfield","Bournemouth",0,3,"A",7,14,4,6,7,8,2,5,0,3,0,0,0,0,0,3,21,10,15,7,3,0
"20220319HULLUT",2022-03-19,"England Championship","Hull","Luton",1,3,"A",16,11,4,5,9,11,6,5,2,2,0,0,0,0,0,4,27,9,20,11,4,0
"20220319REABLA",2022-03-19,"England Championship","Reading","Blackburn",1,0,"H",8,16,6,5,9,10,3,4,1,2,0,0,0,0,0,1,24,11,19,7,3,0
"20220319STOMIL",2022-03-19,"England Championship","Stoke","Millwall",2,0,"H",15,7,2,2,10,12,4,4,3,1,0,0,0,0,0,2,22,4,22,8,4,0
"20220319SWABIR",2022-03-19,"England Championship","Swansea","Birmingham",0,0,"D",9,16,4,4,13,8,1,6,0,0,0,0,0,0,0,0,25,8,21,7,0,0
"20220320QPRPET",2022-03-20,"England Championship","QPR","Peterboro",1,3,"A",13,12,1,8,9,12,4,2,1,3,0,0,0,0,0,4,25,9,21,6,4,0
"20220401HULHUD",2022-04-01,"England Championship","Hull","Huddersfield",0,1,"A",6,23,1,8,12,9,4,9,2,1,1,0,0,0,0,1,29,9,21,13,3,1
"20220402BLANOT",2022-04-02,"England Championship","Blackpool","Nott'm Forest",1,4,"A",18,17,5,7,9,8,8,4,1,1,0,0,0,0,0,5,35,12,17,12,2,0
"20220402BARREA",2022-04-02,"England Championship","Barnsley","Reading",1,1,"D",8,13,2,4,19,12,1,8,2,3,0,0,0,0,0,2,21,6,31,9,5,0
"20220402BOUBRI",2022-04-02,"England Championship","Bournemouth","Bristol City",3,2,"H",25,6,9,3,8,7,12,3,0,1,0,0,0,0,0,5,31,12,15,15,1,0
"20220402CARSWA",2022-04-02,"England Championship","Cardiff","Swansea",0,4,"A",10,12,2,4,14,14,8,4,2,4,0,0,0,0,0,4,22,6,28,12,6,0
"20220402COVBLA",2022-04-02,"England Championship","Coventry","Blackburn",2,2,"D",11,11,4,4,13,16,2,4,2,5,0,0,0,0,0,4,22,8,29,6,7,0
"20220402DERPRE",2022-04-02,"England Championship","Derby","Preston",1,0,"H",22,12,13,1,10,10,9,5,2,2,1,1,0,0,0,1,34,14,20,14,4,2
"20220402LUTMIL",2022-04-02,"England Championship","Luton","Millwall",2,2,"D",9,10,2,4,6,10,5,4,0,0,0,0,0,0,0,4,19,6,16,9,0,0
"20220402PETMID",2022-04-02,"England Championship","Peterboro","Middlesbrough",0,4,"A",10,11,3,6,19,10,5,7,3,1,0,0,0,0,0,4,21,9,29,12,4,0
"20220402QPRFUL",2022-04-02,"England Championship","QPR","Fulham",0,2,"A",8,13,2,8,15,5,4,5,3,0,0,0,0,0,0,2,21,10,20,9,3,0
"20220402STOSHE",2022-04-02,"England Championship","Stoke","Sheffield United",1,0,"H",9,10,1,1,10,5,4,7,0,0,0,0,0,0,0,1,19,2,15,11,0,0
"20220403BIRWES",2022-04-03,"England Championship","Birmingham","West Brom",1,0,"H",3,8,2,0,11,11,3,6,2,1,0,0,0,0,0,1,11,2,22,9,3,0
"20220405MILSWA",2022-04-05,"England Championship","Millwall","Swansea",0,1,"A",13,14,2,5,9,5,10,5,1,2,0,0,0,0,0,1,27,7,14,15,3,0
"20220405PETLUT",2022-04-05,"England Championship","Peterboro","Luton",1,1,"D",18,9,6,3,19,12,4,6,4,2,0,0,0,0,0,2,27,9,31,10,6,0
"20220405PREBLA",2022-04-05,"England Championship","Preston","Blackpool",1,0,"H",12,8,2,0,17,9,3,3,4,0,0,0,0,0,0,1,20,2,26,6,4,0
"20220405SHEQPR",2022-04-05,"England Championship","Sheffield United","QPR",1,0,"H",9,7,3,1,14,9,5,5,2,3,0,0,0,0,0,1,16,4,23,10,5,0
"20220405REASTO",2022-04-05,"England Championship","Reading","Stoke",2,1,"H",9,12,3,3,6,13,5,3,1,3,0,0,0,0,0,3,21,6,19,8,4,0
"20220406MIDFUL",2022-04-06,"England Championship","Middlesbrough","Fulham",0,1,"A",15,6,2,2,13,13,8,4,3,2,0,0,0,0,0,1,21,4,26,12,5,0
"20220406NOTCOV",2022-04-06,"England Championship","Nott'm Forest","Coventry",2,0,"H",18,13,3,5,9,9,7,2,3,3,0,0,0,0,0,2,31,8,18,9,6,0
"20220406WESBOU",2022-04-06,"England Championship","West Brom","Bournemouth",2,0,"H",12,17,4,0,9,14,6,5,3,3,0,0,0,0,0,2,29,4,23,11,6,0
"20220409SHEBOU",2022-04-09,"England Championship","Sheffield United","Bournemouth",0,0,"D",10,6,2,2,18,14,7,4,3,2,0,0,1,1,0,0,16,4,32,11,5,0
"20220409BLABLA",2022-04-09,"England Championship","Blackburn","Blackpool",1,1,"D",10,18,2,3,15,10,7,6,2,3,0,0,0,0,0,2,28,5,25,13,5,0
"20220409BRIPET",2022-04-09,"England Championship","Bristol City","Peterboro",1,1,"D",19,16,2,5,12,13,11,4,0,1,0,1,0,0,0,2,35,7,25,15,1,1
"20220409MIDHUL",2022-04-09,"England Championship","Middlesbrough","Hull",0,1,"A",11,5,4,3,7,13,7,1,3,5,0,0,0,0,0,1,16,7,20,8,8,0
"20220409MILBAR",2022-04-09,"England Championship","Millwall","Barnsley",4,1,"H",15,13,10,4,7,12,7,7,1,1,0,0,0,0,0,5,28,14,19,14,2,0
"20220409NOTBIR",2022-04-09,"England Championship","Nott'm Forest","Birmingham",2,0,"H",13,7,5,2,11,13,9,4,1,3,0,0,0,0,0,2,20,7,24,13,4,0
"20220409PREQPR",2022-04-09,"England Championship","Preston","QPR",2,1,"H",20,15,7,7,11,9,7,5,0,1,0,0,0,0,0,3,35,14,20,12,1,0
"20220409REACAR",2022-04-09,"England Championship","Reading","Cardiff",1,2,"A",10,7,2,3,8,10,5,5,0,1,0,0,0,0,0,3,17,5,18,10,1,0
"20220409SWADER",2022-04-09,"England Championship","Swansea","Derby",2,1,"H",10,8,3,3,11,9,3,4,2,1,0,0,0,0,0,3,18,6,20,7,3,0
"20220409WESSTO",2022-04-09,"England Championship","West Brom","Stoke",1,3,"A",15,13,3,4,7,6,6,4,0,0,0,0,0,0,0,4,28,7,13,10,0,0
"20220410FULCOV",2022-04-10,"England Championship","Fulham","Coventry",1,3,"A",28,18,7,5,10,12,6,10,1,4,0,0,0,0,0,4,46,12,22,16,5,0
"20220411HUDLUT",2022-04-11,"England Championship","Huddersfield","Luton",2,0,"H",11,7,4,1,7,14,6,3,3,2,0,0,0,0,0,2,18,5,21,9,5,0
"20220415LUTNOT",2022-04-15,"England Championship","Luton","Nott'm Forest",1,0,"H",8,11,4,3,17,15,6,1,6,4,1,0,0,0,0,1,19,7,32,7,10,1
"20220415BIRCOV",2022-04-15,"England Championship","Birmingham","Coventry",2,4,"A",12,13,2,7,6,5,8,7,4,0,0,0,0,0,0,6,25,9,11,15,4,0
"20220415BOUMID",2022-04-15,"England Championship","Bournemouth","Middlesbrough",0,0,"D",8,5,2,1,8,10,3,4,1,2,0,0,0,0,0,0,13,3,18,7,3,0
"20220415HULCAR",2022-04-15,"England Championship","Hull","Cardiff",2,1,"H",8,11,3,4,4,13,4,4,0,3,0,0,0,0,0,3,19,7,17,8,3,0
"20220415PETBLA",2022-04-15,"England Championship","Peterboro","Blackburn",2,1,"H",15,13,10,2,8,13,7,6,1,1,0,1,0,0,0,3,28,12,21,13,2,1
"20220415PREMIL",2022-04-15,"England Championship","Preston","Millwall",1,1,"D",17,14,5,7,10,7,10,6,0,1,0,0,0,0,0,2,31,12,17,16,1,0
"20220415SHEREA",2022-04-15,"England Championship","Sheffield United","Reading",1,2,"A",13,8,2,3,15,11,6,2,4,4,0,0,0,0,0,3,21,5,26,8,8,0
"20220415STOBRI",2022-04-15,"England Championship","Stoke","Bristol City",0,1,"A",12,6,3,4,16,13,6,0,2,4,0,0,0,0,0,1,18,7,29,6,6,0
"20220415SWABAR",2022-04-15,"England Championship","Swansea","Barnsley",1,1,"D",17,19,7,4,13,11,6,8,1,3,0,0,0,0,0,2,36,11,24,14,4,0
"20220415WESBLA",2022-04-15,"England Championship","West Brom","Blackpool",2,1,"H",17,11,5,4,8,9,7,3,0,1,0,0,0,0,0,3,28,9,17,10,1,0
"20220415HUDQPR",2022-04-15,"England Championship","Huddersfield","QPR",2,2,"D",6,11,2,3,13,9,7,4,3,2,0,0,0,0,0,4,17,5,22,11,5,0
"20220415DERFUL",2022-04-15,"England Championship","Derby","Fulham",2,1,"H",6,21,4,8,8,11,3,8,4,1,0,0,0,0,0,3,27,12,19,11,5,0
"20220418MIDHUD",2022-04-18,"England Championship","Middlesbrough","Huddersfield",0,2,"A",13,10,2,7,11,15,11,4,3,3,0,0,0,0,0,2,23,9,26,15,6,0
"20220418BARPET",2022-04-18,"England Championship","Barnsley","Peterboro",0,2,"A",19,10,11,4,15,13,9,3,1,2,0,0,0,0,0,2,29,15,28,12,3,0
"20220418BLASTO",2022-04-18,"England Championship","Blackburn","Stoke",0,1,"A",13,7,4,2,13,12,1,3,2,2,0,0,0,0,0,1,20,6,25,4,4,0
"20220418BLABIR",2022-04-18,"England Championship","Blackpool","Birmingham",6,1,"H",16,11,9,6,7,13,9,7,0,1,0,0,0,0,0,7,27,15,20,16,1,0
"20220418CARLUT",2022-04-18,"England Championship","Cardiff","Luton",0,1,"A",13,10,3,3,12,6,9,4,1,1,0,0,0,0,0,1,23,6,18,13,2,0
"20220418COVBOU",2022-04-18,"England Championship","Coventry","Bournemouth",0,3,"A",11,5,4,3,15,6,10,3,0,0,0,0,0,0,0,3,16,7,21,13,0,0
"20220418MILHUL",2022-04-18,"England Championship","Millwall","Hull",2,1,"H",17,9,8,4,9,12,5,7,2,0,0,0,0,0,0,3,26,12,21,12,2,0
"20220418QPRDER",2022-04-18,"England Championship","QPR","Derby",1,0,"H",14,13,6,2,13,8,6,5,2,0,0,1,0,0,0,1,27,8,21,11,2,1
"20220418REASWA",2022-04-18,"England Championship","Reading","Swansea",4,4,"D",9,11,6,5,12,12,5,3,2,4,0,0,0,0,0,8,20,11,24,8,6,0
"20220418BRISHE",2022-04-18,"England Championship","Bristol City","Sheffield United",1,1,"D",7,16,3,5,11,14,2,7,2,4,0,0,0,0,0,2,23,8,25,9,6,0
"20220418NOTWES",2022-04-18,"England Championship","Nott'm Forest","West Brom",4,0,"H",17,1,6,0,10,6,8,0,2,2,0,1,0,0,0,4,18,6,16,8,4,1
"20220419FULPRE",2022-04-19,"England Championship","Fulham","Preston",3,0,"H",14,8,6,1,13,14,6,5,1,1,0,0,0,0,0,3,22,7,27,11,2,0
"20220422HUDBAR",2022-04-22,"England Championship","Huddersfield","Barnsley",2,1,"H",10,11,5,3,7,17,2,7,0,3,0,0,0,0,0,3,21,8,24,9,3,0
"20220423LUTBLA",2022-04-23,"England Championship","Luton","Blackpool",1,1,"D",10,14,5,2,17,14,0,3,0,4,0,0,0,0,0,2,24,7,31,3,4,0
"20220423BIRMIL",2022-04-23,"England Championship","Birmingham","Millwall",2,2,"D",15,13,3,8,16,15,4,6,4,3,0,0,0,0,0,4,28,11,31,10,7,0
"20220423BOUFUL",2022-04-23,"England Championship","Bournemouth","Fulham",1,1,"D",9,6,2,2,15,26,4,3,3,7,0,0,0,0,0,2,15,4,41,7,10,0
"20220423DERBRI",2022-04-23,"England Championship","Derby","Bristol City",1,3,"A",11,18,2,7,10,13,2,5,1,3,0,0,0,0,0,4,29,9,23,7,4,0
"20220423HULREA",2022-04-23,"England Championship","Hull","Reading",3,0,"H",9,13,3,4,10,12,5,5,2,1,0,0,0,0,0,3,22,7,22,10,3,0
"20220423PETNOT",2022-04-23,"England Championship","Peterboro","Nott'm Forest",0,1,"A",12,12,5,4,14,17,6,5,3,3,0,0,0,0,0,1,24,9,31,11,6,0
"20220423SHECAR",2022-04-23,"England Championship","Sheffield United","Cardiff",1,0,"H",7,5,4,1,10,10,5,4,1,3,0,0,0,0,0,1,12,5,20,9,4,0
"20220423STOQPR",2022-04-23,"England Championship","Stoke","QPR",1,0,"H",15,10,6,0,13,7,9,7,0,1,0,0,0,0,0,1,25,6,20,16,1,0
"20220423SWAMID",2022-04-23,"England Championship","Swansea","Middlesbrough",1,1,"D",19,13,4,4,12,12,8,2,2,1,0,0,0,0,0,2,32,8,24,10,3,0
"20220423WESCOV",2022-04-23,"England Championship","West Brom","Coventry",0,0,"D",12,10,2,3,10,9,7,3,1,1,0,0,0,0,0,0,22,5,19,10,2,0
"20220425PREBLA",2022-04-25,"England Championship","Preston","Blackburn",1,4,"A",11,12,3,6,16,9,4,6,2,3,0,0,0,0,0,5,23,9,25,10,5,0
"20220426BARBLA",2022-04-26,"England Championship","Barnsley","Blackpool",0,2,"A",6,11,2,4,13,10,6,4,1,1,0,0,0,0,0,2,17,6,23,10,2,0
"20220426FULNOT",2022-04-26,"England Championship","Fulham","Nott'm Forest",0,1,"A",20,9,5,6,6,15,8,5,2,1,0,0,0,0,0,1,29,11,21,13,3,0
"20220426SWABOU",2022-04-26,"England Championship","Swansea","Bournemouth",3,3,"D",5,24,3,11,10,13,4,7,2,6,0,0,0,0,0,6,29,14,23,11,8,0
"20220427MIDCAR",2022-04-27,"England Championship","Middlesbrough","Cardiff",2,0,"H",14,8,4,4,6,16,9,4,2,4,0,0,2,1,1,2,22,8,22,13,6,0
"20220429QPRSHE",2022-04-29,"England Championship","QPR","Sheffield United",1,3,"A",8,27,2,8,6,6,1,15,2,2,0,0,0,0,0,4,35,10,12,16,4,0
"20220430BARPRE",2022-04-30,"England Championship","Barnsley","Preston",1,3,"A",15,18,5,7,11,5,3,10,0,0,0,0,0,0,0,4,33,12,16,13,0,0
"20220430BLABOU",2022-04-30,"England Championship","Blackburn","Bournemouth",0,3,"A",9,13,2,6,10,10,6,2,4,2,0,0,0,0,0,3,22,8,20,8,6,0
"20220430BLADER",2022-04-30,"England Championship","Blackpool","Derby",0,2,"A",17,9,3,4,5,11,5,1,1,2,0,0,0,0,0,2,26,7,16,6,3,0
"20220430BRIHUL",2022-04-30,"England Championship","Bristol City","Hull",5,0,"H",12,12,8,5,12,8,1,4,1,2,0,0,0,0,0,5,24,13,20,5,3,0
"20220430CARBIR",2022-04-30,"England Championship","Cardiff","Birmingham",1,1,"D",12,13,5,4,7,8,7,2,4,2,0,0,0,0,0,2,25,9,15,9,6,0
"20220430COVHUD",2022-04-30,"England Championship","Coventry","Huddersfield",1,2,"A",22,7,9,4,8,5,10,3,1,0,0,0,0,0,0,3,29,13,13,13,1,0
"20220430MIDSTO",2022-04-30,"England Championship","Middlesbrough","Stoke",3,1,"H",9,10,2,3,4,7,7,1,0,0,0,0,0,0,0,4,19,5,11,8,0,0
"20220430MILPET",2022-04-30,"England Championship","Millwall","Peterboro",3,0,"H",18,14,4,2,9,9,8,12,0,0,0,0,0,0,0,3,32,6,18,20,0,0
"20220430NOTSWA",2022-04-30,"England Championship","Nott'm Forest","Swansea",5,1,"H",27,12,17,3,11,9,12,4,0,2,0,0,0,0,0,6,39,20,20,16,2,0
"20220430REAWES",2022-04-30,"England Championship","Reading","West Brom",0,1,"A",9,14,0,4,8,10,6,5,1,3,0,0,0,0,0,1,23,4,18,11,4,0
"20220502FULLUT",2022-05-02,"England Championship","Fulham","Luton",7,0,"H",19,5,12,2,6,14,5,3,2,6,0,0,0,0,0,7,24,14,20,8,8,0
"20220503BOUNOT",2022-05-03,"England Championship","Bournemouth","Nott'm Forest",1,0,"H",11,7,3,2,7,14,4,3,2,2,0,0,0,0,0,1,18,5,21,7,4,0
"20220507BIRBLA",2022-05-07,"England Championship","Birmingham","Blackburn",1,2,"A",14,14,5,7,7,11,8,1,0,1,0,0,0,0,0,3,28,12,18,9,1,0
"20220507BOUMIL",2022-05-07,"England Championship","Bournemouth","Millwall",1,0,"H",20,8,3,3,8,7,6,5,0,2,0,0,0,0,0,1,28,6,15,11,2,0
"20220507DERCAR",2022-05-07,"England Championship","Derby","Cardiff",0,1,"A",17,3,4,1,9,8,7,1,1,2,0,0,0,0,0,1,20,5,17,8,3,0
"20220507HUDBRI",2022-05-07,"England Championship","Huddersfield","Bristol City",2,0,"H",13,11,5,3,5,4,7,2,2,1,0,0,0,0,0,2,24,8,9,9,3,0
"20220507HULNOT",2022-05-07,"England Championship","Hull","Nott'm Forest",1,1,"D",7,14,3,4,14,9,6,4,0,2,0,0,0,0,0,2,21,7,23,10,2,0
"20220507LUTREA",2022-05-07,"England Championship","Luton","Reading",1,0,"H",16,8,4,2,11,10,1,4,0,1,0,0,0,0,0,1,24,6,21,5,1,0
"20220507PETBLA",2022-05-07,"England Championship","Peterboro","Blackpool",5,0,"H",17,10,10,3,14,5,4,4,1,0,0,0,0,0,0,5,27,13,19,8,1,0
"20220507PREMID",2022-05-07,"England Championship","Preston","Middlesbrough",4,1,"H",15,12,10,4,14,13,7,0,3,5,0,1,0,0,0,5,27,14,27,7,8,1
"20220507SHEFUL",2022-05-07,"England Championship","Sheffield United","Fulham",4,0,"H",10,14,5,4,17,12,2,7,2,1,0,0,0,0,0,4,24,9,29,9,3,0
"20220507STOCOV",2022-05-07,"England Championship","Stoke","Coventry",1,1,"D",9,18,2,5,9,11,4,7,0,1,0,0,1,1,0,2,27,7,20,11,1,0
"20220507SWAQPR",2022-05-07,"England Championship","Swansea","QPR",0,1,"A",11,7,6,3,9,11,0,5,0,0,0,0,0,0,0,1,18,9,20,5,0,0
"20220507WESBAR",2022-05-07,"England Championship","West Brom","Barnsley",4,0,"H",17,3,7,2,5,9,6,1,0,1,0,0,0,0,0,4,20,9,14,7,1,0
"20220729HUDBUR",2022-07-29,"England Championship","Huddersfield","Burnley",0,1,"A",2,16,0,7,13,10,1,5,1,2,0,0,0,0,0,1,18,7,23,6,3,0
"20220730BLAQPR",2022-07-30,"England Championship","Blackburn","QPR",1,0,"H",9,4,4,0,15,9,6,0,1,1,0,0,0,0,0,1,13,4,24,6,2,0
"20220730BLAREA",2022-07-30,"England Championship","Blackpool","Reading",1,0,"H",10,12,5,3,12,7,3,10,1,0,0,0,0,0,0,1,22,8,19,13,1,0
"20220730CARNOR",2022-07-30,"England Championship","Cardiff","Norwich",1,0,"H",3,7,2,1,16,9,1,7,4,0,1,1,0,0,0,1,10,3,25,8,4,2
"20220730HULBRI",2022-07-30,"England Championship","Hull","Bristol City",2,1,"H",14,10,4,4,11,5,6,3,0,0,0,0,0,0,0,3,24,8,16,9,0,0
"20220730LUTBIR",2022-07-30,"England Championship","Luton","Birmingham",0,0,"D",14,12,4,3,7,15,10,6,0,3,0,0,0,0,0,0,26,7,22,16,3,0
"20220730MILSTO",2022-07-30,"England Championship","Millwall","Stoke",2,0,"H",13,4,5,2,14,8,8,2,1,2,0,0,0,0,0,2,17,7,22,10,3,0
"20220730ROTSWA",2022-07-30,"England Championship","Rotherham","Swansea",1,1,"D",9,14,8,5,12,6,5,6,1,2,0,0,0,0,0,2,23,13,18,11,3,0
"20220730WIGPRE",2022-07-30,"England Championship","Wigan","Preston",0,0,"D",20,11,5,2,9,17,7,4,2,3,0,1,0,0,0,0,31,7,26,11,5,1
"20220730MIDWES",2022-07-30,"England Championship","Middlesbrough","West Brom",1,1,"D",16,12,2,5,7,9,4,3,2,1,0,0,0,0,0,2,28,7,16,7,3,0
"20220731SUNCOV",2022-07-31,"England Championship","Sunderland","Coventry",1,1,"D",10,9,5,2,16,6,4,3,4,1,0,0,0,0,0,2,19,7,22,7,5,0
"20220801WATSHE",2022-08-01,"England Championship","Watford","Sheffield United",1,0,"H",10,6,4,3,13,8,5,4,4,3,0,0,0,0,0,1,16,7,21,9,7,0
"20220805BIRHUD",2022-08-05,"England Championship","Birmingham","Huddersfield",2,1,"H",18,9,6,2,10,10,6,7,1,2,0,0,0,0,0,3,27,8,20,13,3,0
"20220806NORWIG",2022-08-06,"England Championship","Norwich","Wigan",1,1,"D",22,6,4,3,6,13,9,0,0,4,0,0,0,0,0,2,28,7,19,9,4,0
"20220806BRISUN",2022-08-06,"England Championship","Bristol City","Sunderland",2,3,"A",13,16,5,6,10,9,8,9,2,2,0,0,0,0,0,5,29,11,19,17,4,0
"20220806BURLUT",2022-08-06,"England Championship","Burnley","Luton",1,1,"D",13,13,1,2,10,11,11,2,2,1,0,0,0,0,0,2,26,3,21,13,3,0
"20220806PREHUL",2022-08-06,"England Championship","Preston","Hull",0,0,"D",20,6,6,1,13,10,4,1,1,4,0,0,0,0,0,0,26,7,23,5,5,0
"20220806QPRMID",2022-08-06,"England Championship","QPR","Middlesbrough",3,2,"H",10,12,5,3,12,12,5,5,2,2,0,1,0,0,0,5,22,8,24,10,4,1
"20220806REACAR",2022-08-06,"England Championship","Reading","Cardiff",2,1,"H",8,6,2,2,17,16,1,2,3,3,0,0,0,0,0,3,14,4,33,3,6,0
"20220806SHEMIL",2022-08-06,"England Championship","Sheffield United","Millwall",2,0,"H",19,11,6,1,12,10,3,5,3,2,0,0,0,0,0,2,30,7,22,8,5,0
"20220806STOBLA",2022-08-06,"England Championship","Stoke","Blackpool",2,0,"H",20,10,7,0,10,8,5,6,2,2,0,0,0,0,0,2,30,7,18,11,4,0
"20220806SWABLA",2022-08-06,"England Championship","Swansea","Blackburn",0,3,"A",8,5,5,4,8,9,5,4,3,1,0,0,0,0,0,3,13,9,17,9,4,0
"20220808WESWAT",2022-08-08,"England Championship","West Brom","Watford",1,1,"D",19,5,7,3,7,13,12,0,2,1,0,0,0,0,0,2,24,10,20,12,3,0
"20220812WATBUR",2022-08-12,"England Championship","Watford","Burnley",1,0,"H",5,11,1,4,13,12,3,6,1,1,1,0,0,0,0,1,16,5,25,9,2,1
"20220813CARBIR",2022-08-13,"England Championship","Cardiff","Birmingham",1,0,"H",16,4,7,0,9,12,2,2,1,4,0,0,0,0,0,1,20,7,21,4,5,0
"20220813BLASWA",2022-08-13,"England Championship","Blackpool","Swansea",0,1,"A",10,15,4,5,6,13,3,6,1,3,0,0,0,0,0,1,25,9,19,9,4,0
"20220813HUDSTO",2022-08-13,"England Championship","Huddersfield","Stoke",3,1,"H",10,18,5,5,9,9,3,3,1,3,0,0,0,0,0,4,28,10,18,6,4,0
"20220813HULNOR",2022-08-13,"England Championship","Hull","Norwich",2,1,"H",13,18,4,12,15,6,2,11,1,1,0,0,0,0,0,3,31,16,21,13,2,0
"20220813LUTPRE",2022-08-13,"England Championship","Luton","Preston",0,1,"A",18,7,2,5,11,12,8,3,0,6,0,0,0,0,0,1,25,7,23,11,6,0
"20220813MILCOV",2022-08-13,"England Championship","Millwall","Coventry",3,2,"H",13,17,6,7,8,13,3,6,4,2,0,1,0,0,0,5,30,13,21,9,6,1
"20220813ROTREA",2022-08-13,"England Championship","Rotherham","Reading",4,0,"H",11,12,4,6,5,8,5,7,0,2,0,0,0,0,0,4,23,10,13,12,2,0
"20220813SUNQPR",2022-08-13,"England Championship","Sunderland","QPR",2,2,"D",16,20,8,4,12,9,4,3,3,2,0,0,0,0,0,4,36,12,21,7,5,0
"20220813WIGBRI",2022-08-13,"England Championship","Wigan","Bristol City",1,1,"D",13,5,3,1,10,13,5,1,1,2,0,0,0,0,0,2,18,4,23,6,3,0
"20220814MIDSHE",2022-08-14,"England Championship","Middlesbrough","Sheffield United",2,2,"D",7,4,4,4,6,13,5,4,2,3,0,0,0,0,0,4,11,8,19,9,5,0
"20220814BLAWES",2022-08-14,"England Championship","Blackburn","West Brom",2,1,"H",7,13,2,4,14,16,1,5,4,1,0,0,0,0,0,3,20,6,30,6,5,0
"20220816BIRWAT",2022-08-16,"England Championship","Birmingham","Watford",1,1,"D",7,14,4,2,12,5,3,5,1,1,0,0,0,0,0,2,21,6,17,8,2,0
"20220816BRILUT",2022-08-16,"England Championship","Bristol City","Luton",2,0,"H",10,11,3,2,9,14,5,7,2,2,1,0,0,0,0,2,21,5,23,12,4,1
"20220816BURHUL",2022-08-16,"England Championship","Burnley","Hull",1,1,"D",15,4,5,3,7,13,6,2,1,3,0,0,0,0,0,2,19,8,20,8,4,0
"20220816NORHUD",2022-08-16,"England Championship","Norwich","Huddersfield",2,1,"H",22,11,9,5,13,5,8,1,1,0,0,1,0,0,0,3,33,14,18,9,1,1
"20220816PREROT",2022-08-16,"England Championship","Preston","Rotherham",0,0,"D",21,5,6,1,5,11,10,3,1,3,0,0,0,0,0,0,26,7,16,13,4,0
"20220816SWAMIL",2022-08-16,"England Championship","Swansea","Millwall",2,2,"D",17,15,9,1,8,8,6,7,2,3,0,0,0,0,0,4,32,10,16,13,5,0
"20220816QPRBLA",2022-08-16,"England Championship","QPR","Blackpool",0,1,"A",12,14,6,4,10,13,2,2,1,2,0,0,0,0,0,1,26,10,23,4,3,0
"20220817STOMID",2022-08-17,"England Championship","Stoke","Middlesbrough",2,2,"D",9,15,4,4,12,10,4,8,2,1,0,0,0,0,0,4,24,8,22,12,3,0
"20220817REABLA",2022-08-17,"England Championship","Reading","Blackburn",3,0,"H",12,8,7,1,8,7,7,3,5,2,0,0,0,0,0,3,20,8,15,10,7,0
"20220817SHESUN",2022-08-17,"England Championship","Sheffield United","Sunderland",2,1,"H",22,4,7,2,7,13,13,3,1,4,0,1,0,0,0,3,26,9,20,16,5,1
"20220817WESCAR",2022-08-17,"England Championship","West Brom","Cardiff",0,0,"D",13,7,5,0,12,10,9,2,3,3,0,0,0,0,0,0,20,5,22,11,6,0
"20220819NORMIL",2022-08-19,"England Championship","Norwich","Millwall",2,0,"H",18,10,3,2,4,16,5,4,2,2,0,0,0,0,0,2,28,5,20,9,4,0
"20220820BIRWIG",2022-08-20,"England Championship","Birmingham","Wigan",0,1,"A",14,5,4,2,11,8,7,3,0,2,0,1,0,0,0,1,19,6,19,10,2,1
"20220820BURBLA",2022-08-20,"England Championship","Burnley","Blackpool",3,3,"D",13,12,4,8,10,13,4,6,1,3,1,1,0,0,0,6,25,12,23,10,4,2
"20220820PREWAT",2022-08-20,"England Championship","Preston","Watford",0,0,"D",10,12,4,2,14,9,7,5,2,2,0,0,0,0,0,0,22,6,23,12,4,0
"20220820QPRROT",2022-08-20,"England Championship","QPR","Rotherham",1,1,"D",17,6,5,2,11,11,9,3,3,2,0,0,0,0,0,2,23,7,22,12,5,0
"20220820REAMID",2022-08-20,"England Championship","Reading","Middlesbrough",1,0,"H",8,16,3,3,8,15,5,7,4,1,0,0,0,0,0,1,24,6,23,12,5,0
"20220820SHEBLA",2022-08-20,"England Championship","Sheffield United","Blackburn",3,0,"H",22,3,11,0,8,8,11,4,3,2,0,0,0,0,0,3,25,11,16,15,5,0
"20220820STOSUN",2022-08-20,"England Championship","Stoke","Sunderland",0,1,"A",15,12,3,2,14,14,7,3,3,6,0,0,0,0,0,1,27,5,28,10,9,0
"20220820SWALUT",2022-08-20,"England Championship","Swansea","Luton",0,2,"A",14,7,2,5,7,12,7,5,1,0,0,0,0,0,0,2,21,7,19,12,1,0
"20220820WESHUL",2022-08-20,"England Championship","West Brom","Hull",5,2,"H",16,7,7,5,2,12,12,2,0,3,0,0,0,0,0,7,23,12,14,14,3,0
"20220821BRICAR",2022-08-21,"England Championship","Bristol City","Cardiff",2,0,"H",15,10,3,3,12,12,7,8,4,3,0,0,0,0,0,2,25,6,24,15,7,0
"20220826LUTSHE",2022-08-26,"England Championship","Luton","Sheffield United",1,1,"D",12,12,4,3,11,8,4,9,0,4,0,0,0,0,0,2,24,7,19,13,4,0
"20220827SUNNOR",2022-08-27,"England Championship","Sunderland","Norwich",0,1,"A",20,12,6,3,11,9,8,7,2,2,0,0,0,0,0,1,32,9,20,15,4,0
"20220827BLASTO",2022-08-27,"England Championship","Blackburn","Stoke",0,1,"A",18,8,2,3,8,14,12,3,3,3,0,0,0,0,0,1,26,5,22,15,6,0
"20220827BLABRI",2022-08-27,"England Championship","Blackpool","Bristol City",3,3,"D",19,13,4,4,15,17,5,3,1,5,0,0,0,0,0,6,32,8,32,8,6,0
"20220827CARPRE",2022-08-27,"England Championship","Cardiff","Preston",0,0,"D",22,5,2,0,5,8,8,2,0,2,0,0,0,0,0,0,27,2,13,10,2,0
"20220827HUDWES",2022-08-27,"England Championship","Huddersfield","West Brom",2,2,"D",11,16,3,6,2,6,6,4,1,2,0,0,0,0,0,4,27,9,8,10,3,0
"20220827HULCOV",2022-08-27,"England Championship","Hull","Coventry",3,2,"H",9,15,4,6,9,6,3,4,3,2,0,0,0,0,0,5,24,10,15,7,5,0
"20220827MIDSWA",2022-08-27,"England Championship","Middlesbrough","Swansea",2,1,"H",7,9,3,4,13,14,8,4,5,2,0,1,1,0,1,3,16,7,27,12,7,1
"20220827MILREA",2022-08-27,"England Championship","Millwall","Reading",0,1,"A",13,5,1,2,11,13,3,1,0,1,0,0,0,0,0,1,18,3,24,4,1,0
"20220827ROTBIR",2022-08-27,"England Championship","Rotherham","Birmingham",2,0,"H",20,10,6,3,7,13,7,2,1,2,0,0,0,0,0,2,30,9,20,9,3,0
"20220827WATQPR",2022-08-27,"England Championship","Watford","QPR",2,3,"A",12,9,5,5,9,9,1,4,4,2,0,0,0,0,0,5,21,10,18,5,6,0
"20220827WIGBUR",2022-08-27,"England Championship","Wigan","Burnley",1,5,"A",18,8,4,6,8,8,6,1,1,1,0,0,0,0,0,6,26,10,16,7,2,0
"20220830BIRNOR",2022-08-30,"England Championship","Birmingham","Norwich",1,2,"A",9,14,2,5,15,5,6,8,4,4,0,0,0,0,0,3,23,7,20,14,8,0
"20220830BURMIL",2022-08-30,"England Championship","Burnley","Millwall",2,0,"H",22,12,10,5,7,15,5,3,0,3,0,0,0,0,0,2,34,15,22,8,3,0
"20220830CARLUT",2022-08-30,"England Championship","Cardiff","Luton",1,2,"A",17,14,2,4,9,15,5,2,0,3,0,0,0,0,0,3,31,6,24,7,3,0
"20220830QPRHUL",2022-08-30,"England Championship","QPR","Hull",3,1,"H",11,7,7,3,4,12,2,7,1,1,0,0,0,0,0,4,18,10,16,9,2,0
"20220830SHEREA",2022-08-30,"England Championship","Sheffield United","Reading",4,0,"H",18,4,7,0,13,7,3,5,0,0,0,0,0,0,0,4,22,7,20,8,0,0
"20220830WIGWES",2022-08-30,"England Championship","Wigan","West Brom",1,1,"D",8,8,3,3,12,12,3,2,2,2,0,0,0,0,0,2,16,6,24,5,4,0
"20220830WATMID",2022-08-30,"England Championship","Watford","Middlesbrough",2,1,"H",14,14,4,3,13,9,2,7,2,4,0,0,0,0,0,3,28,7,22,9,6,0
"20220831BRIHUD",2022-08-31,"England Championship","Bristol City","Huddersfield",2,0,"H",12,12,7,4,6,13,4,7,0,0,0,0,0,0,0,2,24,11,19,11,0,0
"20220831COVPRE",2022-08-31,"England Championship","Coventry","Preston",0,1,"A",13,13,4,4,7,8,9,6,1,2,0,0,0,0,0,1,26,8,15,15,3,0
"20220831STOSWA",2022-08-31,"England Championship","Stoke","Swansea",1,1,"D",20,10,4,5,12,8,12,3,1,2,0,0,0,0,0,2,30,9,20,15,3,0
"20220831SUNROT",2022-08-31,"England Championship","Sunderland","Rotherham",3,0,"H",16,7,3,3,8,13,2,1,0,4,0,0,0,0,0,3,23,6,21,3,4,0
"20220831BLABLA",2022-08-31,"England Championship","Blackpool","Blackburn",0,1,"A",13,17,1,5,9,15,7,5,2,3,0,0,0,0,0,1,30,6,24,12,5,0
"20220902WESBUR",2022-09-02,"England Championship","West Brom","Burnley",1,1,"D",23,11,8,4,12,10,9,1,1,4,0,0,0,0,0,2,34,12,22,10,5,0
"20220903BLABRI",2022-09-03,"England Championship","Blackburn","Bristol City",2,3,"A",11,16,6,5,8,10,5,6,2,2,0,0,0,0,0,5,27,11,18,11,4,0
"20220903LUTWIG",2022-09-03,"England Championship","Luton","Wigan",1,2,"A",13,9,4,1,10,7,9,4,1,1,0,0,0,0,0,3,22,5,17,13,2,0
"20220903MILCAR",2022-09-03,"England Championship","Millwall","Cardiff",2,0,"H",16,12,7,2,9,15,4,6,2,2,0,0,0,0,0,2,28,9,24,10,4,0
"20220903NORCOV",2022-09-03,"England Championship","Norwich","Coventry",3,0,"H",14,7,7,1,8,4,4,1,1,0,0,0,0,0,0,3,21,8,12,5,1,0
"20220903PREBIR",2022-09-03,"England Championship","Preston","Birmingham",0,1,"A",10,8,3,3,14,12,4,6,1,3,0,0,0,0,0,1,18,6,26,10,4,0
"20220903ROTWAT",2022-09-03,"England Championship","Rotherham","Watford",1,1,"D",8,12,3,2,12,11,3,6,3,2,0,0,2,1,1,2,20,5,23,9,5,0
"20220903SWAQPR",2022-09-03,"England Championship","Swansea","QPR",1,0,"H",13,8,4,3,8,9,6,4,3,0,0,0,0,0,0,1,21,7,17,10,3,0
"20220904REASTO",2022-09-04,"England Championship","Reading","Stoke",2,1,"H",11,11,3,3,5,15,4,6,2,0,0,0,0,0,0,3,22,6,20,10,2,0
"20220904HUDBLA",2022-09-04,"England Championship","Huddersfield","Blackpool",0,1,"A",15,7,6,2,8,4,10,2,0,3,0,0,0,0,0,1,22,8,12,12,3,0
"20220904HULSHE",2022-09-04,"England Championship","Hull","Sheffield United",0,2,"A",11,12,3,5,8,14,6,1,1,2,0,0,0,0,0,2,23,8,22,7,3,0
"20220905MIDSUN",2022-09-05,"England Championship","Middlesbrough","Sunderland",1,0,"H",15,8,5,2,10,11,4,6,5,1,0,0,0,0,0,1,23,7,21,10,6,0
"20220913BLAWAT",2022-09-13,"England Championship","Blackburn","Watford",2,0,"H",15,6,6,2,9,12,9,5,2,0,0,0,0,0,0,2,21,8,21,14,2,0
"20220913HUDWIG",2022-09-13,"England Championship","Huddersfield","Wigan",1,2,"A",18,12,6,5,12,10,4,5,2,2,0,0,0,0,0,3,30,11,22,9,4,0
"20220913HULSTO",2022-09-13,"England Championship","Hull","Stoke",0,3,"A",15,20,4,7,13,12,7,6,2,1,0,0,0,0,0,3,35,11,25,13,3,0
"20220913MIDCAR",2022-09-13,"England Championship","Middlesbrough","Cardiff",2,3,"A",10,6,2,4,6,6,9,3,1,1,0,0,0,0,0,5,16,6,12,12,2,0
"20220913SWASHE",2022-09-13,"England Championship","Swansea","Sheffield United",0,1,"A",12,12,2,3,9,13,6,4,1,1,0,0,0,0,0,1,24,5,22,10,2,0
"20220913PREBUR",2022-09-13,"England Championship","Preston","Burnley",1,1,"D",6,12,3,4,17,6,4,6,2,0,0,0,0,0,0,2,18,7,23,10,2,0
"20220914LUTCOV",2022-09-14,"England Championship","Luton","Coventry",2,2,"D",11,12,4,4,7,11,7,3,2,1,0,0,0,0,0,4,23,8,18,10,3,0
"20220914MILQPR",2022-09-14,"England Championship","Millwall","QPR",0,2,"A",12,13,3,4,10,7,5,4,0,0,0,0,0,0,0,2,25,7,17,9,0,0
"20220914NORBRI",2022-09-14,"England Championship","Norwich","Bristol City",3,2,"H",11,11,6,4,10,8,2,7,0,0,0,0,0,0,0,5,22,10,18,9,0,0
"20220914ROTBLA",2022-09-14,"England Championship","Rotherham","Blackpool",3,0,"H",11,6,4,1,9,8,5,4,1,1,0,0,0,0,0,3,17,5,17,9,2,0
"20220914REASUN",2022-09-14,"England Championship","Reading","Sunderland",0,3,"A",6,13,2,6,16,8,3,7,1,1,0,0,0,0,0,3,19,8,24,10,2,0
"20220914WESBIR",2022-09-14,"England Championship","West Brom","Birmingham",2,3,"A",18,7,5,3,6,12,6,2,2,1,0,0,0,0,0,5,25,8,18,8,3,0
"20220917SWAHUL",2022-09-17,"England Championship","Swansea","Hull",3,0,"H",17,6,5,1,6,7,5,3,1,2,0,0,0,0,0,3,23,6,13,8,3,0
"20220917BIRCOV",2022-09-17,"England Championship","Birmingham","Coventry",0,0,"D",12,13,4,3,6,17,6,4,1,3,0,1,0,0,0,0,25,7,23,10,4,1
"20220917BURBRI",2022-09-17,"England Championship","Burnley","Bristol City",2,1,"H",13,9,6,5,10,6,8,5,1,1,0,0,0,0,0,3,22,11,16,13,2,0
"20220917HUDCAR",2022-09-17,"England Championship","Huddersfield","Cardiff",1,0,"H",8,7,4,2,10,6,1,3,3,0,0,0,0,0,0,1,15,6,16,4,3,0
"20220917LUTBLA",2022-09-17,"England Championship","Luton","Blackburn",2,0,"H",13,7,4,1,10,13,4,3,2,2,0,0,0,0,0,2,20,5,23,7,4,0
"20220917MILBLA",2022-09-17,"England Championship","Millwall","Blackpool",2,1,"H",16,8,6,2,16,12,5,2,2,2,0,0,0,0,0,3,24,8,28,7,4,0
"20220917NORWES",2022-09-17,"England Championship","Norwich","West Brom",1,1,"D",11,11,3,2,10,13,7,4,1,1,0,0,0,0,0,2,22,5,23,11,2,0
"20220917PRESHE",2022-09-17,"England Championship","Preston","Sheffield United",0,2,"A",18,15,3,6,11,10,7,5,1,3,0,0,0,0,0,2,33,9,21,12,4,0
"20220917QPRSTO",2022-09-17,"England Championship","QPR","Stoke",0,0,"D",20,8,5,1,11,14,8,6,1,2,0,0,0,0,0,0,28,6,25,14,3,0
"20220917WATSUN",2022-09-17,"England Championship","Watford","Sunderland",2,2,"D",13,12,4,5,8,6,8,3,0,4,0,0,0,0,0,4,25,9,14,11,4,0
"20220917WIGREA",2022-09-17,"England Championship","Wigan","Reading",0,1,"A",10,7,0,2,10,12,1,3,3,2,0,0,0,0,0,1,17,2,22,4,5,0
"20220917MIDROT",2022-09-17,"England Championship","Middlesbrough","Rotherham",0,0,"D",13,3,3,0,14,15,8,3,1,2,0,0,0,0,0,0,16,3,29,11,3,0
"20220930HULLUT",2022-09-30,"England Championship","Hull","Luton",0,2,"A",11,10,0,5,11,10,7,6,1,3,0,0,0,0,0,2,21,5,21,13,4,0
"20221001BLAMIL",2022-10-01,"England Championship","Blackburn","Millwall",2,1,"H",10,10,4,2,6,9,4,4,1,0,0,0,0,0,0,3,20,6,15,8,1,0
"20221001BLANOR",2022-10-01,"England Championship","Blackpool","Norwich",0,1,"A",17,22,6,8,13,4,9,6,3,0,0,0,0,0,0,1,39,14,17,15,3,0
"20221001BRIQPR",2022-10-01,"England Championship","Bristol City","QPR",1,2,"A",12,15,2,6,13,13,8,2,3,1,0,0,0,0,0,3,27,8,26,10,4,0
"20221001CARBUR",2022-10-01,"England Championship","Cardiff","Burnley",1,1,"D",12,8,4,2,9,5,9,1,3,0,0,0,0,0,0,2,20,6,14,10,3,0
"20221001COVMID",2022-10-01,"England Championship","Coventry","Middlesbrough",1,0,"H",11,6,4,3,22,12,3,6,4,1,0,0,1,0,1,1,17,7,34,9,5,0
"20221001REAHUD",2022-10-01,"England Championship","Reading","Huddersfield",3,1,"H",11,10,3,3,5,13,5,1,0,3,0,0,0,0,0,4,21,6,18,6,3,0
"20221001ROTWIG",2022-10-01,"England Championship","Rotherham","Wigan",0,2,"A",12,14,3,5,9,8,8,4,3,1,0,0,0,0,0,2,26,8,17,12,4,0
"20221001SHEBIR",2022-10-01,"England Championship","Sheffield United","Birmingham",1,1,"D",13,8,3,2,9,14,4,4,3,3,0,0,0,0,0,2,21,5,23,8,6,0
"20221001SUNPRE",2022-10-01,"England Championship","Sunderland","Preston",0,0,"D",16,8,2,5,11,14,4,8,1,1,0,0,0,0,0,0,24,7,25,12,2,0
"20221001WESSWA",2022-10-01,"England Championship","West Brom","Swansea",2,3,"A",13,7,5,4,21,8,8,6,3,1,0,0,0,0,0,5,20,9,29,14,4,0
"20221002STOWAT",2022-10-02,"England Championship","Stoke","Watford",0,4,"A",15,16,2,9,10,15,6,6,2,5,0,0,0,0,0,4,31,11,25,12,7,0
"20221004BRICOV",2022-10-04,"England Championship","Bristol City","Coventry",0,0,"D",9,10,3,3,7,11,9,2,2,1,0,0,0,0,0,0,19,6,18,11,3,0
"20221004LUTHUD",2022-10-04,"England Championship","Luton","Huddersfield",3,3,"D",24,3,10,3,9,9,9,5,0,0,0,1,0,0,0,6,27,13,18,14,0,1
"20221004SHEQPR",2022-10-04,"England Championship","Sheffield United","QPR",0,1,"A",21,10,5,3,8,10,9,3,2,2,0,0,0,0,0,1,31,8,18,12,4,0
"20221004SUNBLA",2022-10-04,"England Championship","Sunderland","Blackpool",0,0,"D",15,13,4,4,10,13,5,12,1,3,0,0,0,0,0,0,28,8,23,17,4,0
"20221004CARBLA",2022-10-04,"England Championship","Cardiff","Blackburn",1,0,"H",14,5,5,2,13,14,7,0,2,2,0,0,0,0,0,1,19,7,27,7,4,0
"20221004REANOR",2022-10-04,"England Championship","Reading","Norwich",1,1,"D",10,7,3,1,10,4,3,7,3,1,0,0,0,0,0,2,17,4,14,10,4,0
"20221005BURSTO",2022-10-05,"England Championship","Burnley","Stoke",1,1,"D",13,6,6,4,5,11,15,2,2,2,0,0,0,0,0,2,19,10,16,17,4,0
"20221005HULWIG",2022-10-05,"England Championship","Hull","Wigan",2,1,"H",11,12,5,4,13,10,9,5,3,1,0,0,0,0,0,3,23,9,23,14,4,0
"20221005MIDBIR",2022-10-05,"England Championship","Middlesbrough","Birmingham",1,0,"H",13,13,3,4,11,10,6,6,2,1,0,0,0,0,0,1,26,7,21,12,3,0
"20221005ROTMIL",2022-10-05,"England Championship","Rotherham","Millwall",1,1,"D",10,14,1,4,9,8,6,4,2,2,0,0,0,0,0,2,24,5,17,10,4,0
"20221005WATSWA",2022-10-05,"England Championship","Watford","Swansea",1,2,"A",9,12,4,4,18,12,1,6,1,5,0,0,0,0,0,3,21,8,30,7,6,0
"20221005PREWES",2022-10-05,"England Championship","Preston","West Brom",1,0,"H",9,18,4,5,9,3,2,10,2,1,0,0,0,0,0,1,27,9,12,12,3,0
"20221007QPRREA",2022-10-07,"England Championship","QPR","Reading",2,1,"H",11,9,5,2,10,14,4,5,2,3,0,0,0,0,0,3,20,7,24,9,5,0
"20221008BIRBRI",2022-10-08,"England Championship","Birmingham","Bristol City",3,0,"H",10,7,5,1,23,11,7,4,3,2,0,0,0,0,0,3,17,6,34,11,5,0
"20221008BLAROT",2022-10-08,"England Championship","Blackburn","Rotherham",3,0,"H",19,9,6,2,7,9,8,3,0,3,0,0,0,0,0,3,28,8,16,11,3,0
"20221008BLAWAT",2022-10-08,"England Championship","Blackpool","Watford",3,1,"H",18,10,9,5,10,9,5,7,1,1,0,0,0,0,0,4,28,14,19,12,2,0
"20221008COVBUR",2022-10-08,"England Championship","Coventry","Burnley",0,1,"A",6,13,0,4,7,8,2,7,1,3,0,0,0,0,0,1,19,4,15,9,4,0
"20221008MILMID",2022-10-08,"England Championship","Millwall","Middlesbrough",2,0,"H",9,7,7,1,15,12,0,7,2,2,0,0,0,0,0,2,16,8,27,7,4,0
"20221008NORPRE",2022-10-08,"England Championship","Norwich","Preston",2,3,"A",17,8,8,5,10,12,8,3,1,5,0,0,0,0,0,5,25,13,22,11,6,0
"20221008STOSHE",2022-10-08,"England Championship","Stoke","Sheffield United",3,1,"H",12,8,5,3,12,6,6,5,3,1,0,0,0,0,0,4,20,8,18,11,4,0
"20221008SWASUN",2022-10-08,"England Championship","Swansea","Sunderland",2,1,"H",10,11,6,3,7,13,7,4,2,5,0,0,0,0,0,3,21,9,20,11,7,0
"20221008WESLUT",2022-10-08,"England Championship","West Brom","Luton",0,0,"D",12,8,3,3,5,10,7,4,1,1,0,0,0,0,0,0,20,6,15,11,2,0
"20221008WIGCAR",2022-10-08,"England Championship","Wigan","Cardiff",1,3,"A",10,10,1,6,7,15,6,3,4,2,0,0,0,0,0,4,20,7,22,9,6,0
"20221009HUDHUL",2022-10-09,"England Championship","Huddersfield","Hull",2,0,"H",9,12,5,2,10,14,6,3,4,3,0,0,0,0,0,2,21,7,24,9,7,0
"20221011WIGBLA",2022-10-11,"England Championship","Wigan","Blackburn",1,0,"H",13,3,6,0,11,10,2,1,2,1,0,0,0,0,0,1,16,6,21,3,3,0
"20221012BRIPRE",2022-10-12,"England Championship","Bristol City","Preston",2,1,"H",13,8,4,2,12,12,5,1,3,4,0,0,0,0,0,3,21,6,24,6,7,0
"20221015LUTQPR",2022-10-15,"England Championship","Luton","QPR",3,1,"H",17,12,4,4,16,12,9,9,2,0,0,0,0,0,0,4,29,8,28,18,2,0
"20221015ROTHUD",2022-10-15,"England Championship","Rotherham","Huddersfield",2,1,"H",10,7,4,4,12,12,3,3,3,2,0,0,0,0,0,3,17,8,24,6,5,0
"20221015BRIMIL",2022-10-15,"England Championship","Bristol City","Millwall",1,2,"A",9,16,1,7,10,11,0,6,2,3,0,0,0,0,0,3,25,8,21,6,5,0
"20221015BURSWA",2022-10-15,"England Championship","Burnley","Swansea",4,0,"H",10,6,5,2,9,11,5,6,1,4,0,1,0,0,0,4,16,7,20,11,5,1
"20221015CARCOV",2022-10-15,"England Championship","Cardiff","Coventry",0,1,"A",15,11,1,4,6,12,12,7,1,4,0,0,0,0,0,1,26,5,18,19,5,0
"20221015MIDBLA",2022-10-15,"England Championship","Middlesbrough","Blackburn",1,2,"A",16,10,8,5,7,9,9,4,2,4,0,0,0,0,0,3,26,13,16,13,6,0
"20221015PRESTO",2022-10-15,"England Championship","Preston","Stoke",0,2,"A",7,18,0,6,9,11,3,6,1,0,0,0,0,0,0,2,25,6,20,9,1,0
"20221015REAWES",2022-10-15,"England Championship","Reading","West Brom",0,2,"A",17,9,6,3,10,11,4,7,3,1,0,0,0,0,0,2,26,9,21,11,4,0
"20221015SHEBLA",2022-10-15,"England Championship","Sheffield United","Blackpool",3,3,"D",20,10,9,3,13,10,14,4,5,0,1,3,0,0,0,6,30,12,23,18,5,4
"20221015SUNWIG",2022-10-15,"England Championship","Sunderland","Wigan",2,1,"H",8,8,3,1,7,15,1,5,3,2,0,0,0,0,0,3,16,4,22,6,5,0
"20221015WATNOR",2022-10-15,"England Championship","Watford","Norwich",2,1,"H",16,11,9,2,10,8,3,12,1,1,0,0,0,0,0,3,27,11,18,15,2,0
"20221016HULBIR",2022-10-16,"England Championship","Hull","Birmingham",0,2,"A",12,9,2,3,15,6,7,6,4,3,0,0,0,0,0,2,21,5,21,13,7,0
"20221018HUDPRE",2022-10-18,"England Championship","Huddersfield","Preston",0,1,"A",9,10,0,3,13,9,5,5,5,1,0,0,0,0,0,1,19,3,22,10,6,0
"20221018NORLUT",2022-10-18,"England Championship","Norwich","Luton",0,1,"A",14,6,1,2,9,13,4,2,1,2,1,0,0,0,0,1,20,3,22,6,3,1
"20221018SWAREA",2022-10-18,"England Championship","Swansea","Reading",3,2,"H",13,7,5,4,2,7,8,0,1,1,0,0,0,0,0,5,20,9,9,8,2,0
"20221018BLASUN",2022-10-18,"England Championship","Blackburn","Sunderland",2,0,"H",11,13,3,4,16,11,3,7,3,3,0,0,0,0,0,2,24,7,27,10,6,0
"20221018STOROT",2022-10-18,"England Championship","Stoke","Rotherham",0,1,"A",29,4,12,1,7,14,8,3,0,3,0,0,0,0,0,1,33,13,21,11,3,0
"20221018WESBRI",2022-10-18,"England Championship","West Brom","Bristol City",0,2,"A",14,6,0,2,12,8,13,1,3,1,0,0,0,0,0,2,20,2,20,14,4,0
"20221019BIRBUR",2022-10-19,"England Championship","Birmingham","Burnley",1,1,"D",14,9,2,1,13,11,8,4,1,2,0,0,0,0,0,2,23,3,24,12,3,0
"20221019BLAHUL",2022-10-19,"England Championship","Blackpool","Hull",1,3,"A",8,11,1,3,13,15,2,4,3,4,0,0,1,0,1,4,19,4,28,6,7,0
"20221019COVSHE",2022-10-19,"England Championship","Coventry","Sheffield United",1,0,"H",7,18,2,3,14,7,4,10,4,1,0,0,1,1,0,1,25,5,21,14,5,0
"20221019QPRCAR",2022-10-19,"England Championship","QPR","Cardiff",3,0,"H",22,4,10,0,16,11,6,2,2,5,0,1,0,0,0,3,26,10,27,8,7,1
"20221019WIGMID",2022-10-19,"England Championship","Wigan","Middlesbrough",1,4,"A",10,16,5,7,7,11,4,4,1,2,0,0,0,0,0,5,26,12,18,8,3,0
"20221019MILWAT",2022-10-19,"England Championship","Millwall","Watford",3,0,"H",12,13,4,2,12,10,2,5,0,2,0,0,0,0,0,3,25,6,22,7,2,0
"20221022BLAPRE",2022-10-22,"England Championship","Blackpool","Preston",4,2,"H",11,18,5,6,11,12,1,6,1,2,0,0,0,0,0,6,29,11,23,7,3,0
"20221022BLABIR",2022-10-22,"England Championship","Blackburn","Birmingham",2,1,"H",5,17,3,6,8,6,2,9,1,1,0,0,0,0,0,3,22,9,14,11,2,0
"20221022MIDHUD",2022-10-22,"England Championship","Middlesbrough","Huddersfield",0,0,"D",11,9,2,4,7,11,3,5,3,1,0,0,0,0,0,0,20,6,18,8,4,0
"20221022MILWES",2022-10-22,"England Championship","Millwall","West Brom",2,1,"H",18,8,3,2,8,11,5,2,1,1,0,1,0,0,0,3,26,5,19,7,2,1
"20221022QPRWIG",2022-10-22,"England Championship","QPR","Wigan",2,1,"H",9,11,4,2,10,6,5,4,1,2,0,0,0,0,0,3,20,6,16,9,3,0
"20221022REABRI",2022-10-22,"England Championship","Reading","Bristol City",2,0,"H",15,5,4,0,12,8,10,5,2,3,0,0,0,0,0,2,20,4,20,15,5,0
"20221022ROTHUL",2022-10-22,"England Championship","Rotherham","Hull",2,4,"A",11,19,3,13,6,9,4,7,1,0,0,0,0,0,0,6,30,16,15,11,1,0
"20221022SHENOR",2022-10-22,"England Championship","Sheffield United","Norwich",2,2,"D",22,10,8,6,16,12,4,9,1,5,0,0,0,0,0,4,32,14,28,13,6,0
"20221022STOCOV",2022-10-22,"England Championship","Stoke","Coventry",0,2,"A",11,8,2,3,8,15,9,2,1,1,0,0,0,0,0,2,19,5,23,11,2,0
"20221022SUNBUR",2022-10-22,"England Championship","Sunderland","Burnley",2,4,"A",10,9,5,4,9,10,2,5,1,3,0,0,0,0,0,6,19,9,19,7,4,0
"20221023SWACAR",2022-10-23,"England Championship","Swansea","Cardiff",2,0,"H",13,3,6,1,5,10,7,1,3,3,0,1,0,0,0,2,16,7,15,8,6,1
"20221023WATLUT",2022-10-23,"England Championship","Watford","Luton",4,0,"H",13,9,8,3,9,15,6,1,3,4,0,1,0,0,0,4,22,11,24,7,7,1
"20221025COVROT",2022-10-25,"England Championship","Coventry","Rotherham",2,2,"D",21,10,7,4,7,11,6,1,2,3,0,0,0,0,0,4,31,11,18,7,5,0
"20221025BURNOR",2022-10-25,"England Championship","Burnley","Norwich",1,0,"H",17,5,2,2,10,14,5,4,3,3,0,0,0,0,0,1,22,4,24,9,6,0
"20221028BIRQPR",2022-10-28,"England Championship","Birmingham","QPR",2,0,"H",7,15,3,4,15,6,2,10,4,3,0,0,0,0,0,2,22,7,21,12,7,0
"20221029BRISWA",2022-10-29,"England Championship","Bristol City","Swansea",1,1,"D",10,14,4,3,13,5,7,11,1,0,0,0,0,0,0,2,24,7,18,18,1,0
"20221029WESSHE",2022-10-29,"England Championship","West Brom","Sheffield United",0,2,"A",15,11,4,2,6,4,8,3,0,1,0,0,0,0,0,2,26,6,10,11,1,0
"20221029BURREA",2022-10-29,"England Championship","Burnley","Reading",2,1,"H",14,10,3,4,7,7,12,9,3,4,0,0,0,0,0,3,24,7,14,21,7,0
"20221029CARROT",2022-10-29,"England Championship","Cardiff","Rotherham",1,0,"H",19,3,5,0,3,9,10,3,0,1,0,0,0,0,0,1,22,5,12,13,1,0
"20221029COVBLA",2022-10-29,"England Championship","Coventry","Blackpool",1,2,"A",16,17,5,4,9,12,3,5,1,4,0,0,0,0,0,3,33,9,21,8,5,0
"20221029HUDMIL",2022-10-29,"England Championship","Huddersfield","Millwall",1,0,"H",14,4,5,1,8,13,8,1,2,3,0,0,0,0,0,1,18,6,21,9,5,0
"20221029HULBLA",2022-10-29,"England Championship","Hull","Blackburn",0,1,"A",7,14,0,6,11,10,6,3,2,1,0,0,0,0,0,1,21,6,21,9,3,0
"20221029LUTSUN",2022-10-29,"England Championship","Luton","Sunderland",1,1,"D",15,16,3,4,18,17,8,5,2,3,0,0,0,0,0,2,31,7,35,13,5,0
"20221029NORSTO",2022-10-29,"England Championship","Norwich","Stoke",3,1,"H",16,17,9,4,14,10,5,6,6,2,0,0,0,0,0,4,33,13,24,11,8,0
"20221029PREMID",2022-10-29,"England Championship","Preston","Middlesbrough",2,1,"H",13,9,4,1,11,10,2,4,3,3,0,0,0,0,0,3,22,5,21,6,6,0
"20221029WIGWAT",2022-10-29,"England Championship","Wigan","Watford",0,1,"A",8,13,1,2,5,7,3,4,2,2,0,0,0,0,0,1,21,3,12,7,4,0
"20221101COVBLA",2022-11-01,"England Championship","Coventry","Blackburn",1,0,"H",15,9,7,2,5,10,3,4,2,4,0,1,0,0,0,1,24,9,15,7,6,1
"20221101HULMID",2022-11-01,"England Championship","Hull","Middlesbrough",1,3,"A",10,6,2,3,11,8,7,2,1,3,0,0,0,0,0,4,16,5,19,9,4,0
"20221101LUTREA",2022-11-01,"England Championship","Luton","Reading",0,0,"D",9,17,2,3,10,8,6,5,2,3,0,0,0,0,0,0,26,5,18,11,5,0
"20221101PRESWA",2022-11-01,"England Championship","Preston","Swansea",1,0,"H",9,14,4,4,11,8,2,7,4,3,0,0,0,0,0,1,23,8,19,9,7,0
"20221101BRISHE",2022-11-01,"England Championship","Bristol City","Sheffield United",0,1,"A",16,4,3,3,6,15,8,1,3,5,1,0,1,0,1,1,20,6,21,9,8,1
"20221101WESBLA",2022-11-01,"England Championship","West Brom","Blackpool",1,0,"H",11,4,5,0,11,8,7,2,4,2,0,0,0,0,0,1,15,5,19,9,6,0
"20221102BIRMIL",2022-11-02,"England Championship","Birmingham","Millwall",0,0,"D",5,10,0,3,10,11,2,5,0,1,0,0,0,0,0,0,15,3,21,7,1,0
"20221102BURROT",2022-11-02,"England Championship","Burnley","Rotherham",3,2,"H",24,8,11,5,7,4,7,3,3,2,0,1,0,0,0,5,32,16,11,10,5,1
"20221102CARWAT",2022-11-02,"England Championship","Cardiff","Watford",1,2,"A",11,16,3,5,9,8,8,11,2,2,0,0,0,0,0,3,27,8,17,19,4,0
"20221102HUDSUN",2022-11-02,"England Championship","Huddersfield","Sunderland",0,2,"A",16,9,3,3,9,8,5,1,2,2,0,0,0,0,0,2,25,6,17,6,4,0
"20221102NORQPR",2022-11-02,"England Championship","Norwich","QPR",0,0,"D",12,13,3,4,7,10,11,4,1,3,0,0,0,0,0,0,25,7,17,15,4,0
"20221102WIGSTO",2022-11-02,"England Championship","Wigan","Stoke",0,1,"A",11,14,1,5,7,12,2,7,1,1,0,0,0,0,0,1,25,6,19,9,2,0
"20221104REAPRE",2022-11-04,"England Championship","Reading","Preston",1,2,"A",11,10,2,4,10,9,3,2,1,4,0,0,0,0,0,3,21,6,19,5,5,0
"20221105SHEBUR",2022-11-05,"England Championship","Sheffield United","Burnley",5,2,"H",28,14,12,4,8,7,10,6,2,3,0,0,0,0,0,7,42,16,15,16,5,0
"20221105BLAHUD",2022-11-05,"England Championship","Blackburn","Huddersfield",1,0,"H",12,8,4,3,3,16,5,4,0,3,0,0,0,0,0,1,20,7,19,9,3,0
"20221105BLALUT",2022-11-05,"England Championship","Blackpool","Luton",0,1,"A",19,11,8,3,7,10,9,11,1,1,0,0,0,0,0,1,30,11,17,20,2,0
"20221105MIDBRI",2022-11-05,"England Championship","Middlesbrough","Bristol City",1,1,"D",23,6,9,2,13,11,8,1,3,2,0,0,0,0,0,2,29,11,24,9,5,0
"20221105MILHUL",2022-11-05,"England Championship","Millwall","Hull",0,0,"D",24,7,6,2,9,13,10,2,0,3,0,1,0,0,0,0,31,8,22,12,3,1
"20221105QPRWES",2022-11-05,"England Championship","QPR","West Brom",0,1,"A",9,10,2,2,9,10,8,5,1,2,0,0,0,0,0,1,19,4,19,13,3,0
"20221105ROTNOR",2022-11-05,"England Championship","Rotherham","Norwich",1,2,"A",10,13,4,4,10,12,2,9,1,3,0,0,1,0,1,3,23,8,22,11,4,0
"20221105STOBIR",2022-11-05,"England Championship","Stoke","Birmingham",1,2,"A",11,8,7,3,14,17,4,3,3,4,0,0,0,0,0,3,19,10,31,7,7,0
"20221105SUNCAR",2022-11-05,"England Championship","Sunderland","Cardiff",0,1,"A",11,13,2,4,6,12,6,4,4,3,0,0,0,0,0,1,24,6,18,10,7,0
"20221105SWAWIG",2022-11-05,"England Championship","Swansea","Wigan",2,2,"D",13,5,3,4,10,13,6,3,2,2,0,0,0,0,0,4,18,7,23,9,4,0
"20221105WATCOV",2022-11-05,"England Championship","Watford","Coventry",0,1,"A",11,12,2,4,13,6,10,5,4,2,0,0,0,0,0,1,23,6,19,15,6,0
"20221108BIRSWA",2022-11-08,"England Championship","Birmingham","Swansea",2,2,"D",15,8,2,3,12,11,12,1,3,4,0,0,0,0,0,4,23,5,23,13,7,0
"20221108BLAMID",2022-11-08,"England Championship","Blackpool","Middlesbrough",0,3,"A",7,19,1,5,10,12,2,7,4,1,0,0,1,0,1,3,26,6,22,9,5,0
"20221108CARHUL",2022-11-08,"England Championship","Cardiff","Hull",2,3,"A",12,10,2,4,6,9,4,2,0,1,0,0,0,0,0,5,22,6,15,6,1,0
"20221108COVWIG",2022-11-08,"England Championship","Coventry","Wigan",2,0,"H",14,6,2,0,11,15,6,4,2,1,0,0,0,0,0,2,20,2,26,10,3,0
"20221108QPRHUD",2022-11-08,"England Championship","QPR","Huddersfield",1,2,"A",36,11,6,5,11,8,14,4,0,6,0,0,0,0,0,3,47,11,19,18,6,0
"20221108SHEROT",2022-11-08,"England Championship","Sheffield United","Rotherham",0,1,"A",14,4,5,2,10,10,12,1,2,3,0,0,0,0,0,1,18,7,20,13,5,0
"20221108STOLUT",2022-11-08,"England Championship","Stoke","Luton",2,0,"H",8,15,2,3,7,15,5,13,1,4,0,0,0,0,0,2,23,5,22,18,5,0
"20221108WATREA",2022-11-08,"England Championship","Watford","Reading",2,0,"H",15,6,5,1,15,16,7,3,2,3,0,0,0,0,0,2,21,6,31,10,5,0
"20221111BIRSUN",2022-11-11,"England Championship","Birmingham","Sunderland",1,2,"A",22,6,6,4,8,12,7,3,2,4,0,0,0,0,0,3,28,10,20,10,6,0
"20221112BRIWAT",2022-11-12,"England Championship","Bristol City","Watford",0,0,"D",9,2,2,0,15,10,4,3,1,1,0,0,0,0,0,0,11,2,25,7,2,0
"20221112CARSHE",2022-11-12,"England Championship","Cardiff","Sheffield United",0,1,"A",12,10,2,5,10,7,5,4,0,1,0,0,0,0,0,1,22,7,17,9,1,0
"20221112COVQPR",2022-11-12,"England Championship","Coventry","QPR",2,0,"H",13,11,5,1,7,11,2,6,2,2,0,0,0,0,0,2,24,6,18,8,4,0
"20221112HUDSWA",2022-11-12,"England Championship","Huddersfield","Swansea",0,0,"D",8,16,4,6,8,9,2,11,1,2,0,0,0,0,0,0,24,10,17,13,3,0
"20221112HULREA",2022-11-12,"England Championship","Hull","Reading",1,2,"A",12,9,4,4,6,6,4,6,0,1,0,0,0,0,0,3,21,8,12,10,1,0
"20221112LUTROT",2022-11-12,"England Championship","Luton","Rotherham",1,1,"D",18,8,7,2,10,13,12,4,1,7,0,0,0,0,0,2,26,9,23,16,8,0
"20221112NORMID",2022-11-12,"England Championship","Norwich","Middlesbrough",1,2,"A",14,11,6,3,9,10,3,4,1,2,0,0,0,0,0,3,25,9,19,7,3,0
"20221112PREMIL",2022-11-12,"England Championship","Preston","Millwall",2,4,"A",17,5,4,4,5,10,2,2,1,3,0,0,0,0,0,6,22,8,15,4,4,0
"20221112WESSTO",2022-11-12,"England Championship","West Brom","Stoke",2,0,"H",16,13,4,3,9,9,8,6,1,3,0,0,1,0,1,2,29,7,18,14,4,0
"20221112WIGBLA",2022-11-12,"England Championship","Wigan","Blackpool",2,1,"H",18,4,3,1,11,13,8,3,3,2,0,1,0,0,0,3,22,4,24,11,5,1
"20221113BURBLA",2022-11-13,"England Championship","Burnley","Blackburn",3,0,"H",17,1,8,1,12,9,7,3,1,2,0,0,0,0,0,3,18,9,21,10,3,0
"20221203SUNMIL",2022-12-03,"England Championship","Sunderland","Millwall",3,0,"H",11,19,5,5,10,19,1,8,1,3,0,0,0,0,0,3,30,10,29,9,4,0
"20221210BLAPRE",2022-12-10,"England Championship","Blackburn","Preston",1,4,"A",7,13,2,6,12,4,2,2,1,2,0,0,0,0,0,5,20,8,16,4,3,0
"20221210ROTBRI",2022-12-10,"England Championship","Rotherham","Bristol City",1,3,"A",16,9,5,4,7,11,7,9,1,4,0,0,0,0,0,4,25,9,18,16,5,0
"20221210REACOV",2022-12-10,"England Championship","Reading","Coventry",1,0,"H",9,15,3,4,11,8,4,4,2,3,0,0,0,0,0,1,24,7,19,8,5,0
"20221210BLABIR",2022-12-10,"England Championship","Blackpool","Birmingham",0,0,"D",9,10,0,1,9,14,2,6,0,1,0,0,0,0,0,0,19,1,23,8,1,0
"20221210MIDLUT",2022-12-10,"England Championship","Middlesbrough","Luton",2,1,"H",17,3,3,1,16,16,3,2,0,2,0,1,0,0,0,3,20,4,32,5,2,1
"20221210MILWIG",2022-12-10,"England Championship","Millwall","Wigan",1,1,"D",12,7,6,3,18,12,4,3,1,2,0,0,0,0,0,2,19,9,30,7,3,0
"20221210SHEHUD",2022-12-10,"England Championship","Sheffield United","Huddersfield",1,0,"H",16,4,4,1,8,9,10,1,2,2,0,0,0,0,0,1,20,5,17,11,4,0
"20221210STOCAR",2022-12-10,"England Championship","Stoke","Cardiff",2,2,"D",11,8,3,5,10,7,6,6,1,2,0,0,0,0,0,4,19,8,17,12,3,0
"20221210SWANOR",2022-12-10,"England Championship","Swansea","Norwich",0,1,"A",17,5,7,2,9,13,7,4,2,5,0,0,0,0,0,1,22,9,22,11,7,0
"20221211QPRBUR",2022-12-11,"England Championship","QPR","Burnley",0,3,"A",9,9,2,7,13,18,2,6,1,2,0,0,0,0,0,3,18,9,31,8,3,0
"20221211WATHUL",2022-12-11,"England Championship","Watford","Hull",0,0,"D",12,9,3,3,7,13,7,5,0,4,0,0,0,0,0,0,21,6,20,12,4,0
"20221212SUNWES",2022-12-12,"England Championship","Sunderland","West Brom",1,2,"A",11,10,3,4,8,7,5,5,1,1,0,0,0,0,0,3,21,7,15,10,2,0
"20221216BIRREA",2022-12-16,"England Championship","Birmingham","Reading",3,2,"H",9,20,6,7,14,14,0,7,1,1,0,0,0,0,0,5,29,13,28,7,2,0
"20221217BRISTO",2022-12-17,"England Championship","Bristol City","Stoke",1,2,"A",14,6,5,3,11,17,3,3,3,4,0,0,1,0,1,3,20,8,28,6,7,0
"20221217BURMID",2022-12-17,"England Championship","Burnley","Middlesbrough",3,1,"H",11,4,4,4,13,4,4,1,1,2,1,0,0,0,0,4,15,8,17,5,3,1
"20221217CARBLA",2022-12-17,"England Championship","Cardiff","Blackpool",1,1,"D",22,9,8,2,11,13,4,6,3,3,0,0,0,0,0,2,31,10,24,10,6,0
"20221217COVSWA",2022-12-17,"England Championship","Coventry","Swansea",3,3,"D",17,17,9,7,11,12,5,3,0,2,0,0,0,0,0,6,34,16,23,8,2,0
"20221217HUDWAT",2022-12-17,"England Championship","Huddersfield","Watford",0,2,"A",15,12,2,6,10,15,7,11,2,2,0,0,0,0,0,2,27,8,25,18,4,0
"20221217HULSUN",2022-12-17,"England Championship","Hull","Sunderland",1,1,"D",17,6,2,1,8,13,7,4,1,1,0,1,0,0,0,2,23,3,21,11,2,1
"20221217PREQPR",2022-12-17,"England Championship","Preston","QPR",0,1,"A",10,17,2,6,18,13,4,4,1,3,0,0,0,0,0,1,27,8,31,8,4,0
"20221217WESROT",2022-12-17,"England Championship","West Brom","Rotherham",3,0,"H",16,2,9,1,11,10,6,3,1,2,0,0,0,0,0,3,18,10,21,9,3,0
"20221217NORBLA",2022-12-17,"England Championship","Norwich","Blackburn",0,2,"A",19,7,4,3,12,18,6,2,4,3,0,0,0,0,0,2,26,7,30,8,7,0
"20221219WIGSHE",2022-12-19,"England Championship","Wigan","Sheffield United",1,2,"A",10,10,3,6,10,13,8,4,1,3,0,0,0,0,0,3,20,9,23,12,4,0
"20221221COVWES",2022-12-21,"England Championship","Coventry","West Brom",1,0,"H",17,5,8,3,12,11,10,2,2,1,0,0,0,0,0,1,22,11,23,12,3,0
"20221226WATMIL",2022-12-26,"England Championship","Watford","Millwall",0,2,"A",7,23,2,8,14,15,4,10,2,3,1,0,0,0,0,2,30,10,29,14,5,1
"20221226SUNBLA",2022-12-26,"England Championship","Sunderland","Blackburn",2,1,"H",11,5,5,2,15,13,7,3,3,5,0,0,0,0,0,3,16,7,28,10,8,0
"20221226BRIWES",2022-12-26,"England Championship","Bristol City","West Brom",0,2,"A",8,15,3,4,11,8,8,6,2,1,0,0,0,0,0,2,23,7,19,14,3,0
"20221226HULBLA",2022-12-26,"England Championship","Hull","Blackpool",1,1,"D",15,16,1,5,18,13,11,8,2,2,0,1,0,0,0,2,31,6,31,19,4,1
"20221226MIDWIG",2022-12-26,"England Championship","Middlesbrough","Wigan",4,1,"H",14,17,7,5,8,11,9,10,2,1,0,0,0,0,0,5,31,12,19,19,3,0
"20221226PREHUD",2022-12-26,"England Championship","Preston","Huddersfield",1,2,"A",11,9,2,3,10,12,2,3,2,3,0,0,0,0,0,3,20,5,22,5,5,0
"20221226ROTSTO",2022-12-26,"England Championship","Rotherham","Stoke",2,2,"D",5,12,1,5,14,16,3,3,1,2,0,0,0,0,0,4,17,6,30,6,3,0
"20221226SHECOV",2022-12-26,"England Championship","Sheffield United","Coventry",3,1,"H",8,11,3,4,10,10,2,7,0,3,1,0,0,0,0,4,19,7,20,9,3,1
"20221226CARQPR",2022-12-26,"England Championship","Cardiff","QPR",0,0,"D",11,10,0,1,11,14,1,6,2,3,0,0,0,0,0,0,21,1,25,7,5,0
"20221226LUTNOR",2022-12-26,"England Championship","Luton","Norwich",2,1,"H",12,19,3,5,11,10,6,4,1,1,1,0,0,0,0,3,31,8,21,10,2,1
"20221227REASWA",2022-12-27,"England Championship","Reading","Swansea",2,1,"H",9,12,4,7,24,7,3,4,2,3,0,0,0,0,0,3,21,11,31,7,5,0
"20221227BURBIR",2022-12-27,"England Championship","Burnley","Birmingham",3,0,"H",10,2,4,0,12,8,1,1,1,3,0,0,1,0,1,3,12,4,20,2,4,0
"20221229QPRLUT",2022-12-29,"England Championship","QPR","Luton",0,3,"A",8,6,2,5,10,20,6,2,0,4,0,0,0,0,0,3,14,7,30,8,4,0
"20221229BLAMID",2022-12-29,"England Championship","Blackburn","Middlesbrough",1,2,"A",9,11,5,4,8,11,1,7,1,3,1,0,0,0,0,3,20,9,19,8,4,1
"20221229COVCAR",2022-12-29,"England Championship","Coventry","Cardiff",0,0,"D",15,6,4,2,8,9,5,2,2,1,0,0,0,0,0,0,21,6,17,7,3,0
"20221229HUDROT",2022-12-29,"England Championship","Huddersfield","Rotherham",2,0,"H",9,7,3,2,6,13,0,2,3,2,0,0,0,0,0,2,16,5,19,2,5,0
"20221229MILBRI",2022-12-29,"England Championship","Millwall","Bristol City",0,0,"D",9,6,0,2,8,3,3,4,0,0,0,0,0,0,0,0,15,2,11,7,0,0
"20221229WIGSUN",2022-12-29,"England Championship","Wigan","Sunderland",1,4,"A",7,13,2,7,19,14,1,4,2,1,0,0,0,0,0,5,20,9,33,5,3,0
"20221229WESPRE",2022-12-29,"England Championship","West Brom","Preston",2,0,"H",17,8,8,2,9,9,14,3,1,1,0,0,0,0,0,2,25,10,18,17,2,0
"20221229BLASHE",2022-12-29,"England Championship","Blackpool","Sheffield United",1,2,"A",14,11,4,6,8,16,5,6,0,0,0,0,0,0,0,3,25,10,24,11,0,0
"20221230BIRHUL",2022-12-30,"England Championship","Birmingham","Hull",0,1,"A",10,15,3,2,10,10,4,7,3,1,0,0,0,0,0,1,25,5,20,11,4,0
"20221230NORREA",2022-12-30,"England Championship","Norwich","Reading",1,1,"D",11,11,5,4,17,7,8,7,3,2,0,0,0,0,0,2,22,9,24,15,5,0
"20221230STOBUR",2022-12-30,"England Championship","Stoke","Burnley",0,1,"A",6,7,3,2,21,13,3,5,2,3,0,0,0,0,0,1,13,5,34,8,5,0
"20221230SWAWAT",2022-12-30,"England Championship","Swansea","Watford",4,0,"H",15,4,7,3,14,11,4,2,4,2,0,0,0,0,0,4,19,10,25,6,6,0
"20230101BLACAR",2023-01-01,"England Championship","Blackburn","Cardiff",1,0,"H",10,11,4,3,6,9,3,9,3,2,0,0,0,0,0,1,21,7,15,12,5,0
"20230101BLASUN",2023-01-01,"England Championship","Blackpool","Sunderland",1,1,"D",6,18,2,5,14,10,1,5,3,2,1,0,0,0,0,2,24,7,24,6,5,1
"20230101COVBRI",2023-01-01,"England Championship","Coventry","Bristol City",1,1,"D",16,9,6,2,10,10,6,11,3,2,0,0,0,0,0,2,25,8,20,17,5,0
"20230101HUDLUT",2023-01-01,"England Championship","Huddersfield","Luton",1,2,"A",6,9,3,5,14,15,1,1,1,3,0,0,0,0,0,3,15,8,29,2,4,0
"20230101MILROT",2023-01-01,"England Championship","Millwall","Rotherham",3,0,"H",26,5,12,1,9,12,10,1,1,1,0,0,0,0,0,3,31,13,21,11,2,0
"20230102BIRMID",2023-01-02,"England Championship","Birmingham","Middlesbrough",1,3,"A",9,18,1,8,10,8,9,8,1,2,0,0,0,0,0,4,27,9,18,17,3,0
"20230102NORWAT",2023-01-02,"England Championship","Norwich","Watford",0,1,"A",15,12,1,3,9,17,8,3,2,3,0,0,0,0,0,1,27,4,26,11,5,0
"20230102STOPRE",2023-01-02,"England Championship","Stoke","Preston",0,1,"A",15,9,3,2,13,6,4,7,4,4,0,0,0,0,0,1,24,5,19,11,8,0
"20230102SWABUR",2023-01-02,"England Championship","Swansea","Burnley",1,2,"A",10,8,3,3,7,12,4,5,3,5,0,0,0,0,0,3,18,6,19,9,8,0
"20230102WESREA",2023-01-02,"England Championship","West Brom","Reading",1,0,"H",17,7,4,2,11,12,6,3,1,4,0,0,0,0,0,1,24,6,23,9,5,0
"20230102WIGHUL",2023-01-02,"England Championship","Wigan","Hull",1,4,"A",6,9,1,4,10,8,7,5,1,2,0,0,0,0,0,5,15,5,18,12,3,0
"20230102QPRSHE",2023-01-02,"England Championship","QPR","Sheffield United",1,1,"D",15,15,2,6,11,13,8,6,2,2,0,0,0,0,0,2,30,8,24,14,4,0
"20230114ROTBLA",2023-01-14,"England Championship","Rotherham","Blackburn",4,0,"H",8,9,4,3,7,1,4,2,1,0,0,0,0,0,0,4,17,7,8,6,1,0
"20230114BRIBIR",2023-01-14,"England Championship","Bristol City","Birmingham",4,2,"H",10,14,5,4,14,6,5,2,2,1,0,0,0,0,0,6,24,9,20,7,3,0
"20230114BURCOV",2023-01-14,"England Championship","Burnley","Coventry",1,0,"H",10,8,5,0,4,8,3,5,3,3,0,0,0,0,0,1,18,5,12,8,6,0
"20230114CARWIG",2023-01-14,"England Championship","Cardiff","Wigan",1,1,"D",11,16,2,4,7,11,3,3,4,2,0,0,0,0,0,2,27,6,18,6,6,0
"20230114HULHUD",2023-01-14,"England Championship","Hull","Huddersfield",1,1,"D",14,8,5,6,4,5,4,4,0,2,0,0,0,0,0,2,22,11,9,8,2,0
"20230114LUTWES",2023-01-14,"England Championship","Luton","West Brom",2,3,"A",10,18,4,7,15,9,2,9,3,2,0,0,0,0,0,5,28,11,24,11,5,0
"20230114MIDMIL",2023-01-14,"England Championship","Middlesbrough","Millwall",1,0,"H",7,8,3,2,8,13,6,3,2,3,0,0,0,0,0,1,15,5,21,9,5,0
"20230114PRENOR",2023-01-14,"England Championship","Preston","Norwich",0,4,"A",9,22,2,8,17,11,4,7,4,4,0,0,0,0,0,4,31,10,28,11,8,0
"20230114REAQPR",2023-01-14,"England Championship","Reading","QPR",2,2,"D",10,17,3,4,11,9,5,7,2,2,0,0,0,0,0,4,27,7,20,12,4,0
"20230114SHESTO",2023-01-14,"England Championship","Sheffield United","Stoke",3,1,"H",8,9,3,5,7,13,2,6,2,2,0,0,0,0,0,4,17,8,20,8,4,0
"20230114SUNSWA",2023-01-14,"England Championship","Sunderland","Swansea",1,3,"A",8,18,3,6,15,15,1,4,1,4,1,0,0,0,0,4,26,9,30,5,5,1
"20230114WATBLA",2023-01-14,"England Championship","Watford","Blackpool",2,0,"H",11,6,5,2,11,14,2,3,2,3,0,0,0,0,0,2,17,7,25,5,5,0
"20230120SHEHUL",2023-01-20,"England Championship","Sheffield United","Hull",1,0,"H",13,10,5,2,11,8,4,2,6,2,0,1,0,0,0,1,23,7,19,6,8,1
"20230120BURWES",2023-01-20,"England Championship","Burnley","West Brom",2,1,"H",17,8,2,2,7,8,16,5,1,1,0,0,0,0,0,3,25,4,15,21,2,0
"20230121COVNOR",2023-01-21,"England Championship","Coventry","Norwich",2,4,"A",11,18,4,7,10,8,4,6,0,1,0,0,0,0,0,6,29,11,18,10,1,0
"20230121BIRPRE",2023-01-21,"England Championship","Birmingham","Preston",1,2,"A",10,8,4,4,12,11,5,3,4,1,0,0,0,0,0,3,18,8,23,8,5,0
"20230121BRIBLA",2023-01-21,"England Championship","Bristol City","Blackburn",1,1,"D",11,6,3,2,10,12,5,3,1,1,0,1,0,0,0,2,17,5,22,8,2,1
"20230121CARMIL",2023-01-21,"England Championship","Cardiff","Millwall",0,1,"A",22,15,4,6,13,10,7,4,3,3,0,0,0,0,0,1,37,10,23,11,6,0
"20230121QPRSWA",2023-01-21,"England Championship","QPR","Swansea",1,1,"D",15,14,4,2,15,14,5,8,0,0,0,0,0,0,0,2,29,6,29,13,0,0
"20230121STOREA",2023-01-21,"England Championship","Stoke","Reading",4,0,"H",16,7,7,3,12,5,6,2,0,0,0,0,0,0,0,4,23,10,17,8,0,0
"20230121WATROT",2023-01-21,"England Championship","Watford","Rotherham",1,1,"D",18,12,5,5,9,8,9,3,3,3,0,0,0,0,0,2,30,10,17,12,6,0
"20230121WIGLUT",2023-01-21,"England Championship","Wigan","Luton",0,2,"A",9,8,1,2,7,11,3,1,2,3,0,0,0,0,0,2,17,3,18,4,5,0
"20230122SUNMID",2023-01-22,"England Championship","Sunderland","Middlesbrough",2,0,"H",17,14,6,6,8,10,4,8,0,2,0,1,0,0,0,2,31,12,18,12,2,1
"20230128COVHUD",2023-01-28,"England Championship","Coventry","Huddersfield",2,0,"H",9,6,5,4,13,13,6,3,1,2,0,0,0,0,0,2,15,9,26,9,3,0
"20230128HULQPR",2023-01-28,"England Championship","Hull","QPR",3,0,"H",7,5,3,2,10,8,4,5,0,4,0,0,0,0,0,3,12,5,18,9,4,0
"20230128MIDWAT",2023-01-28,"England Championship","Middlesbrough","Watford",2,0,"H",14,11,6,4,10,19,9,5,1,2,0,0,0,0,0,2,25,10,29,14,3,0
"20230131LUTCAR",2023-01-31,"England Championship","Luton","Cardiff",1,0,"H",15,11,4,4,12,7,13,2,3,2,0,0,0,0,0,1,26,8,19,15,5,0
"20230203WESCOV",2023-02-03,"England Championship","West Brom","Coventry",1,0,"H",16,10,3,1,11,12,10,4,4,1,0,0,0,0,0,1,26,4,23,14,5,0
"20230204NORBUR",2023-02-04,"England Championship","Norwich","Burnley",0,3,"A",8,13,1,6,15,15,5,3,5,3,0,0,0,0,0,3,21,7,30,8,8,0
"20230204ROTSHE",2023-02-04,"England Championship","Rotherham","Sheffield United",0,0,"D",6,12,3,2,13,6,3,5,1,1,0,0,0,0,0,0,18,5,19,8,2,0
"20230204HUDQPR",2023-02-04,"England Championship","Huddersfield","QPR",1,1,"D",6,11,4,2,14,13,8,4,2,2,0,0,0,0,0,2,17,6,27,12,4,0
"20230204HULCAR",2023-02-04,"England Championship","Hull","Cardiff",1,0,"H",12,14,4,3,10,7,3,7,2,0,0,0,0,0,0,1,26,7,17,10,2,0
"20230204LUTSTO",2023-02-04,"England Championship","Luton","Stoke",1,0,"H",11,7,4,1,11,7,7,5,2,3,0,0,0,0,0,1,18,5,18,12,5,0
"20230204MIDBLA",2023-02-04,"England Championship","Middlesbrough","Blackpool",3,0,"H",13,13,6,1,14,12,9,7,1,2,0,0,0,0,0,3,26,7,26,16,3,0
"20230204MILSUN",2023-02-04,"England Championship","Millwall","Sunderland",1,1,"D",14,5,2,1,19,10,5,6,3,1,0,0,0,0,0,2,19,3,29,11,4,0
"20230204PREBRI",2023-02-04,"England Championship","Preston","Bristol City",1,2,"A",17,6,6,3,10,12,5,3,1,4,0,0,0,0,0,3,23,9,22,8,5,0
"20230204REAWAT",2023-02-04,"England Championship","Reading","Watford",2,2,"D",14,12,6,4,17,17,4,4,3,4,0,0,0,0,0,4,26,10,34,8,7,0
"20230204SWABIR",2023-02-04,"England Championship","Swansea","Birmingham",3,4,"A",14,14,6,6,7,12,1,3,1,2,0,0,0,0,0,7,28,12,19,4,3,0
"20230206BLAWIG",2023-02-06,"England Championship","Blackburn","Wigan",0,0,"D",9,11,3,1,10,13,7,7,3,1,0,0,0,0,0,0,20,4,23,14,4,0
"20230207BLAHUD",2023-02-07,"England Championship","Blackpool","Huddersfield",2,2,"D",10,13,3,6,9,7,3,7,1,3,1,0,0,0,0,4,23,9,16,10,4,1
"20230210BIRWES",2023-02-10,"England Championship","Birmingham","West Brom",2,0,"H",12,5,4,1,13,7,5,6,3,3,0,0,0,0,0,2,17,5,20,11,6,0
"20230211BLAROT",2023-02-11,"England Championship","Blackpool","Rotherham",0,0,"D",10,10,3,2,7,13,4,0,1,0,0,0,0,0,0,0,20,5,20,4,1,0
"20230211BRINOR",2023-02-11,"England Championship","Bristol City","Norwich",1,0,"H",7,15,2,1,14,7,8,8,1,3,0,0,0,0,0,1,22,3,21,16,4,0
"20230211BURPRE",2023-02-11,"England Championship","Burnley","Preston",3,0,"H",13,5,6,2,10,15,5,2,1,3,0,0,0,0,0,3,18,8,25,7,4,0
"20230211CARMID",2023-02-11,"England Championship","Cardiff","Middlesbrough",1,3,"A",15,11,4,3,9,13,7,4,0,2,0,0,0,0,0,4,26,7,22,11,2,0
"20230211COVLUT",2023-02-11,"England Championship","Coventry","Luton",1,1,"D",12,8,3,6,16,16,5,5,1,4,1,0,0,0,0,2,20,9,32,10,5,1
"20230211QPRMIL",2023-02-11,"England Championship","QPR","Millwall",1,2,"A",10,11,2,5,8,12,4,3,1,1,0,0,0,0,0,3,21,7,20,7,2,0
"20230211SHESWA",2023-02-11,"England Championship","Sheffield United","Swansea",3,0,"H",18,12,9,3,13,11,4,5,2,3,0,0,0,0,0,3,30,12,24,9,5,0
"20230211STOHUL",2023-02-11,"England Championship","Stoke","Hull",0,0,"D",5,9,2,3,14,9,7,2,0,2,0,0,0,0,0,0,14,5,23,9,2,0
"20230211SUNREA",2023-02-11,"England Championship","Sunderland","Reading",1,0,"H",13,9,5,1,7,9,4,8,0,2,0,0,0,0,0,1,22,6,16,12,2,0
"20230211WATBLA",2023-02-11,"England Championship","Watford","Blackburn",1,1,"D",15,7,6,4,13,18,6,2,2,4,0,0,0,0,0,2,22,10,31,8,6,0
"20230211WIGHUD",2023-02-11,"England Championship","Wigan","Huddersfield",1,0,"H",6,5,1,2,12,10,3,2,1,1,0,0,0,0,0,1,11,3,22,5,2,0
"20230214BIRCAR",2023-02-14,"England Championship","Birmingham","Cardiff",0,2,"A",6,12,1,4,13,7,5,4,3,3,0,0,0,0,0,2,18,5,20,9,6,0
"20230214COVMIL",2023-02-14,"England Championship","Coventry","Millwall",1,0,"H",12,11,5,2,8,9,3,6,1,3,0,0,0,0,0,1,23,7,17,9,4,0
"20230214NORHUL",2023-02-14,"England Championship","Norwich","Hull",3,1,"H",21,3,6,1,8,11,5,3,0,1,0,0,0,0,0,4,24,7,19,8,1,0
"20230214QPRSUN",2023-02-14,"England Championship","QPR","Sunderland",0,3,"A",7,12,2,8,16,13,2,2,6,2,0,0,0,0,0,3,19,10,29,4,8,0
"20230214BURWAT",2023-02-14,"England Championship","Burnley","Watford",1,1,"D",14,4,5,1,14,15,5,1,3,3,0,0,0,0,0,2,18,6,29,6,6,0
"20230214REAROT",2023-02-14,"England Championship","Reading","Rotherham",2,1,"H",12,13,3,1,10,14,4,4,2,0,0,0,0,0,0,3,25,4,24,8,2,0
"20230215BRIWIG",2023-02-15,"England Championship","Bristol City","Wigan",1,1,"D",5,10,1,2,6,12,3,11,2,3,0,0,0,0,0,2,15,3,18,14,5,0
"20230215PRELUT",2023-02-15,"England Championship","Preston","Luton",1,1,"D",7,18,2,3,7,13,2,10,2,2,1,0,0,0,0,2,25,5,20,12,4,1
"20230215STOHUD",2023-02-15,"England Championship","Stoke","Huddersfield",3,0,"H",16,3,6,1,15,13,12,3,2,3,0,1,0,0,0,3,19,7,28,15,5,1
"20230215SWABLA",2023-02-15,"England Championship","Swansea","Blackpool",2,1,"H",17,7,6,3,18,9,6,2,2,1,0,1,0,0,0,3,24,9,27,8,3,1
"20230215SHEMID",2023-02-15,"England Championship","Sheffield United","Middlesbrough",1,3,"A",18,17,10,5,10,8,6,6,3,3,0,0,0,0,0,4,35,15,18,12,6,0
"20230215WESBLA",2023-02-15,"England Championship","West Brom","Blackburn",1,1,"D",12,10,4,4,10,12,12,5,2,1,0,0,0,0,0,2,22,8,22,17,3,0
"20230217CARREA",2023-02-17,"England Championship","Cardiff","Reading",1,0,"H",19,5,5,0,8,10,8,3,1,2,0,0,0,0,0,1,24,5,18,11,3,0
"20230218MILSHE",2023-02-18,"England Championship","Millwall","Sheffield United",3,2,"H",12,11,5,6,10,13,4,5,3,4,0,0,0,0,0,5,23,11,23,9,7,0
"20230218BLASWA",2023-02-18,"England Championship","Blackburn","Swansea",1,0,"H",8,10,3,2,10,10,6,3,4,0,0,0,0,0,0,1,18,5,20,9,4,0
"20230218BLASTO",2023-02-18,"England Championship","Blackpool","Stoke",1,0,"H",7,25,1,6,13,9,3,5,4,1,0,0,0,0,0,1,32,7,22,8,5,0
"20230218HUDBIR",2023-02-18,"England Championship","Huddersfield","Birmingham",2,1,"H",12,19,7,5,10,10,4,6,1,1,0,0,0,0,0,3,31,12,20,10,2,0
"20230218HULPRE",2023-02-18,"England Championship","Hull","Preston",0,0,"D",15,7,4,0,10,8,11,6,2,2,0,0,0,0,0,0,22,4,18,17,4,0
"20230218LUTBUR",2023-02-18,"England Championship","Luton","Burnley",0,1,"A",7,9,2,2,14,11,7,5,1,1,1,0,0,0,0,1,16,4,25,12,2,1
"20230218MIDQPR",2023-02-18,"England Championship","Middlesbrough","QPR",3,1,"H",12,9,9,2,5,12,9,9,1,0,0,0,0,0,0,4,21,11,17,18,1,0
"20230218ROTCOV",2023-02-18,"England Championship","Rotherham","Coventry",0,2,"A",11,8,1,6,9,13,4,2,2,3,0,0,0,0,0,2,19,7,22,6,5,0
"20230218SUNBRI",2023-02-18,"England Championship","Sunderland","Bristol City",1,1,"D",11,9,3,2,12,14,2,4,1,0,0,0,0,0,0,2,20,5,26,6,1,0
"20230218WIGNOR",2023-02-18,"England Championship","Wigan","Norwich",0,0,"D",11,9,6,1,10,14,3,5,2,2,0,0,0,0,0,0,20,7,24,8,4,0
"20230220WATWES",2023-02-20,"England Championship","Watford","West Brom",3,2,"H",18,18,7,4,10,13,6,6,2,2,0,0,0,0,0,5,36,11,23,12,4,0
"20230221BLABLA",2023-02-21,"England Championship","Blackburn","Blackpool",1,0,"H",13,7,3,0,12,12,8,2,3,0,0,0,0,0,0,1,20,3,24,10,3,0
"20230221MILBUR",2023-02-21,"England Championship","Millwall","Burnley",1,1,"D",12,17,3,3,7,11,3,6,1,1,0,0,0,0,0,2,29,6,18,9,2,0
"20230221NORBIR",2023-02-21,"England Championship","Norwich","Birmingham",3,1,"H",15,10,7,2,14,9,6,1,1,2,0,0,0,0,0,4,25,9,23,7,3,0
"20230221ROTSUN",2023-02-21,"England Championship","Rotherham","Sunderland",2,1,"H",7,13,3,5,7,9,4,6,2,1,0,0,0,0,0,3,20,8,16,10,3,0
"20230221SWASTO",2023-02-21,"England Championship","Swansea","Stoke",1,3,"A",12,15,6,8,12,17,5,4,4,1,0,0,0,0,0,4,27,14,29,9,5,0
"20230225COVSUN",2023-02-25,"England Championship","Coventry","Sunderland",2,1,"H",15,13,3,5,11,8,4,7,3,2,0,0,0,0,0,3,28,8,19,11,5,0
"20230225BIRLUT",2023-02-25,"England Championship","Birmingham","Luton",0,1,"A",8,11,0,5,11,9,2,7,1,1,0,0,0,0,0,1,19,5,20,9,2,0
"20230225BRIHUL",2023-02-25,"England Championship","Bristol City","Hull",1,0,"H",10,11,3,1,6,8,7,3,0,1,0,0,0,0,0,1,21,4,14,10,1,0
"20230225BURHUD",2023-02-25,"England Championship","Burnley","Huddersfield",4,0,"H",22,8,12,1,7,13,5,2,0,2,0,0,0,0,0,4,30,13,20,7,2,0
"20230225NORCAR",2023-02-25,"England Championship","Norwich","Cardiff",2,0,"H",13,9,4,2,12,9,3,5,1,1,0,0,0,0,0,2,22,6,21,8,2,0
"20230225PREWIG",2023-02-25,"England Championship","Preston","Wigan",2,1,"H",7,14,3,4,13,13,3,7,2,1,1,0,0,0,0,3,21,7,26,10,3,1
"20230225QPRBLA",2023-02-25,"England Championship","QPR","Blackburn",1,3,"A",11,9,2,5,12,10,7,1,4,0,0,0,0,0,0,4,20,7,22,8,4,0
"20230225REABLA",2023-02-25,"England Championship","Reading","Blackpool",3,1,"H",8,14,5,4,11,10,3,8,1,0,0,0,0,0,0,4,22,9,21,11,1,0
"20230225SHEWAT",2023-02-25,"England Championship","Sheffield United","Watford",1,0,"H",17,8,4,2,11,8,5,5,2,3,0,0,0,0,0,1,25,6,19,10,5,0
"20230225STOMIL",2023-02-25,"England Championship","Stoke","Millwall",0,1,"A",15,7,3,1,10,11,9,4,0,1,0,0,0,0,0,1,22,4,21,13,1,0
"20230225WESMID",2023-02-25,"England Championship","West Brom","Middlesbrough",2,0,"H",12,12,4,3,7,10,4,8,0,1,0,0,0,0,0,2,24,7,17,12,1,0
"20230227SWAROT",2023-02-27,"England Championship","Swansea","Rotherham",1,1,"D",7,14,4,5,18,11,3,6,3,2,0,0,0,0,0,2,21,9,29,9,5,0
"20230228PRECOV",2023-02-28,"England Championship","Preston","Coventry",0,0,"D",14,11,2,4,10,11,4,2,1,4,0,0,0,0,0,0,25,6,21,6,5,0
"20230228LUTMIL",2023-02-28,"England Championship","Luton","Millwall",2,2,"D",15,9,4,3,11,12,6,2,0,1,0,0,0,0,0,4,24,7,23,8,1,0
"20230303HULWES",2023-03-03,"England Championship","Hull","West Brom",2,0,"H",8,21,2,6,12,8,4,6,0,2,0,0,0,0,0,2,29,8,20,10,2,0
"20230304BLASHE",2023-03-04,"England Championship","Blackburn","Sheffield United",1,0,"H",11,14,2,4,8,11,3,8,2,3,0,0,0,0,0,1,25,6,19,11,5,0
"20230304CARBRI",2023-03-04,"England Championship","Cardiff","Bristol City",2,0,"H",11,12,4,4,8,13,3,5,0,0,1,0,0,0,0,2,23,8,21,8,0,1
"20230304BLABUR",2023-03-04,"England Championship","Blackpool","Burnley",0,0,"D",6,13,0,5,12,11,1,8,1,1,0,0,0,0,0,0,19,5,23,9,2,0
"20230304HUDCOV",2023-03-04,"England Championship","Huddersfield","Coventry",0,4,"A",14,13,3,6,10,12,5,5,0,1,0,0,0,0,0,4,27,9,22,10,1,0
"20230304LUTSWA",2023-03-04,"England Championship","Luton","Swansea",1,0,"H",16,10,4,3,17,11,4,3,2,2,0,0,0,0,0,1,26,7,28,7,4,0
"20230304MIDREA",2023-03-04,"England Championship","Middlesbrough","Reading",5,0,"H",13,3,6,0,13,13,6,1,1,2,0,0,0,0,0,5,16,6,26,7,3,0
"20230304MILNOR",2023-03-04,"England Championship","Millwall","Norwich",2,3,"A",21,9,8,5,7,11,4,4,2,3,0,0,0,0,0,5,30,13,18,8,5,0
"20230304ROTQPR",2023-03-04,"England Championship","Rotherham","QPR",3,1,"H",16,14,9,3,9,11,7,8,2,3,0,0,1,1,0,4,30,12,20,15,5,0
"20230304SUNSTO",2023-03-04,"England Championship","Sunderland","Stoke",1,5,"A",8,16,4,8,8,19,2,4,1,2,0,0,0,0,0,6,24,12,27,6,3,0
"20230304WATPRE",2023-03-04,"England Championship","Watford","Preston",0,0,"D",12,10,4,2,13,17,6,3,1,4,0,0,0,0,0,0,22,6,30,9,5,0
"20230304WIGBIR",2023-03-04,"England Championship","Wigan","Birmingham",1,1,"D",7,13,3,2,13,14,2,1,2,2,0,0,0,0,0,2,20,5,27,3,4,0
"20230307HUDBRI",2023-03-07,"England Championship","Huddersfield","Bristol City",0,0,"D",9,10,3,5,13,4,6,4,3,2,0,0,0,0,0,0,19,8,17,10,5,0
"20230307REASHE",2023-03-07,"England Championship","Reading","Sheffield United",0,1,"A",12,8,3,4,9,7,3,4,2,0,0,0,0,0,0,1,20,7,16,7,2,0
"20230307WESWIG",2023-03-07,"England Championship","West Brom","Wigan",1,0,"H",17,10,4,3,6,9,1,2,0,2,0,0,0,0,0,1,27,7,15,3,2,0
"20230310STOBLA",2023-03-10,"England Championship","Stoke","Blackburn",3,2,"H",14,9,5,2,9,10,1,5,2,2,0,0,0,0,0,5,23,7,19,6,4,0
"20230311BRIBLA",2023-03-11,"England Championship","Bristol City","Blackpool",2,0,"H",18,5,3,2,8,13,6,0,0,1,0,0,0,0,0,2,23,5,21,6,1,0
"20230311BIRROT",2023-03-11,"England Championship","Birmingham","Rotherham",2,0,"H",13,12,5,1,8,12,4,10,1,3,0,0,0,0,0,2,25,6,20,14,4,0
"20230311BURWIG",2023-03-11,"England Championship","Burnley","Wigan",3,0,"H",27,2,7,2,11,15,10,0,1,3,0,1,0,0,0,3,29,9,26,10,4,1
"20230311COVHUL",2023-03-11,"England Championship","Coventry","Hull",1,1,"D",25,11,6,3,14,12,10,3,0,0,0,0,0,0,0,2,36,9,26,13,0,0
"20230311PRECAR",2023-03-11,"England Championship","Preston","Cardiff",2,0,"H",12,13,5,4,12,9,4,4,2,1,0,1,0,0,0,2,25,9,21,8,3,1
"20230311QPRWAT",2023-03-11,"England Championship","QPR","Watford",1,0,"H",11,9,4,2,14,10,2,5,2,2,0,0,0,0,0,1,20,6,24,7,4,0
"20230311REAMIL",2023-03-11,"England Championship","Reading","Millwall",0,1,"A",2,8,0,1,15,14,2,2,1,0,0,0,0,0,0,1,10,1,29,4,1,0
"20230311SHELUT",2023-03-11,"England Championship","Sheffield United","Luton",0,1,"A",9,6,5,1,11,9,3,4,2,0,0,0,0,0,0,1,15,6,20,7,2,0
"20230311SWAMID",2023-03-11,"England Championship","Swansea","Middlesbrough",1,3,"A",14,14,5,7,9,10,4,6,2,1,0,0,0,0,0,4,28,12,19,10,3,0
"20230311WESHUD",2023-03-11,"England Championship","West Brom","Huddersfield",1,0,"H",13,4,4,1,8,13,9,2,1,0,0,0,0,0,0,1,17,5,21,11,1,0
"20230312NORSUN",2023-03-12,"England Championship","Norwich","Sunderland",0,1,"A",17,11,5,5,13,21,8,3,2,5,0,0,0,0,0,1,28,10,34,11,7,0
"20230314BLAQPR",2023-03-14,"England Championship","Blackpool","QPR",6,1,"H",16,7,8,2,8,18,6,1,1,3,0,0,0,0,0,7,23,10,26,7,4,0
"20230314MILSWA",2023-03-14,"England Championship","Millwall","Swansea",2,1,"H",9,19,3,11,8,13,5,5,1,2,0,0,0,0,0,3,28,14,21,10,3,0
"20230314ROTPRE",2023-03-14,"England Championship","Rotherham","Preston",1,2,"A",6,7,1,3,7,10,3,5,2,2,0,0,0,0,0,3,13,4,17,8,4,0
"20230314WATBIR",2023-03-14,"England Championship","Watford","Birmingham",3,0,"H",11,8,5,6,20,13,3,1,1,3,0,0,0,0,0,3,19,11,33,4,4,0
"20230314WIGCOV",2023-03-14,"England Championship","Wigan","Coventry",1,1,"D",10,18,5,7,18,11,6,4,1,1,0,0,0,0,0,2,28,12,29,10,2,0
"20230314MIDSTO",2023-03-14,"England Championship","Middlesbrough","Stoke",1,1,"D",9,11,3,5,10,15,4,6,1,4,0,0,0,0,0,2,20,8,25,10,5,0
"20230315BLAREA",2023-03-15,"England Championship","Blackburn","Reading",2,1,"H",12,9,6,4,7,7,6,4,2,2,0,1,1,0,1,3,21,10,14,10,4,1
"20230315CARWES",2023-03-15,"England Championship","Cardiff","West Brom",1,1,"D",11,8,2,3,5,7,3,5,2,2,0,0,0,0,0,2,19,5,12,8,4,0
"20230315HUDNOR",2023-03-15,"England Championship","Huddersfield","Norwich",1,1,"D",11,12,0,3,9,10,6,8,0,3,0,1,0,0,0,2,23,3,19,14,3,1
"20230315HULBUR",2023-03-15,"England Championship","Hull","Burnley",1,3,"A",14,9,6,3,8,14,3,3,1,2,0,0,0,0,0,4,23,9,22,6,3,0
"20230315LUTBRI",2023-03-15,"England Championship","Luton","Bristol City",1,0,"H",15,6,6,3,15,12,7,2,4,3,0,0,0,0,0,1,21,9,27,9,7,0
"20230315SUNSHE",2023-03-15,"England Championship","Sunderland","Sheffield United",1,2,"A",7,11,3,4,16,16,4,8,2,4,0,0,0,0,0,3,18,7,32,12,6,0
"20230318BLACOV",2023-03-18,"England Championship","Blackpool","Coventry",1,4,"A",12,18,1,7,7,12,5,4,0,3,0,0,0,0,0,5,30,8,19,9,3,0
"20230318MIDPRE",2023-03-18,"England Championship","Middlesbrough","Preston",4,0,"H",16,7,5,3,11,15,7,4,4,3,0,1,0,0,0,4,23,8,26,11,7,1
"20230318MILHUD",2023-03-18,"England Championship","Millwall","Huddersfield",0,1,"A",18,4,4,2,8,12,3,6,2,3,0,0,0,0,0,1,22,6,20,9,5,0
"20230318QPRBIR",2023-03-18,"England Championship","QPR","Birmingham",0,1,"A",16,10,2,6,16,16,10,1,4,3,0,0,0,0,0,1,26,8,32,11,7,0
"20230318REAHUL",2023-03-18,"England Championship","Reading","Hull",1,1,"D",11,12,5,4,15,18,1,9,2,1,0,0,0,0,0,2,23,9,33,10,3,0
"20230318STONOR",2023-03-18,"England Championship","Stoke","Norwich",0,0,"D",14,8,8,1,13,11,8,3,2,0,0,0,0,0,0,0,22,9,24,11,2,0
"20230318SUNLUT",2023-03-18,"England Championship","Sunderland","Luton",1,1,"D",11,7,4,3,7,16,6,2,0,4,0,0,0,0,0,2,18,7,23,8,4,0
"20230318WATWIG",2023-03-18,"England Championship","Watford","Wigan",1,1,"D",17,6,3,2,10,10,5,4,2,4,0,0,0,0,0,2,23,5,20,9,6,0
"20230319SWABRI",2023-03-19,"England Championship","Swansea","Bristol City",2,0,"H",17,6,5,3,14,6,3,7,2,2,0,0,0,0,0,2,23,8,20,10,4,0
"20230331BURSUN",2023-03-31,"England Championship","Burnley","Sunderland",0,0,"D",13,7,3,3,11,13,5,4,2,0,0,0,0,0,0,0,20,6,24,9,2,0
"20230401LUTWAT",2023-04-01,"England Championship","Luton","Watford",2,0,"H",13,2,6,1,14,12,9,3,2,3,0,0,0,0,0,2,15,7,26,12,5,0
"20230401PREBLA",2023-04-01,"England Championship","Preston","Blackpool",3,1,"H",9,12,7,5,10,13,6,8,3,3,0,0,0,0,0,4,21,12,23,14,6,0
"20230401BIRBLA",2023-04-01,"England Championship","Birmingham","Blackburn",1,0,"H",10,17,3,8,3,7,4,7,3,3,0,0,0,0,0,1,27,11,10,11,6,0
"20230401BRIREA",2023-04-01,"England Championship","Bristol City","Reading",1,1,"D",18,7,8,2,11,8,10,4,3,2,0,0,0,0,0,2,25,10,19,14,5,0
"20230401CARSWA",2023-04-01,"England Championship","Cardiff","Swansea",2,3,"A",9,10,3,4,19,11,1,3,2,5,0,0,0,0,0,5,19,7,30,4,7,0
"20230401COVSTO",2023-04-01,"England Championship","Coventry","Stoke",0,4,"A",15,26,6,11,11,6,6,6,2,0,0,0,0,0,0,4,41,17,17,12,2,0
"20230401HUDMID",2023-04-01,"England Championship","Huddersfield","Middlesbrough",4,2,"H",13,20,5,6,5,12,5,9,2,2,0,0,0,0,0,6,33,11,17,14,4,0
"20230401HULROT",2023-04-01,"England Championship","Hull","Rotherham",0,0,"D",14,4,1,0,7,14,8,8,0,2,0,1,0,0,0,0,18,1,21,16,2,1
"20230401NORSHE",2023-04-01,"England Championship","Norwich","Sheffield United",0,1,"A",7,7,1,1,13,17,4,5,3,3,0,0,0,0,0,1,14,2,30,9,6,0
"20230401WESMIL",2023-04-01,"England Championship","West Brom","Millwall",0,0,"D",16,14,1,4,13,12,6,7,2,3,0,0,0,0,0,0,30,5,25,13,5,0
"20230401WIGQPR",2023-04-01,"England Championship","Wigan","QPR",1,0,"H",8,8,4,3,12,14,2,5,2,2,0,0,0,0,0,1,16,7,26,7,4,0
"20230407MILLUT",2023-04-07,"England Championship","Millwall","Luton",0,0,"D",14,6,4,2,7,13,4,4,1,2,0,0,0,0,0,0,20,6,20,8,3,0
"20230407ROTWES",2023-04-07,"England Championship","Rotherham","West Brom",3,1,"H",23,10,10,5,13,11,8,3,2,4,0,0,0,0,0,4,33,15,24,11,6,0
"20230407BLANOR",2023-04-07,"England Championship","Blackburn","Norwich",0,2,"A",16,13,4,5,6,6,8,5,1,2,0,0,0,0,0,2,29,9,12,13,3,0
"20230407BLACAR",2023-04-07,"England Championship","Blackpool","Cardiff",1,3,"A",13,13,4,5,15,12,4,3,2,1,0,0,0,0,0,4,26,9,27,7,3,0
"20230407QPRPRE",2023-04-07,"England Championship","QPR","Preston",0,2,"A",10,12,1,6,10,6,6,6,0,1,0,0,0,0,0,2,22,7,16,12,1,0
"20230407REABIR",2023-04-07,"England Championship","Reading","Birmingham",1,1,"D",12,10,3,4,11,7,5,0,1,1,0,0,0,0,0,2,22,7,18,5,2,0
"20230407SHEWIG",2023-04-07,"England Championship","Sheffield United","Wigan",1,0,"H",22,9,4,1,14,5,9,6,2,1,0,0,0,0,0,1,31,5,19,15,3,0
"20230407STOBRI",2023-04-07,"England Championship","Stoke","Bristol City",1,2,"A",8,5,5,3,11,6,7,4,1,0,0,0,0,0,0,3,13,8,17,11,1,0
"20230407SWACOV",2023-04-07,"England Championship","Swansea","Coventry",0,0,"D",16,11,6,4,11,10,5,5,2,3,0,0,0,0,0,0,27,10,21,10,5,0
"20230407WATHUD",2023-04-07,"England Championship","Watford","Huddersfield",2,3,"A",14,8,5,4,7,10,13,3,3,2,1,0,0,0,0,5,22,9,17,16,5,1
"20230407SUNHUL",2023-04-07,"England Championship","Sunderland","Hull",4,4,"D",18,9,7,7,9,16,1,0,0,2,0,0,0,0,0,8,27,14,25,1,2,0
"20230407MIDBUR",2023-04-07,"England Championship","Middlesbrough","Burnley",1,2,"A",9,11,3,4,16,6,1,2,1,1,0,0,0,0,0,3,20,7,22,3,2,0
"20230410HUDBLA",2023-04-10,"England Championship","Huddersfield","Blackburn",2,2,"D",9,21,2,11,5,7,5,10,0,3,0,0,0,0,0,4,30,13,12,15,3,0
"20230410BIRSTO",2023-04-10,"England Championship","Birmingham","Stoke",0,0,"D",7,8,2,1,14,7,6,10,2,2,0,0,0,0,0,0,15,3,21,16,4,0
"20230410CARSUN",2023-04-10,"England Championship","Cardiff","Sunderland",0,1,"A",17,18,4,4,20,8,7,5,4,1,0,0,0,0,0,1,35,8,28,12,5,0
"20230410COVWAT",2023-04-10,"England Championship","Coventry","Watford",2,2,"D",23,7,6,4,8,14,6,4,3,5,0,0,0,0,0,4,30,10,22,10,8,0
"20230410HULMIL",2023-04-10,"England Championship","Hull","Millwall",1,0,"H",8,22,2,6,10,11,7,5,1,2,0,0,0,0,0,1,30,8,21,12,3,0
"20230410LUTBLA",2023-04-10,"England Championship","Luton","Blackpool",3,1,"H",21,11,4,5,14,9,7,5,1,2,0,0,0,0,0,4,32,9,23,12,3,0
"20230410NORROT",2023-04-10,"England Championship","Norwich","Rotherham",0,0,"D",21,6,4,2,10,14,10,3,0,1,0,0,0,0,0,0,27,6,24,13,1,0
"20230410PREREA",2023-04-10,"England Championship","Preston","Reading",2,1,"H",23,8,7,3,9,10,9,2,1,2,0,0,0,0,0,3,31,10,19,11,3,0
"20230410WESQPR",2023-04-10,"England Championship","West Brom","QPR",2,2,"D",12,14,6,2,8,12,8,4,0,1,0,0,0,0,0,4,26,8,20,12,1,0
"20230410WIGSWA",2023-04-10,"England Championship","Wigan","Swansea",0,2,"A",8,14,4,3,18,6,6,1,3,1,0,0,0,0,0,2,22,7,24,7,4,0
"20230410BRIMID",2023-04-10,"England Championship","Bristol City","Middlesbrough",2,2,"D",16,10,7,4,8,7,4,7,2,1,0,0,0,0,0,4,26,11,15,11,3,0
"20230410BURSHE",2023-04-10,"England Championship","Burnley","Sheffield United",2,0,"H",16,4,6,1,12,10,8,2,1,3,0,1,0,0,0,2,20,7,22,10,4,1
"20230414MIDNOR",2023-04-14,"England Championship","Middlesbrough","Norwich",5,1,"H",8,11,6,3,10,10,3,5,0,1,0,0,0,0,0,6,19,9,20,8,1,0
"20230415SHECAR",2023-04-15,"England Championship","Sheffield United","Cardiff",4,1,"H",13,15,7,6,8,10,5,5,3,2,0,0,0,0,0,5,28,13,18,10,5,0
"20230415BLAWIG",2023-04-15,"England Championship","Blackpool","Wigan",1,0,"H",5,14,2,2,12,12,3,7,1,2,0,0,0,0,0,1,19,4,24,10,3,0
"20230415MILPRE",2023-04-15,"England Championship","Millwall","Preston",2,0,"H",6,8,2,3,6,11,2,4,1,2,0,0,0,0,0,2,14,5,17,6,3,0
"20230415QPRCOV",2023-04-15,"England Championship","QPR","Coventry",0,3,"A",6,14,2,5,9,10,5,2,1,3,0,0,0,0,0,3,20,7,19,7,4,0
"20230415REABUR",2023-04-15,"England Championship","Reading","Burnley",0,0,"D",7,16,0,1,8,13,3,7,3,1,0,0,0,0,0,0,23,1,21,10,4,0
"20230415ROTLUT",2023-04-15,"England Championship","Rotherham","Luton",0,2,"A",4,15,0,5,17,16,2,6,2,5,0,0,0,0,0,2,19,5,33,8,7,0
"20230415STOWES",2023-04-15,"England Championship","Stoke","West Brom",1,2,"A",10,11,3,6,15,16,5,5,4,2,1,0,0,0,0,3,21,9,31,10,6,1
"20230415SUNBIR",2023-04-15,"England Championship","Sunderland","Birmingham",2,1,"H",13,14,4,5,3,19,9,2,0,2,1,0,0,0,0,3,27,9,22,11,2,1
"20230415SWAHUD",2023-04-15,"England Championship","Swansea","Huddersfield",1,0,"H",19,9,5,1,12,11,5,4,4,2,0,0,0,0,0,1,28,6,23,9,6,0
"20230415WATBRI",2023-04-15,"England Championship","Watford","Bristol City",2,0,"H",13,11,4,6,11,7,6,7,1,3,0,0,0,0,0,2,24,10,18,13,4,0
"20230415BLAHUL",2023-04-15,"England Championship","Blackburn","Hull",0,0,"D",14,11,2,3,12,6,9,3,1,2,0,0,0,0,0,0,25,5,18,12,3,0
"20230418BLAWES",2023-04-18,"England Championship","Blackpool","West Brom",0,2,"A",13,11,3,3,5,10,5,5,1,3,0,0,0,0,0,2,24,6,15,10,4,0
"20230418ROTBUR",2023-04-18,"England Championship","Rotherham","Burnley",2,2,"D",9,18,5,8,11,8,4,7,1,2,0,0,0,0,0,4,27,13,19,11,3,0
"20230418SHEBRI",2023-04-18,"England Championship","Sheffield United","Bristol City",1,0,"H",12,4,3,1,9,9,2,2,1,2,0,0,0,0,0,1,16,4,18,4,3,0
"20230418STOWIG",2023-04-18,"England Championship","Stoke","Wigan",0,1,"A",9,7,3,2,17,13,7,4,2,2,0,0,0,0,0,1,16,5,30,11,4,0
"20230418SUNHUD",2023-04-18,"England Championship","Sunderland","Huddersfield",1,1,"D",18,13,3,3,10,21,5,11,3,2,0,0,0,0,0,2,31,6,31,16,5,0
"20230418MILBIR",2023-04-18,"England Championship","Millwall","Birmingham",0,1,"A",21,7,7,4,6,9,11,4,0,2,0,0,0,0,0,1,28,11,15,15,2,0
"20230419BLACOV",2023-04-19,"England Championship","Blackburn","Coventry",1,1,"D",6,4,2,3,14,9,5,6,3,1,0,0,0,0,0,2,10,5,23,11,4,0
"20230419QPRNOR",2023-04-19,"England Championship","QPR","Norwich",1,1,"D",7,18,2,6,11,9,7,11,5,2,0,0,1,1,0,2,25,8,20,18,7,0
"20230419SWAPRE",2023-04-19,"England Championship","Swansea","Preston",4,2,"H",12,6,7,2,10,18,2,4,3,3,1,0,0,0,0,6,18,9,28,6,6,1
"20230419WATCAR",2023-04-19,"England Championship","Watford","Cardiff",1,3,"A",14,9,3,5,11,11,10,1,3,3,0,0,0,0,0,4,23,8,22,11,6,0
"20230419MIDHUL",2023-04-19,"England Championship","Middlesbrough","Hull",3,1,"H",21,7,7,3,12,6,4,3,1,1,0,0,0,0,0,4,28,10,18,7,2,0
"20230419REALUT",2023-04-19,"England Championship","Reading","Luton",1,1,"D",10,19,2,6,10,11,2,5,3,2,1,0,0,0,0,2,29,8,21,7,5,1
"20230422BIRBLA",2023-04-22,"England Championship","Birmingham","Blackpool",0,1,"A",16,12,7,4,15,13,6,7,2,1,0,0,0,0,0,1,28,11,28,13,3,0
"20230422BRIROT",2023-04-22,"England Championship","Bristol City","Rotherham",2,1,"H",9,7,5,3,8,10,7,7,2,3,0,0,0,0,0,3,16,8,18,14,5,0
"20230422BURQPR",2023-04-22,"England Championship","Burnley","QPR",1,2,"A",21,6,6,5,5,10,11,4,2,2,0,0,0,0,0,3,27,11,15,15,4,0
"20230422CARSTO",2023-04-22,"England Championship","Cardiff","Stoke",1,1,"D",7,6,4,1,3,8,6,4,3,0,0,0,0,0,0,2,13,5,11,10,3,0
"20230422COVREA",2023-04-22,"England Championship","Coventry","Reading",2,1,"H",19,11,5,3,15,12,2,4,4,4,0,0,0,0,0,3,30,8,27,6,8,0
"20230422HULWAT",2023-04-22,"England Championship","Hull","Watford",1,0,"H",2,10,1,2,14,10,2,5,3,2,0,0,0,0,0,1,12,3,24,7,5,0
"20230422NORSWA",2023-04-22,"England Championship","Norwich","Swansea",0,3,"A",8,14,2,6,8,9,2,6,1,1,1,0,0,0,0,3,22,8,17,8,2,1
"20230422WIGMIL",2023-04-22,"England Championship","Wigan","Millwall",2,1,"H",16,9,2,3,10,8,5,3,1,2,0,0,0,0,0,3,25,5,18,8,3,0
"20230422PREBLA",2023-04-22,"England Championship","Preston","Blackburn",1,1,"D",13,9,4,3,13,11,4,3,1,2,0,0,0,0,0,2,22,7,24,7,3,0
"20230423WESSUN",2023-04-23,"England Championship","West Brom","Sunderland",1,2,"A",19,13,4,6,13,13,4,5,3,3,0,0,0,0,0,3,32,10,26,9,6,0
"20230424LUTMID",2023-04-24,"England Championship","Luton","Middlesbrough",2,1,"H",8,9,3,1,10,9,4,5,2,0,0,0,0,0,0,3,17,4,19,9,2,0
"20230425BLABUR",2023-04-25,"England Championship","Blackburn","Burnley",0,1,"A",8,8,5,1,13,12,10,4,3,5,0,0,0,0,0,1,16,6,25,14,8,0
"20230426SHEWES",2023-04-26,"England Championship","Sheffield United","West Brom",2,0,"H",13,6,4,4,11,10,5,0,1,1,0,0,0,0,0,2,19,8,21,5,2,0
"20230427ROTCAR",2023-04-27,"England Championship","Rotherham","Cardiff",1,2,"A",8,13,3,6,14,8,6,4,1,0,0,0,0,0,0,3,21,9,22,10,1,0
"20230428BLAMIL",2023-04-28,"England Championship","Blackpool","Millwall",2,3,"A",13,18,3,3,12,16,7,3,2,4,0,0,0,0,0,5,31,6,28,10,6,0
"20230429BRIBUR",2023-04-29,"England Championship","Bristol City","Burnley",1,2,"A",8,14,1,7,12,9,3,3,1,0,0,0,0,0,0,3,22,8,21,6,1,0
"20230429COVBIR",2023-04-29,"England Championship","Coventry","Birmingham",2,0,"H",9,9,3,1,10,10,5,5,0,2,0,0,0,0,0,2,18,4,20,10,2,0
"20230429HULSWA",2023-04-29,"England Championship","Hull","Swansea",1,1,"D",7,10,1,2,10,10,3,5,0,2,0,0,0,0,0,2,17,3,20,8,2,0
"20230429REAWIG",2023-04-29,"England Championship","Reading","Wigan",1,1,"D",21,11,5,3,7,13,13,3,2,1,0,0,0,0,0,2,32,8,20,16,3,0
"20230429SHEPRE",2023-04-29,"England Championship","Sheffield United","Preston",4,1,"H",18,10,10,4,9,5,10,5,2,1,0,0,0,0,0,5,28,14,14,15,3,0
"20230429STOQPR",2023-04-29,"England Championship","Stoke","QPR",0,1,"A",6,4,2,4,7,10,7,0,1,3,0,0,0,0,0,1,10,6,17,7,4,0
"20230429SUNWAT",2023-04-29,"England Championship","Sunderland","Watford",2,2,"D",25,9,7,3,11,12,10,2,3,3,0,0,0,0,0,4,34,10,23,12,6,0
"20230429WESNOR",2023-04-29,"England Championship","West Brom","Norwich",2,1,"H",14,7,5,2,9,14,6,1,0,2,0,0,0,0,0,3,21,7,23,7,2,0
"20230430CARHUD",2023-04-30,"England Championship","Cardiff","Huddersfield",1,2,"A",8,20,2,4,2,8,5,9,1,0,0,0,0,0,0,3,28,6,10,14,1,0
"20230501ROTMID",2023-05-01,"England Championship","Rotherham","Middlesbrough",1,0,"H",4,7,1,1,19,7,1,11,3,1,0,1,0,0,0,1,11,2,26,12,4,1
"20230501BLALUT",2023-05-01,"England Championship","Blackburn","Luton",1,1,"D",15,13,3,4,7,8,9,4,2,0,0,0,0,0,0,2,28,7,15,13,2,0
"20230504HUDSHE",2023-05-04,"England Championship","Huddersfield","Sheffield United",1,0,"H",7,5,2,2,5,6,9,3,1,2,0,0,0,0,0,1,12,4,11,12,3,0
"20230508BIRSHE",2023-05-08,"England Championship","Birmingham","Sheffield United",1,2,"A",9,21,3,3,9,12,4,4,1,0,0,0,0,0,0,3,30,6,21,8,1,0
"20230508BURCAR",2023-05-08,"England Championship","Burnley","Cardiff",3,0,"H",18,10,7,4,9,12,5,3,1,2,0,0,0,0,0,3,28,11,21,8,3,0
"20230508HUDREA",2023-05-08,"England Championship","Huddersfield","Reading",2,0,"H",13,9,7,0,7,16,4,6,0,1,0,0,0,0,0,2,22,7,23,10,1,0
"20230508LUTHUL",2023-05-08,"England Championship","Luton","Hull",0,0,"D",8,9,2,1,11,8,7,6,1,0,0,0,0,0,0,0,17,3,19,13,1,0
"20230508MIDCOV",2023-05-08,"England Championship","Middlesbrough","Coventry",1,1,"D",8,9,3,2,6,14,7,6,1,3,0,0,0,0,0,2,17,5,20,13,4,0
"20230508MILBLA",2023-05-08,"England Championship","Millwall","Blackburn",3,4,"A",14,13,4,9,7,7,3,6,1,0,0,0,0,0,0,7,27,13,14,9,1,0
"20230508NORBLA",2023-05-08,"England Championship","Norwich","Blackpool",0,1,"A",28,12,5,6,11,7,10,4,1,0,0,0,1,1,0,1,40,11,18,14,1,0
"20230508PRESUN",2023-05-08,"England Championship","Preston","Sunderland",0,3,"A",10,16,2,7,18,1,2,7,2,0,0,0,0,0,0,3,26,9,19,9,2,0
"20230508QPRBRI",2023-05-08,"England Championship","QPR","Bristol City",0,2,"A",16,8,0,2,13,7,7,3,0,1,0,0,0,0,0,2,24,2,20,10,1,0
"20230508SWAWES",2023-05-08,"England Championship","Swansea","West Brom",3,2,"H",16,10,4,4,13,9,6,3,1,2,0,0,0,0,0,5,26,8,22,9,3,0
"20230508WATSTO",2023-05-08,"England Championship","Watford","Stoke",2,0,"H",13,15,6,7,13,17,6,6,0,2,0,0,0,0,0,2,28,13,30,12,2,0
"20230508WIGROT",2023-05-08,"England Championship","Wigan","Rotherham",0,0,"D",10,7,6,2,10,13,3,2,0,2,0,0,0,0,0,0,17,8,23,5,2,0
"20230804SHESOU",2023-08-04,"England Championship","Sheffield Weds","Southampton",1,2,"A",8,23,1,7,12,10,3,6,4,4,0,0,0,0,0,3,31,8,22,9,8,0
"20230805BLAWES",2023-08-05,"England Championship","Blackburn","West Brom",2,1,"H",12,14,3,4,11,11,6,5,4,3,0,0,0,0,0,3,26,7,22,11,7,0
"20230805BRIPRE",2023-08-05,"England Championship","Bristol City","Preston",1,1,"D",5,11,2,3,10,11,2,4,0,1,0,0,0,0,0,2,16,5,21,6,1,0
"20230805MIDMIL",2023-08-05,"England Championship","Middlesbrough","Millwall",0,1,"A",16,12,2,2,3,8,12,6,1,3,0,0,1,0,1,1,28,4,11,18,4,0
"20230805NORHUL",2023-08-05,"England Championship","Norwich","Hull",2,1,"H",28,8,5,3,14,12,9,4,2,5,0,0,0,0,0,3,36,8,26,13,7,0
"20230805PLYHUD",2023-08-05,"England Championship","Plymouth","Huddersfield",3,1,"H",14,15,7,3,9,15,2,9,1,0,0,0,0,0,0,4,29,10,24,11,1,0
"20230805STOROT",2023-08-05,"England Championship","Stoke","Rotherham",4,1,"H",15,6,6,3,12,10,10,2,5,3,0,1,0,0,0,5,21,9,22,12,8,1
"20230805SWABIR",2023-08-05,"England Championship","Swansea","Birmingham",1,1,"D",11,11,6,5,9,12,5,5,1,4,0,0,0,0,0,2,22,11,21,10,5,0
"20230805WATQPR",2023-08-05,"England Championship","Watford","QPR",4,0,"H",23,4,12,1,8,15,8,2,1,2,0,0,0,0,0,4,27,13,23,10,3,0
"20230806LEICOV",2023-08-06,"England Championship","Leicester","Coventry",2,1,"H",20,20,7,6,11,13,6,8,3,2,0,0,0,0,0,3,40,13,24,14,5,0
"20230806LEECAR",2023-08-06,"England Championship","Leeds","Cardiff",2,2,"D",25,7,6,2,8,10,10,0,2,1,0,0,0,0,0,4,32,8,18,10,3,0
"20230806SUNIPS",2023-08-06,"England Championship","Sunderland","Ipswich",1,2,"A",20,13,4,5,10,13,11,4,1,3,1,0,0,0,0,3,33,9,23,15,4,1
"20230812COVMID",2023-08-12,"England Championship","Coventry","Middlesbrough",3,0,"H",12,14,5,2,5,8,7,7,1,1,0,0,0,0,0,3,26,7,13,14,2,0
"20230812BIRLEE",2023-08-12,"England Championship","Birmingham","Leeds",1,0,"H",10,7,2,1,13,10,7,4,1,2,0,0,0,0,0,1,17,3,23,11,3,0
"20230812CARQPR",2023-08-12,"England Championship","Cardiff","QPR",1,2,"A",15,7,4,3,8,13,13,7,2,2,0,0,0,0,0,3,22,7,21,20,4,0
"20230812HUDLEI",2023-08-12,"England Championship","Huddersfield","Leicester",0,1,"A",13,17,3,6,15,8,5,4,1,4,0,0,0,0,0,1,30,9,23,9,5,0
"20230812HULSHE",2023-08-12,"England Championship","Hull","Sheffield Weds",4,2,"H",16,6,7,2,7,22,9,1,1,3,0,0,0,0,0,6,22,9,29,10,4,0
"20230812IPSSTO",2023-08-12,"England Championship","Ipswich","Stoke",2,0,"H",22,9,10,2,12,17,7,3,3,1,0,0,0,0,0,2,31,12,29,10,4,0
"20230812MILBRI",2023-08-12,"England Championship","Millwall","Bristol City",0,1,"A",10,13,2,1,13,11,1,5,1,3,0,0,0,0,0,1,23,3,24,6,4,0
"20230812PRESUN",2023-08-12,"England Championship","Preston","Sunderland",2,1,"H",11,13,2,4,17,8,5,12,3,1,0,0,0,0,0,3,24,6,25,17,4,0
"20230812ROTBLA",2023-08-12,"England Championship","Rotherham","Blackburn",2,2,"D",9,21,3,6,9,8,5,9,3,1,1,0,0,0,0,4,30,9,17,14,4,1
"20230812SOUNOR",2023-08-12,"England Championship","Southampton","Norwich",4,4,"D",31,15,11,6,12,13,13,4,7,4,0,0,0,0,0,8,46,17,25,17,11,0
"20230812WATPLY",2023-08-12,"England Championship","Watford","Plymouth",0,0,"D",20,13,3,5,16,10,12,3,0,2,0,0,0,0,0,0,33,8,26,15,2,0
"20230812WESSWA",2023-08-12,"England Championship","West Brom","Swansea",3,2,"H",11,13,3,4,10,10,4,8,3,4,0,0,0,0,0,5,24,7,20,12,7,0
"20230818LEEWES",2023-08-18,"England Championship","Leeds","West Brom",1,1,"D",16,4,4,2,10,9,4,3,4,5,0,0,0,0,0,2,20,6,19,7,9,0
"20230819PLYSOU",2023-08-19,"England Championship","Plymouth","Southampton",1,2,"A",15,19,2,9,11,15,5,10,2,4,0,0,0,0,0,3,34,11,26,15,6,0
"20230819BLAHUL",2023-08-19,"England Championship","Blackburn","Hull",1,2,"A",14,19,3,5,12,7,2,8,1,3,1,0,0,0,0,3,33,8,19,10,4,1
"20230819BRIBIR",2023-08-19,"England Championship","Bristol City","Birmingham",0,2,"A",19,16,0,6,12,10,8,4,0,2,1,0,0,0,0,2,35,6,22,12,2,1
"20230819LEICAR",2023-08-19,"England Championship","Leicester","Cardiff",2,1,"H",15,10,6,4,11,10,10,4,1,4,0,1,0,0,0,3,25,10,21,14,5,1
"20230819MIDHUD",2023-08-19,"England Championship","Middlesbrough","Huddersfield",1,1,"D",17,16,7,2,10,10,7,8,1,3,0,0,0,0,0,2,33,9,20,15,4,0
"20230819QPRIPS",2023-08-19,"England Championship","QPR","Ipswich",0,1,"A",10,16,4,3,15,10,5,4,4,1,0,0,0,0,0,1,26,7,25,9,5,0
"20230819SHEPRE",2023-08-19,"England Championship","Sheffield Weds","Preston",0,1,"A",8,5,3,2,14,16,0,4,1,1,0,0,0,0,0,1,13,5,30,4,2,0
"20230819STOWAT",2023-08-19,"England Championship","Stoke","Watford",1,0,"H",13,10,2,3,21,10,7,2,4,1,0,0,0,0,0,1,23,5,31,9,5,0
"20230819SUNROT",2023-08-19,"England Championship","Sunderland","Rotherham",2,1,"H",11,4,4,1,11,10,5,0,2,1,0,0,0,0,0,3,15,5,21,5,3,0
"20230819SWACOV",2023-08-19,"England Championship","Swansea","Coventry",1,1,"D",7,11,3,2,12,10,3,8,2,1,0,0,0,0,0,2,18,5,22,11,3,0
"20230820NORMIL",2023-08-20,"England Championship","Norwich","Millwall",3,1,"H",20,10,5,2,3,13,6,3,2,1,0,0,0,0,0,4,30,7,16,9,3,0
"20230825HULBRI",2023-08-25,"England Championship","Hull","Bristol City",1,1,"D",13,19,9,5,5,13,4,5,1,2,0,0,0,0,0,2,32,14,18,9,3,0
"20230826BIRPLY",2023-08-26,"England Championship","Birmingham","Plymouth",2,1,"H",13,16,4,8,17,5,10,10,2,1,0,0,0,0,0,3,29,12,22,20,3,0
"20230826CARSHE",2023-08-26,"England Championship","Cardiff","Sheffield Weds",2,1,"H",12,11,4,2,6,20,5,10,0,5,0,0,0,0,0,3,23,6,26,15,5,0
"20230826COVSUN",2023-08-26,"England Championship","Coventry","Sunderland",0,0,"D",17,15,6,2,11,7,4,7,1,4,0,0,0,0,0,0,32,8,18,11,5,0
"20230826HUDNOR",2023-08-26,"England Championship","Huddersfield","Norwich",0,4,"A",18,9,5,5,10,8,5,3,3,1,0,0,0,0,0,4,27,10,18,8,4,0
"20230826IPSLEE",2023-08-26,"England Championship","Ipswich","Leeds",3,4,"A",21,14,6,9,12,8,8,4,3,2,0,0,0,0,0,7,35,15,20,12,5,0
"20230826MILSTO",2023-08-26,"England Championship","Millwall","Stoke",1,0,"H",17,20,7,2,15,7,6,7,1,5,0,0,0,0,0,1,37,9,22,13,6,0
"20230826PRESWA",2023-08-26,"England Championship","Preston","Swansea",2,1,"H",11,10,3,1,12,7,6,4,2,1,0,0,0,0,0,3,21,4,19,10,3,0
"20230826ROTLEI",2023-08-26,"England Championship","Rotherham","Leicester",1,2,"A",8,15,1,7,15,10,5,4,2,2,0,0,0,0,0,3,23,8,25,9,4,0
"20230826SOUQPR",2023-08-26,"England Championship","Southampton","QPR",2,1,"H",7,11,3,5,8,14,4,3,4,2,0,0,0,0,0,3,18,8,22,7,6,0
"20230826WESMID",2023-08-26,"England Championship","West Brom","Middlesbrough",4,2,"H",7,15,4,5,10,9,4,2,2,1,0,1,0,0,0,6,22,9,19,6,3,1
"20230827WATBLA",2023-08-27,"England Championship","Watford","Blackburn",0,1,"A",24,5,4,3,8,5,8,4,3,2,0,0,0,0,0,1,29,7,13,12,5,0
"20230902BIRMIL",2023-09-02,"England Championship","Birmingham","Millwall",1,1,"D",17,9,4,3,9,18,1,3,1,2,0,0,0,0,0,2,26,7,27,4,3,0
"20230902SUNSOU",2023-09-02,"England Championship","Sunderland","Southampton",5,0,"H",18,13,10,2,20,10,5,8,2,2,0,0,0,0,0,5,31,12,30,13,4,0
"20230902SWABRI",2023-09-02,"England Championship","Swansea","Bristol City",1,2,"A",12,16,4,4,13,17,4,8,3,2,0,0,0,0,0,3,28,8,30,12,5,0
"20230902COVWAT",2023-09-02,"England Championship","Coventry","Watford",3,3,"D",16,14,7,5,10,16,9,6,3,3,0,0,0,0,0,6,30,12,26,15,6,0
"20230902IPSCAR",2023-09-02,"England Championship","Ipswich","Cardiff",3,2,"H",19,13,7,5,7,14,6,3,4,3,0,0,0,0,0,5,32,12,21,9,7,0
"20230902LEESHE",2023-09-02,"England Championship","Leeds","Sheffield Weds",0,0,"D",16,10,4,5,8,9,5,3,1,2,0,0,0,0,0,0,26,9,17,8,3,0
"20230902LEIHUL",2023-09-02,"England Championship","Leicester","Hull",0,1,"A",21,7,1,4,16,12,8,3,3,5,0,0,0,0,0,1,28,5,28,11,8,0
"20230902MIDQPR",2023-09-02,"England Championship","Middlesbrough","QPR",0,2,"A",16,11,9,3,9,11,7,5,1,2,0,0,0,0,0,2,27,12,20,12,3,0
"20230902PLYBLA",2023-09-02,"England Championship","Plymouth","Blackburn",3,0,"H",23,20,9,4,5,6,9,9,2,1,0,0,0,0,0,3,43,13,11,18,3,0
"20230902ROTNOR",2023-09-02,"England Championship","Rotherham","Norwich",2,1,"H",9,17,3,5,12,10,2,6,2,1,0,0,0,0,0,3,26,8,22,8,3,0
"20230902STOPRE",2023-09-02,"England Championship","Stoke","Preston",0,2,"A",18,7,1,3,15,17,9,0,3,4,0,0,0,0,0,2,25,4,32,9,7,0
"20230902WESHUD",2023-09-02,"England Championship","West Brom","Huddersfield",1,2,"A",10,14,5,4,9,9,4,9,1,1,0,0,0,0,0,3,24,9,18,13,2,0
"20230915HULCOV",2023-09-15,"England Championship","Hull","Coventry",1,1,"D",18,8,4,2,7,21,9,3,2,5,0,0,2,0,2,2,26,6,28,12,7,0
"20230915SOULEI",2023-09-15,"England Championship","Southampton","Leicester",1,4,"A",19,15,8,8,11,12,9,3,2,4,1,0,0,0,0,5,34,16,23,12,6,1
"20230916BLAMID",2023-09-16,"England Championship","Blackburn","Middlesbrough",2,1,"H",15,21,8,6,11,10,5,9,1,2,0,0,0,0,0,3,36,14,21,14,3,0
"20230916BRIWES",2023-09-16,"England Championship","Bristol City","West Brom",0,0,"D",14,14,3,0,10,5,7,7,2,2,0,0,0,0,0,0,28,3,15,14,4,0
"20230916HUDROT",2023-09-16,"England Championship","Huddersfield","Rotherham",2,0,"H",15,7,5,3,10,17,2,5,1,1,0,0,0,0,0,2,22,8,27,7,2,0
"20230916NORSTO",2023-09-16,"England Championship","Norwich","Stoke",1,0,"H",13,13,5,2,7,14,5,3,2,2,0,0,0,0,0,1,26,7,21,8,4,0
"20230916PREPLY",2023-09-16,"England Championship","Preston","Plymouth",2,1,"H",9,18,5,7,14,11,4,14,3,1,0,0,0,0,0,3,27,12,25,18,4,0
"20230916QPRSUN",2023-09-16,"England Championship","QPR","Sunderland",1,3,"A",5,22,3,8,12,3,0,8,2,0,1,0,0,0,0,4,27,11,15,8,2,1
"20230916SHEIPS",2023-09-16,"England Championship","Sheffield Weds","Ipswich",0,1,"A",6,13,0,6,17,13,7,1,3,4,0,0,0,0,0,1,19,6,30,8,7,0
"20230916WATBIR",2023-09-16,"England Championship","Watford","Birmingham",2,0,"H",12,8,4,3,16,17,8,1,1,5,0,1,0,0,0,2,20,7,33,9,6,1
"20230916CARSWA",2023-09-16,"England Championship","Cardiff","Swansea",2,0,"H",13,9,7,3,13,11,2,2,1,1,0,0,0,0,0,2,22,10,24,4,2,0
"20230917MILLEE",2023-09-17,"England Championship","Millwall","Leeds",0,3,"A",12,14,3,3,13,9,8,9,0,0,0,0,0,0,0,3,26,6,22,17,0,0
"20230919BRIPLY",2023-09-19,"England Championship","Bristol City","Plymouth",4,1,"H",17,6,6,2,9,13,7,1,3,0,0,0,0,0,0,5,23,8,22,8,3,0
"20230919CARCOV",2023-09-19,"England Championship","Cardiff","Coventry",3,2,"H",8,7,3,3,7,8,3,5,2,3,0,0,0,0,0,5,15,6,15,8,5,0
"20230919PREBIR",2023-09-19,"England Championship","Preston","Birmingham",2,1,"H",10,16,3,4,11,13,5,2,2,1,0,0,0,0,0,3,26,7,24,7,3,0
"20230919QPRSWA",2023-09-19,"England Championship","QPR","Swansea",1,1,"D",11,8,3,3,12,17,4,6,1,1,0,1,0,0,0,2,19,6,29,10,2,1
"20230919SOUIPS",2023-09-19,"England Championship","Southampton","Ipswich",0,1,"A",13,11,3,3,9,13,9,3,2,2,0,0,0,0,0,1,24,6,22,12,4,0
"20230919SHEMID",2023-09-19,"England Championship","Sheffield Weds","Middlesbrough",1,1,"D",9,10,2,3,13,8,3,4,2,1,0,0,0,0,0,2,19,5,21,7,3,0
"20230920BLASUN",2023-09-20,"England Championship","Blackburn","Sunderland",1,3,"A",22,13,6,4,14,11,8,4,5,3,0,0,0,0,0,4,35,10,25,12,8,0
"20230920HUDSTO",2023-09-20,"England Championship","Huddersfield","Stoke",2,2,"D",10,18,6,3,10,6,5,8,2,2,0,0,0,0,0,4,28,9,16,13,4,0
"20230920HULLEE",2023-09-20,"England Championship","Hull","Leeds",0,0,"D",9,17,0,4,7,15,5,6,3,2,0,1,0,0,0,0,26,4,22,11,5,1
"20230920MILROT",2023-09-20,"England Championship","Millwall","Rotherham",3,0,"H",20,5,8,1,12,16,6,1,1,1,0,0,0,0,0,3,25,9,28,7,2,0
"20230920WATWES",2023-09-20,"England Championship","Watford","West Brom",2,2,"D",12,7,4,5,8,9,3,2,2,1,0,0,0,0,0,4,19,9,17,5,3,0
"20230920NORLEI",2023-09-20,"England Championship","Norwich","Leicester",0,2,"A",15,10,2,3,14,15,10,1,3,4,0,0,0,0,0,2,25,5,29,11,7,0
"20230922BIRQPR",2023-09-22,"England Championship","Birmingham","QPR",0,0,"D",12,8,4,4,13,13,6,7,3,2,0,0,0,0,0,0,20,8,26,13,5,0
"20230923IPSBLA",2023-09-23,"England Championship","Ipswich","Blackburn",4,3,"H",29,10,11,5,10,13,10,5,3,4,0,0,0,0,0,7,39,16,23,15,7,0
"20230923LEEWAT",2023-09-23,"England Championship","Leeds","Watford",3,0,"H",17,4,10,1,13,15,8,1,1,3,0,0,0,0,0,3,21,11,28,9,4,0
"20230923LEIBRI",2023-09-23,"England Championship","Leicester","Bristol City",1,0,"H",19,6,7,1,11,10,9,0,1,2,0,0,0,0,0,1,25,8,21,9,3,0
"20230923MIDSOU",2023-09-23,"England Championship","Middlesbrough","Southampton",2,1,"H",14,15,5,5,16,7,5,7,3,0,0,0,0,0,0,3,29,10,23,12,3,0
"20230923PLYNOR",2023-09-23,"England Championship","Plymouth","Norwich",6,2,"H",16,11,10,6,9,6,3,6,1,0,0,0,0,0,0,8,27,16,15,9,1,0
"20230923ROTPRE",2023-09-23,"England Championship","Rotherham","Preston",1,1,"D",3,14,1,6,7,6,2,10,3,2,0,0,0,0,0,2,17,7,13,12,5,0
"20230923SWASHE",2023-09-23,"England Championship","Swansea","Sheffield Weds",3,0,"H",12,10,4,1,12,16,2,5,2,2,0,0,0,0,0,3,22,5,28,7,4,0
"20230923WESMIL",2023-09-23,"England Championship","West Brom","Millwall",0,0,"D",16,7,3,2,8,12,6,8,0,2,0,0,0,0,0,0,23,5,20,14,2,0
"20230924STOHUL",2023-09-24,"England Championship","Stoke","Hull",1,3,"A",10,13,6,5,18,9,11,6,2,3,0,0,0,0,0,4,23,11,27,17,5,0
"20230924SUNCAR",2023-09-24,"England Championship","Sunderland","Cardiff",0,1,"A",16,7,6,2,6,14,4,4,2,2,0,0,0,0,0,1,23,8,20,8,4,0
"20230925COVHUD",2023-09-25,"England Championship","Coventry","Huddersfield",1,1,"D",11,10,3,4,12,14,10,4,2,3,0,0,0,0,0,2,21,7,26,14,5,0
"20230929SHESUN",2023-09-29,"England Championship","Sheffield Weds","Sunderland",0,3,"A",8,12,2,6,14,5,2,5,2,0,0,0,0,0,0,3,20,8,19,7,2,0
"20230930SOULEE",2023-09-30,"England Championship","Southampton","Leeds",3,1,"H",10,15,5,5,14,13,5,6,4,1,0,0,0,0,0,4,25,10,27,11,5,0
"20230930BRISTO",2023-09-30,"England Championship","Bristol City","Stoke",2,3,"A",13,6,5,4,9,13,11,3,1,1,0,0,0,0,0,5,19,9,22,14,2,0
"20230930CARROT",2023-09-30,"England Championship","Cardiff","Rotherham",2,0,"H",12,7,5,0,4,11,6,5,2,0,0,0,0,0,0,2,19,5,15,11,2,0
"20230930HUDIPS",2023-09-30,"England Championship","Huddersfield","Ipswich",1,1,"D",12,20,6,6,10,11,5,6,3,3,0,0,0,0,0,2,32,12,21,11,6,0
"20230930HULPLY",2023-09-30,"England Championship","Hull","Plymouth",1,1,"D",21,11,5,5,9,10,12,4,2,2,0,0,0,0,0,2,32,10,19,16,4,0
"20230930MILSWA",2023-09-30,"England Championship","Millwall","Swansea",0,3,"A",22,7,5,5,18,10,6,0,2,2,0,0,0,0,0,3,29,10,28,6,4,0
"20230930NORBIR",2023-09-30,"England Championship","Norwich","Birmingham",2,0,"H",16,12,4,2,9,10,4,4,1,1,0,0,0,0,0,2,28,6,19,8,2,0
"20230930PREWES",2023-09-30,"England Championship","Preston","West Brom",0,4,"A",5,19,1,6,12,5,2,6,3,1,0,0,0,0,0,4,24,7,17,8,4,0
"20230930QPRCOV",2023-09-30,"England Championship","QPR","Coventry",1,3,"A",12,15,3,6,11,14,4,5,4,2,0,0,0,0,0,4,27,9,25,9,6,0
"20230930WATMID",2023-09-30,"England Championship","Watford","Middlesbrough",2,3,"A",17,9,4,3,10,15,9,3,2,0,0,0,0,0,0,5,26,7,25,12,2,0
"20231001BLALEI",2023-10-01,"England Championship","Blackburn","Leicester",1,4,"A",15,11,4,4,8,14,5,6,2,3,0,0,0,0,0,5,26,8,22,11,5,0
"20231003BIRHUD",2023-10-03,"England Championship","Birmingham","Huddersfield",4,1,"H",12,17,6,6,14,13,3,5,3,1,0,0,0,0,0,5,29,12,27,8,4,0
"20231003IPSHUL",2023-10-03,"England Championship","Ipswich","Hull",3,0,"H",14,13,6,6,16,11,6,5,0,0,0,0,0,0,0,3,27,12,27,11,0,0
"20231003MIDCAR",2023-10-03,"England Championship","Middlesbrough","Cardiff",2,0,"H",11,6,6,3,10,10,8,2,1,3,0,0,0,0,0,2,17,9,20,10,4,0
"20231003PLYMIL",2023-10-03,"England Championship","Plymouth","Millwall",0,2,"A",22,9,6,3,5,14,8,1,2,6,0,0,0,0,0,2,31,9,19,9,8,0
"20231003STOSOU",2023-10-03,"England Championship","Stoke","Southampton",0,1,"A",15,9,2,4,17,2,8,6,4,1,0,0,0,0,0,1,24,6,19,14,5,0
"20231003WESSHE",2023-10-03,"England Championship","West Brom","Sheffield Weds",1,0,"H",17,4,3,2,2,12,10,4,0,1,0,0,0,0,0,1,21,5,14,14,1,0
"20231004COVBLA",2023-10-04,"England Championship","Coventry","Blackburn",1,0,"H",14,14,3,4,18,13,7,8,2,1,0,0,0,0,0,1,28,7,31,15,3,0
"20231004LEEQPR",2023-10-04,"England Championship","Leeds","QPR",1,0,"H",16,5,3,2,9,12,8,0,0,2,0,1,0,0,0,1,21,5,21,8,2,1
"20231004LEIPRE",2023-10-04,"England Championship","Leicester","Preston",3,0,"H",9,6,4,1,3,8,4,4,0,2,0,0,0,0,0,3,15,5,11,8,2,0
"20231004SUNWAT",2023-10-04,"England Championship","Sunderland","Watford",2,0,"H",9,11,4,4,9,19,5,2,1,5,0,1,0,0,0,2,20,8,28,7,6,1
"20231004SWANOR",2023-10-04,"England Championship","Swansea","Norwich",2,1,"H",23,14,7,5,12,12,8,7,4,2,0,0,0,0,0,3,37,12,24,15,6,0
"20231004ROTBRI",2023-10-04,"England Championship","Rotherham","Bristol City",1,2,"A",8,9,1,5,3,7,4,4,1,1,0,0,0,0,0,3,17,6,10,8,2,0
"20231006BIRWES",2023-10-06,"England Championship","Birmingham","West Brom",3,1,"H",11,10,3,3,16,6,6,8,2,1,0,0,0,0,0,4,21,6,22,14,3,0
"20231007SUNMID",2023-10-07,"England Championship","Sunderland","Middlesbrough",0,4,"A",9,19,3,7,14,13,4,8,3,2,1,0,0,0,0,4,28,10,27,12,5,1
"20231007CARWAT",2023-10-07,"England Championship","Cardiff","Watford",1,1,"D",8,8,2,1,9,10,2,1,0,2,0,0,0,0,0,2,16,3,19,3,2,0
"20231007COVNOR",2023-10-07,"England Championship","Coventry","Norwich",1,1,"D",21,6,3,2,11,13,8,0,1,1,0,0,0,0,0,2,27,5,24,8,2,0
"20231007IPSPRE",2023-10-07,"England Championship","Ipswich","Preston",4,2,"H",16,8,10,2,10,11,7,0,0,3,0,0,0,0,0,6,24,12,21,7,3,0
"20231007LEEBRI",2023-10-07,"England Championship","Leeds","Bristol City",2,1,"H",21,9,8,2,10,8,8,6,1,2,0,0,0,0,0,3,30,10,18,14,3,0
"20231007LEISTO",2023-10-07,"England Championship","Leicester","Stoke",2,0,"H",14,3,7,1,6,5,4,4,1,1,0,0,0,0,0,2,17,8,11,8,2,0
"20231007MILHUL",2023-10-07,"England Championship","Millwall","Hull",2,2,"D",13,8,4,3,18,7,5,1,4,2,0,0,0,0,0,4,21,7,25,6,6,0
"20231007PLYSWA",2023-10-07,"England Championship","Plymouth","Swansea",1,3,"A",16,14,7,6,11,5,12,7,2,0,0,0,0,0,0,4,30,13,16,19,2,0
"20231007QPRBLA",2023-10-07,"England Championship","QPR","Blackburn",0,4,"A",21,17,6,7,13,10,10,7,2,2,0,0,0,0,0,4,38,13,23,17,4,0
"20231007SHEHUD",2023-10-07,"England Championship","Sheffield Weds","Huddersfield",0,0,"D",6,7,1,0,16,13,5,4,1,1,0,0,0,0,0,0,13,1,29,9,2,0
"20231007SOUROT",2023-10-07,"England Championship","Southampton","Rotherham",1,1,"D",22,4,10,2,8,13,12,4,2,6,0,0,0,0,0,2,26,12,21,16,8,0
"20231021PREMIL",2023-10-21,"England Championship","Preston","Millwall",1,1,"D",7,7,2,4,13,15,5,2,4,1,0,0,0,0,0,2,14,6,28,7,5,0
"20231021BLACAR",2023-10-21,"England Championship","Blackburn","Cardiff",1,0,"H",9,11,1,2,8,8,4,6,2,1,0,0,0,0,0,1,20,3,16,10,3,0
"20231021BRICOV",2023-10-21,"England Championship","Bristol City","Coventry",1,0,"H",6,12,3,1,15,11,2,15,2,3,0,0,0,0,0,1,18,4,26,17,5,0
"20231021HUDQPR",2023-10-21,"England Championship","Huddersfield","QPR",2,1,"H",6,14,4,2,9,12,2,9,2,2,0,0,1,0,1,3,20,6,21,11,4,0
"20231021HULSOU",2023-10-21,"England Championship","Hull","Southampton",1,2,"A",13,18,3,5,13,14,7,9,4,3,0,0,1,0,1,3,31,8,27,16,7,0
"20231021MIDBIR",2023-10-21,"England Championship","Middlesbrough","Birmingham",1,0,"H",17,5,10,3,9,17,12,0,3,3,0,0,0,0,0,1,22,13,26,12,6,0
"20231021NORLEE",2023-10-21,"England Championship","Norwich","Leeds",2,3,"A",14,19,4,8,11,13,7,7,2,3,0,0,0,0,0,5,33,12,24,14,5,0
"20231021STOSUN",2023-10-21,"England Championship","Stoke","Sunderland",2,1,"H",11,18,4,7,17,9,6,2,5,4,0,0,0,0,0,3,29,11,26,8,9,0
"20231021SWALEI",2023-10-21,"England Championship","Swansea","Leicester",1,3,"A",11,18,4,7,10,5,3,3,2,3,0,0,0,0,0,4,29,11,15,6,5,0
"20231021WATSHE",2023-10-21,"England Championship","Watford","Sheffield Weds",1,0,"H",12,10,3,2,15,6,4,5,2,1,0,0,0,0,0,1,22,5,21,9,3,0
"20231021WESPLY",2023-10-21,"England Championship","West Brom","Plymouth",0,0,"D",14,5,2,2,4,14,10,5,2,7,0,0,0,0,0,0,19,4,18,15,9,0
"20231024HUDCAR",2023-10-24,"England Championship","Huddersfield","Cardiff",0,4,"A",19,15,6,7,7,19,9,6,1,3,0,0,0,0,0,4,34,13,26,15,4,0
"20231024MILBLA",2023-10-24,"England Championship","Millwall","Blackburn",1,2,"A",16,9,3,6,6,6,11,3,0,1,0,0,0,0,0,3,25,9,12,14,1,0
"20231024NORMID",2023-10-24,"England Championship","Norwich","Middlesbrough",1,2,"A",13,19,2,8,13,10,4,7,2,2,0,0,0,0,0,3,32,10,23,11,4,0
"20231024SWAWAT",2023-10-24,"England Championship","Swansea","Watford",0,1,"A",9,12,3,5,7,14,6,4,0,3,0,0,0,0,0,1,21,8,21,10,3,0
"20231024LEISUN",2023-10-24,"England Championship","Leicester","Sunderland",1,0,"H",8,13,5,3,13,10,5,5,4,3,0,0,0,0,0,1,21,8,23,10,7,0
"20231024WESQPR",2023-10-24,"England Championship","West Brom","QPR",2,0,"H",16,1,4,0,8,12,6,2,1,3,0,1,0,0,0,2,17,4,20,8,4,1
"20231025BIRHUL",2023-10-25,"England Championship","Birmingham","Hull",0,2,"A",14,17,4,8,18,8,6,5,2,1,0,0,0,0,0,2,31,12,26,11,3,0
"20231025BRIIPS",2023-10-25,"England Championship","Bristol City","Ipswich",0,1,"A",11,19,4,6,11,15,5,2,0,4,0,0,0,0,0,1,30,10,26,7,4,0
"20231025PLYSHE",2023-10-25,"England Championship","Plymouth","Sheffield Weds",3,0,"H",13,13,6,2,10,8,1,7,2,1,0,0,0,0,0,3,26,8,18,8,3,0
"20231025PRESOU",2023-10-25,"England Championship","Preston","Southampton",2,2,"D",12,13,5,5,16,13,7,2,3,2,0,0,0,0,0,4,25,10,29,9,5,0
"20231025ROTCOV",2023-10-25,"England Championship","Rotherham","Coventry",2,0,"H",20,23,7,7,4,6,6,16,2,1,0,0,0,0,0,2,43,14,10,22,3,0
"20231025STOLEE",2023-10-25,"England Championship","Stoke","Leeds",1,0,"H",12,16,4,3,16,11,5,3,1,3,0,0,0,0,0,1,28,7,27,8,4,0
"20231028LEEHUD",2023-10-28,"England Championship","Leeds","Huddersfield",4,1,"H",20,5,5,2,7,11,4,2,0,4,0,0,0,0,0,5,25,7,18,6,4,0
"20231028SOUBIR",2023-10-28,"England Championship","Southampton","Birmingham",3,1,"H",11,10,5,2,8,12,4,4,0,4,0,0,0,0,0,4,21,7,20,8,4,0
"20231028BLASWA",2023-10-28,"England Championship","Blackburn","Swansea",0,1,"A",20,16,6,4,15,7,6,5,5,3,0,0,0,0,0,1,36,10,22,11,8,0
"20231028CARBRI",2023-10-28,"England Championship","Cardiff","Bristol City",2,0,"H",9,8,7,1,9,9,4,3,1,2,0,0,0,0,0,2,17,8,18,7,3,0
"20231028HULPRE",2023-10-28,"England Championship","Hull","Preston",1,0,"H",19,11,6,4,13,13,7,2,3,3,0,0,0,0,0,1,30,10,26,9,6,0
"20231028IPSPLY",2023-10-28,"England Championship","Ipswich","Plymouth",3,2,"H",15,10,4,6,11,7,11,3,4,2,0,0,0,0,0,5,25,10,18,14,6,0
"20231028MIDSTO",2023-10-28,"England Championship","Middlesbrough","Stoke",0,2,"A",9,13,3,6,12,16,8,4,2,2,0,0,0,0,0,2,22,9,28,12,4,0
"20231028QPRLEI",2023-10-28,"England Championship","QPR","Leicester",1,2,"A",9,16,3,5,13,7,1,8,1,2,1,0,0,0,0,3,25,8,20,9,3,1
"20231028SUNNOR",2023-10-28,"England Championship","Sunderland","Norwich",3,1,"H",17,9,8,2,12,17,7,1,4,4,0,0,0,0,0,4,26,10,29,8,8,0
"20231028WATMIL",2023-10-28,"England Championship","Watford","Millwall",2,2,"D",19,11,6,4,13,13,7,2,3,3,0,0,0,0,0,4,30,10,26,9,6,0
"20231029SHEROT",2023-10-29,"England Championship","Sheffield Weds","Rotherham",2,0,"H",14,6,5,0,9,16,4,3,2,3,0,0,0,0,0,2,20,5,25,7,5,0
"20231030COVWES",2023-10-30,"England Championship","Coventry","West Brom",0,2,"A",15,7,3,3,9,7,5,5,2,6,0,0,0,0,0,2,22,6,16,10,8,0
"20231103LEILEE",2023-11-03,"England Championship","Leicester","Leeds",0,1,"A",10,11,1,6,6,8,7,6,1,2,0,0,0,0,0,1,21,7,14,13,3,0
"20231104BIRIPS",2023-11-04,"England Championship","Birmingham","Ipswich",2,2,"D",13,17,3,7,9,11,7,8,3,1,0,0,0,0,0,4,30,10,20,15,4,0
"20231104BRISHE",2023-11-04,"England Championship","Bristol City","Sheffield Weds",1,0,"H",17,6,7,2,10,14,8,7,3,1,0,1,0,0,0,1,23,9,24,15,4,1
"20231104HUDWAT",2023-11-04,"England Championship","Huddersfield","Watford",0,0,"D",5,9,2,3,6,20,1,3,0,2,0,0,0,0,0,0,14,5,26,4,2,0
"20231104MILSOU",2023-11-04,"England Championship","Millwall","Southampton",0,1,"A",7,16,1,8,10,10,5,12,2,2,0,0,0,0,0,1,23,9,20,17,4,0
"20231104PLYMID",2023-11-04,"England Championship","Plymouth","Middlesbrough",3,3,"D",10,20,5,11,15,15,8,6,2,3,0,0,0,0,0,6,30,16,30,14,5,0
"20231104PRECOV",2023-11-04,"England Championship","Preston","Coventry",3,2,"H",16,18,7,8,14,15,6,8,2,2,0,0,0,0,0,5,34,15,29,14,4,0
"20231104ROTQPR",2023-11-04,"England Championship","Rotherham","QPR",1,1,"D",8,11,3,4,10,14,6,6,2,1,0,0,0,0,0,2,19,7,24,12,3,0
"20231104STOCAR",2023-11-04,"England Championship","Stoke","Cardiff",0,0,"D",7,11,1,3,16,6,1,7,1,0,0,0,0,0,0,0,18,4,22,8,1,0
"20231104SWASUN",2023-11-04,"England Championship","Swansea","Sunderland",0,0,"D",3,25,2,3,13,12,2,8,2,3,1,0,0,0,0,0,28,5,25,10,5,1
"20231104WESHUL",2023-11-04,"England Championship","West Brom","Hull",3,1,"H",10,9,5,4,10,12,1,2,1,1,0,0,0,0,0,4,19,9,22,3,2,0
"20231105NORBLA",2023-11-05,"England Championship","Norwich","Blackburn",1,3,"A",21,10,8,4,11,4,8,2,3,2,0,1,0,0,0,4,31,12,15,10,5,1
"20231107ROTIPS",2023-11-07,"England Championship","Rotherham","Ipswich",2,2,"D",8,13,3,3,12,10,6,8,1,1,0,0,0,0,0,4,21,6,22,14,2,0
"20231110BLAPRE",2023-11-10,"England Championship","Blackburn","Preston",1,2,"A",22,9,5,4,9,13,7,2,0,1,0,0,0,0,0,3,31,9,22,9,1,0
"20231111SUNBIR",2023-11-11,"England Championship","Sunderland","Birmingham",3,1,"H",22,16,6,7,5,13,10,5,2,2,0,0,0,0,0,4,38,13,18,15,4,0
"20231111CARNOR",2023-11-11,"England Championship","Cardiff","Norwich",2,3,"A",13,20,6,8,10,6,2,9,2,2,0,0,0,0,0,5,33,14,16,11,4,0
"20231111COVSTO",2023-11-11,"England Championship","Coventry","Stoke",0,0,"D",13,6,2,2,14,16,4,4,1,1,0,0,0,0,0,0,19,4,30,8,2,0
"20231111HULHUD",2023-11-11,"England Championship","Hull","Huddersfield",1,0,"H",20,2,5,1,10,10,9,1,2,3,0,0,0,0,0,1,22,6,20,10,5,0
"20231111IPSSWA",2023-11-11,"England Championship","Ipswich","Swansea",3,2,"H",22,7,9,4,15,9,6,2,2,1,0,1,0,0,0,5,29,13,24,8,3,1
"20231111LEEPLY",2023-11-11,"England Championship","Leeds","Plymouth",2,1,"H",14,9,6,3,10,10,7,6,1,4,0,0,0,0,0,3,23,9,20,13,5,0
"20231111MIDLEI",2023-11-11,"England Championship","Middlesbrough","Leicester",1,0,"H",9,12,6,4,18,15,3,4,4,3,0,0,0,0,0,1,21,10,33,7,7,0
"20231111QPRBRI",2023-11-11,"England Championship","QPR","Bristol City",0,0,"D",7,7,0,2,12,16,5,2,2,2,0,0,0,0,0,0,14,2,28,7,4,0
"20231111SHEMIL",2023-11-11,"England Championship","Sheffield Weds","Millwall",0,4,"A",12,13,2,6,13,8,8,4,2,2,0,0,0,0,0,4,25,8,21,12,4,0
"20231111SOUWES",2023-11-11,"England Championship","Southampton","West Brom",2,1,"H",10,14,3,2,7,10,3,10,3,0,0,0,1,1,0,3,24,5,17,13,3,0
"20231111WATROT",2023-11-11,"England Championship","Watford","Rotherham",5,0,"H",14,9,8,2,12,11,7,2,2,1,0,0,0,0,0,5,23,10,23,9,3,0
"20231124ROTLEE",2023-11-24,"England Championship","Rotherham","Leeds",1,1,"D",6,18,3,5,11,4,4,3,0,0,0,0,0,0,0,2,24,8,15,7,0,0
"20231125BIRSHE",2023-11-25,"England Championship","Birmingham","Sheffield Weds",2,1,"H",13,16,4,4,11,11,6,6,1,0,0,0,0,0,0,3,29,8,22,12,1,0
"20231125BRIMID",2023-11-25,"England Championship","Bristol City","Middlesbrough",3,2,"H",10,12,8,4,8,12,3,8,2,2,0,0,0,0,0,5,22,12,20,11,4,0
"20231125HUDSOU",2023-11-25,"England Championship","Huddersfield","Southampton",1,1,"D",10,16,2,4,5,11,2,7,4,1,0,0,1,0,1,2,26,6,16,9,5,0
"20231125LEIWAT",2023-11-25,"England Championship","Leicester","Watford",2,0,"H",23,9,8,1,5,14,6,2,2,5,0,1,1,0,1,2,32,9,19,8,7,1
"20231125MILCOV",2023-11-25,"England Championship","Millwall","Coventry",0,3,"A",20,11,5,9,12,10,4,3,2,1,0,0,0,0,0,3,31,14,22,7,3,0
"20231125NORQPR",2023-11-25,"England Championship","Norwich","QPR",1,0,"H",7,9,1,3,18,12,4,7,4,4,0,0,0,0,0,1,16,4,30,11,8,0
"20231125PLYSUN",2023-11-25,"England Championship","Plymouth","Sunderland",2,0,"H",10,24,2,5,12,5,4,14,4,1,0,0,1,0,1,2,34,7,17,18,5,0
"20231125PRECAR",2023-11-25,"England Championship","Preston","Cardiff",1,2,"A",4,19,2,8,9,6,6,13,3,1,1,0,0,0,0,3,23,10,15,19,4,1
"20231125STOBLA",2023-11-25,"England Championship","Stoke","Blackburn",0,3,"A",12,7,1,4,11,9,7,1,2,1,0,0,0,0,0,3,19,5,20,8,3,0
"20231125SWAHUL",2023-11-25,"England Championship","Swansea","Hull",2,2,"D",14,18,4,9,12,11,2,1,0,2,0,0,0,0,0,4,32,13,23,3,2,0
"20231125WESIPS",2023-11-25,"England Championship","West Brom","Ipswich",2,0,"H",10,6,4,0,5,12,4,5,1,2,0,0,0,0,0,2,16,4,17,9,3,0
"20231128CARWES",2023-11-28,"England Championship","Cardiff","West Brom",0,1,"A",11,8,1,1,7,9,6,3,1,2,0,0,0,0,0,1,19,2,16,9,3,0
"20231128COVPLY",2023-11-28,"England Championship","Coventry","Plymouth",1,0,"H",13,13,3,3,10,11,7,6,1,3,0,0,0,0,0,1,26,6,21,13,4,0
"20231128HULROT",2023-11-28,"England Championship","Hull","Rotherham",4,1,"H",22,9,12,3,5,8,8,4,1,2,0,0,0,0,0,5,31,15,13,12,3,0
"20231128MIDPRE",2023-11-28,"England Championship","Middlesbrough","Preston",4,0,"H",13,6,8,1,15,14,7,3,0,2,0,0,0,0,0,4,19,9,29,10,2,0
"20231128QPRSTO",2023-11-28,"England Championship","QPR","Stoke",4,2,"H",19,12,9,4,13,11,13,7,2,5,0,1,0,0,0,6,31,13,24,20,7,1
"20231128WATNOR",2023-11-28,"England Championship","Watford","Norwich",3,2,"H",21,12,9,5,14,12,7,5,1,4,0,0,1,0,1,5,33,14,26,12,5,0
"20231129BLABIR",2023-11-29,"England Championship","Blackburn","Birmingham",4,2,"H",11,26,6,6,12,6,8,9,4,2,0,0,0,0,0,6,37,12,18,17,6,0
"20231129LEESWA",2023-11-29,"England Championship","Leeds","Swansea",3,1,"H",18,10,8,2,12,11,6,5,0,1,0,0,0,0,0,4,28,10,23,11,1,0
"20231129SHELEI",2023-11-29,"England Championship","Sheffield Weds","Leicester",1,1,"D",14,12,7,3,10,7,5,4,2,1,0,0,0,0,0,2,26,10,17,9,3,0
"20231129SOUBRI",2023-11-29,"England Championship","Southampton","Bristol City",1,0,"H",14,8,5,1,11,14,6,3,3,1,0,0,0,0,0,1,22,6,25,9,4,0
"20231129SUNHUD",2023-11-29,"England Championship","Sunderland","Huddersfield",1,2,"A",27,9,9,5,12,11,10,4,2,1,0,0,0,0,0,3,36,14,23,14,3,0
"20231129IPSMIL",2023-11-29,"England Championship","Ipswich","Millwall",3,1,"H",19,5,7,3,9,13,4,2,2,3,0,0,0,0,0,4,24,10,22,6,5,0
"20231201PREQPR",2023-12-01,"England Championship","Preston","QPR",0,2,"A",7,8,1,5,11,11,6,4,1,1,0,0,0,0,0,2,15,6,22,10,2,0
"20231202WESLEI",2023-12-02,"England Championship","West Brom","Leicester",1,2,"A",9,9,3,3,10,11,4,6,2,1,0,0,0,0,0,3,18,6,21,10,3,0
"20231202BIRROT",2023-12-02,"England Championship","Birmingham","Rotherham",0,0,"D",12,12,4,4,11,17,4,6,1,3,0,0,0,0,0,0,24,8,28,10,4,0
"20231202HULWAT",2023-12-02,"England Championship","Hull","Watford",1,2,"A",23,10,7,4,7,12,8,2,1,2,0,0,0,0,0,3,33,11,19,10,3,0
"20231202IPSCOV",2023-12-02,"England Championship","Ipswich","Coventry",2,1,"H",13,15,3,1,14,11,1,6,2,1,0,0,0,0,0,3,28,4,25,7,3,0
"20231202LEEMID",2023-12-02,"England Championship","Leeds","Middlesbrough",3,2,"H",20,11,9,5,12,15,6,3,2,5,0,1,0,0,0,5,31,14,27,9,7,1
"20231202MILSUN",2023-12-02,"England Championship","Millwall","Sunderland",1,1,"D",7,10,4,3,14,12,4,4,5,3,0,0,0,0,0,2,17,7,26,8,8,0
"20231202PLYSTO",2023-12-02,"England Championship","Plymouth","Stoke",2,1,"H",16,9,8,4,3,15,7,8,1,2,0,0,0,0,0,3,25,12,18,15,3,0
"20231202SHEBLA",2023-12-02,"England Championship","Sheffield Weds","Blackburn",3,1,"H",13,18,8,5,12,6,3,7,2,1,0,0,0,0,0,4,31,13,18,10,3,0
"20231202SOUCAR",2023-12-02,"England Championship","Southampton","Cardiff",2,0,"H",18,10,6,3,6,9,7,3,1,1,0,0,0,0,0,2,28,9,15,10,2,0
"20231202SWAHUD",2023-12-02,"England Championship","Swansea","Huddersfield",1,1,"D",22,5,5,3,11,9,19,1,1,2,0,0,0,0,0,2,27,8,20,20,3,0
"20231203BRINOR",2023-12-03,"England Championship","Bristol City","Norwich",1,2,"A",15,12,6,3,5,7,6,6,1,1,0,0,0,0,0,3,27,9,12,12,2,0
"20231208COVBIR",2023-12-08,"England Championship","Coventry","Birmingham",2,0,"H",16,13,8,6,11,19,6,7,0,5,0,0,0,0,0,2,29,14,30,13,5,0
"20231209BLALEE",2023-12-09,"England Championship","Blackburn","Leeds",0,2,"A",12,8,2,4,11,7,13,3,3,2,0,0,0,0,0,2,20,6,18,16,5,0
"20231209SUNWES",2023-12-09,"England Championship","Sunderland","West Brom",2,1,"H",14,11,5,1,5,13,4,7,1,6,0,0,0,0,0,3,25,6,18,11,7,0
"20231209CARMIL",2023-12-09,"England Championship","Cardiff","Millwall",1,0,"H",7,10,3,3,11,14,4,2,1,2,0,0,0,0,0,1,17,6,25,6,3,0
"20231209HUDBRI",2023-12-09,"England Championship","Huddersfield","Bristol City",1,1,"D",6,15,2,4,8,10,2,9,1,1,0,0,0,0,0,2,21,6,18,11,2,0
"20231209LEIPLY",2023-12-09,"England Championship","Leicester","Plymouth",4,0,"H",13,15,7,5,6,10,5,8,0,3,0,0,0,0,0,4,28,12,16,13,3,0
"20231209MIDIPS",2023-12-09,"England Championship","Middlesbrough","Ipswich",0,2,"A",7,9,1,3,15,14,5,3,1,3,0,0,0,0,0,2,16,4,29,8,4,0
"20231209NORPRE",2023-12-09,"England Championship","Norwich","Preston",0,0,"D",18,6,4,1,8,10,10,1,0,2,0,0,0,0,0,0,24,5,18,11,2,0
"20231209QPRHUL",2023-12-09,"England Championship","QPR","Hull",2,0,"H",13,15,4,6,10,7,4,4,1,3,0,0,0,0,0,2,28,10,17,8,4,0
"20231209ROTSWA",2023-12-09,"England Championship","Rotherham","Swansea",1,2,"A",7,19,3,9,9,9,6,11,2,3,1,0,0,0,0,3,26,12,18,17,5,1
"20231209STOSHE",2023-12-09,"England Championship","Stoke","Sheffield Weds",0,1,"A",13,6,4,2,7,11,4,5,3,4,0,0,0,0,0,1,19,6,18,9,7,0
"20231209WATSOU",2023-12-09,"England Championship","Watford","Southampton",1,1,"D",11,6,4,3,10,16,7,3,3,4,0,0,0,0,0,2,17,7,26,10,7,0
"20231212BLABRI",2023-12-12,"England Championship","Blackburn","Bristol City",2,1,"H",13,11,3,5,6,7,3,4,4,1,0,0,0,0,0,3,24,8,13,7,5,0
"20231212HUDPRE",2023-12-12,"England Championship","Huddersfield","Preston",1,3,"A",7,11,3,3,12,10,2,6,0,2,0,0,0,0,0,4,18,6,22,8,2,0
"20231212ROTWES",2023-12-12,"England Championship","Rotherham","West Brom",0,2,"A",4,6,2,2,11,10,1,2,0,1,0,0,0,0,0,2,10,4,21,3,1,0
"20231212STOSWA",2023-12-12,"England Championship","Stoke","Swansea",1,1,"D",16,8,4,2,11,14,6,3,3,2,0,0,1,0,1,2,24,6,25,9,5,0
"20231212WATIPS",2023-12-12,"England Championship","Watford","Ipswich",1,2,"A",12,10,3,6,12,16,6,4,2,4,0,0,0,0,0,3,22,9,28,10,6,0
"20231212SUNLEE",2023-12-12,"England Championship","Sunderland","Leeds",1,0,"H",11,12,3,4,12,8,6,3,1,3,0,0,0,0,0,1,23,7,20,9,4,0
"20231213CARBIR",2023-12-13,"England Championship","Cardiff","Birmingham",0,1,"A",11,11,4,5,11,18,4,3,1,2,0,0,0,0,0,1,22,9,29,7,3,0
"20231213COVSOU",2023-12-13,"England Championship","Coventry","Southampton",1,1,"D",11,12,4,3,9,12,3,9,0,3,0,0,0,0,0,2,23,7,21,12,3,0
"20231213LEIMIL",2023-12-13,"England Championship","Leicester","Millwall",3,2,"H",15,11,6,6,5,16,9,3,2,4,0,0,0,0,0,5,26,12,21,12,6,0
"20231213NORSHE",2023-12-13,"England Championship","Norwich","Sheffield Weds",3,1,"H",12,21,5,4,6,10,3,7,1,1,0,0,0,0,0,4,33,9,16,10,2,0
"20231213QPRPLY",2023-12-13,"England Championship","QPR","Plymouth",0,0,"D",29,12,10,2,14,8,6,1,2,3,0,1,0,0,0,0,41,12,22,7,5,1
"20231213MIDHUL",2023-12-13,"England Championship","Middlesbrough","Hull",1,2,"A",16,8,8,4,9,5,6,4,0,1,0,0,0,0,0,3,24,12,14,10,1,0
"20231216IPSNOR",2023-12-16,"England Championship","Ipswich","Norwich",2,2,"D",18,11,5,3,11,8,6,3,2,0,0,0,1,0,1,4,29,8,19,9,2,0
"20231216BRISUN",2023-12-16,"England Championship","Bristol City","Sunderland",1,0,"H",6,18,3,9,12,8,5,11,3,3,0,0,0,0,0,1,24,12,20,16,6,0
"20231216HULCAR",2023-12-16,"England Championship","Hull","Cardiff",3,0,"H",15,8,7,1,14,12,9,2,1,3,0,0,0,0,0,3,23,8,26,11,4,0
"20231216LEECOV",2023-12-16,"England Championship","Leeds","Coventry",1,1,"D",20,7,6,3,8,15,7,0,3,5,0,0,0,0,0,2,27,9,23,7,8,0
"20231216MILHUD",2023-12-16,"England Championship","Millwall","Huddersfield",1,1,"D",12,10,7,2,16,8,0,6,0,2,0,0,0,0,0,2,22,9,24,6,2,0
"20231216PLYROT",2023-12-16,"England Championship","Plymouth","Rotherham",3,2,"H",25,9,9,4,7,16,11,5,0,5,0,1,0,0,0,5,34,13,23,16,5,1
"20231216PREWAT",2023-12-16,"England Championship","Preston","Watford",1,5,"A",20,15,10,7,14,9,10,5,3,1,0,0,0,0,0,6,35,17,23,15,4,0
"20231216SHEQPR",2023-12-16,"England Championship","Sheffield Weds","QPR",2,1,"H",8,5,3,2,12,13,8,3,5,4,0,0,0,0,0,3,13,5,25,11,9,0
"20231216SOUBLA",2023-12-16,"England Championship","Southampton","Blackburn",4,0,"H",22,4,11,4,9,11,15,1,3,2,0,1,1,0,1,4,26,15,20,16,5,1
"20231216SWAMID",2023-12-16,"England Championship","Swansea","Middlesbrough",1,2,"A",10,9,3,4,14,14,4,4,2,3,0,0,0,0,0,3,19,7,28,8,5,0
"20231217WESSTO",2023-12-17,"England Championship","West Brom","Stoke",1,1,"D",16,9,7,1,9,14,11,11,3,1,0,0,0,0,0,2,25,8,23,22,4,0
"20231218BIRLEI",2023-12-18,"England Championship","Birmingham","Leicester",2,3,"A",8,14,5,5,12,17,3,2,0,1,0,0,0,0,0,5,22,10,29,5,1,0
"20231222BRIHUL",2023-12-22,"England Championship","Bristol City","Hull",3,2,"H",21,16,5,4,9,11,7,6,2,3,0,0,1,1,0,5,37,9,20,13,5,0
"20231222SWAPRE",2023-12-22,"England Championship","Swansea","Preston",2,1,"H",10,9,4,4,10,8,4,3,4,2,0,0,0,0,0,3,19,8,18,7,6,0
"20231223LEEIPS",2023-12-23,"England Championship","Leeds","Ipswich",4,0,"H",9,2,4,0,10,15,5,0,1,4,0,0,0,0,0,4,11,4,25,5,5,0
"20231223BLAWAT",2023-12-23,"England Championship","Blackburn","Watford",1,2,"A",11,18,5,6,12,8,7,5,2,3,0,0,0,0,0,3,29,11,20,12,5,0
"20231223LEIROT",2023-12-23,"England Championship","Leicester","Rotherham",3,0,"H",24,2,11,0,5,4,10,0,1,1,0,0,0,0,0,3,26,11,9,10,2,0
"20231223MIDWES",2023-12-23,"England Championship","Middlesbrough","West Brom",1,0,"H",13,9,4,2,13,11,2,10,1,2,0,0,0,0,0,1,22,6,24,12,3,0
"20231223NORHUD",2023-12-23,"England Championship","Norwich","Huddersfield",2,0,"H",21,5,8,1,9,10,12,2,1,1,0,0,0,0,0,2,26,9,19,14,2,0
"20231223PLYBIR",2023-12-23,"England Championship","Plymouth","Birmingham",3,3,"D",15,13,8,7,7,15,7,3,2,5,0,1,0,0,0,6,28,15,22,10,7,1
"20231223QPRSOU",2023-12-23,"England Championship","QPR","Southampton",0,1,"A",12,13,2,4,8,12,7,5,1,3,0,1,0,0,0,1,25,6,20,12,4,1
"20231223SHECAR",2023-12-23,"England Championship","Sheffield Weds","Cardiff",1,2,"A",18,7,5,3,10,12,10,3,3,2,0,0,1,1,0,3,25,8,22,13,5,0
"20231223STOMIL",2023-12-23,"England Championship","Stoke","Millwall",0,0,"D",19,2,3,1,11,16,7,1,1,3,0,0,0,0,0,0,21,4,27,8,4,0
"20231223SUNCOV",2023-12-23,"England Championship","Sunderland","Coventry",0,3,"A",21,10,6,5,11,11,7,7,3,2,0,0,0,0,0,3,31,11,22,14,5,0
"20231226PRELEE",2023-12-26,"England Championship","Preston","Leeds",2,1,"H",13,11,4,2,22,12,5,6,5,1,0,1,0,0,0,3,24,6,34,11,6,1
"20231226MILQPR",2023-12-26,"England Championship","Millwall","QPR",2,0,"H",13,10,3,1,12,12,4,6,3,3,0,0,0,0,0,2,23,4,24,10,6,0
"20231226CARPLY",2023-12-26,"England Championship","Cardiff","Plymouth",2,2,"D",17,13,4,6,5,9,7,3,0,1,0,0,0,0,0,4,30,10,14,10,1,0
"20231226COVSHE",2023-12-26,"England Championship","Coventry","Sheffield Weds",2,0,"H",9,11,2,2,7,12,5,9,1,1,1,1,0,0,0,2,20,4,19,14,2,2
"20231226HUDBLA",2023-12-26,"England Championship","Huddersfield","Blackburn",3,0,"H",12,10,6,1,10,8,6,4,1,4,0,0,0,0,0,3,22,7,18,10,5,0
"20231226HULSUN",2023-12-26,"England Championship","Hull","Sunderland",0,1,"A",10,17,6,3,6,8,3,7,1,1,0,0,0,0,0,1,27,9,14,10,2,0
"20231226ROTMID",2023-12-26,"England Championship","Rotherham","Middlesbrough",1,0,"H",3,19,1,5,12,8,0,11,0,0,0,0,0,0,0,1,22,6,20,11,0,0
"20231226SOUSWA",2023-12-26,"England Championship","Southampton","Swansea",5,0,"H",11,4,9,1,15,13,3,1,2,4,0,0,1,0,1,5,15,10,28,4,6,0
"20231226WATBRI",2023-12-26,"England Championship","Watford","Bristol City",1,4,"A",13,15,5,5,10,4,6,6,1,0,0,0,0,0,0,5,28,10,14,12,1,0
"20231226WESNOR",2023-12-26,"England Championship","West Brom","Norwich",1,0,"H",21,7,3,3,5,8,12,4,0,0,0,1,0,0,0,1,28,6,13,16,0,1
"20231226BIRSTO",2023-12-26,"England Championship","Birmingham","Stoke",1,3,"A",14,11,5,5,10,12,5,3,2,3,0,0,0,0,0,4,25,10,22,8,5,0
"20231226IPSLEI",2023-12-26,"England Championship","Ipswich","Leicester",1,1,"D",19,5,2,2,9,9,11,2,1,2,0,0,0,0,0,2,24,4,18,13,3,0
"20231229SOUPLY",2023-12-29,"England Championship","Southampton","Plymouth",2,1,"H",26,8,7,1,8,8,9,3,3,2,0,0,0,0,0,3,34,8,16,12,5,0
"20231229BIRBRI",2023-12-29,"England Championship","Birmingham","Bristol City",0,0,"D",5,8,1,0,11,6,1,6,0,0,0,0,0,0,0,0,13,1,17,7,0,0
"20231229CARLEI",2023-12-29,"England Championship","Cardiff","Leicester",0,2,"A",10,9,2,4,11,7,5,2,1,0,0,0,0,0,0,2,19,6,18,7,1,0
"20231229COVSWA",2023-12-29,"England Championship","Coventry","Swansea",2,2,"D",21,12,5,4,14,11,12,4,1,4,0,0,0,0,0,4,33,9,25,16,5,0
"20231229HUDMID",2023-12-29,"England Championship","Huddersfield","Middlesbrough",1,2,"A",16,9,5,5,11,11,7,2,0,2,0,0,0,0,0,3,25,10,22,9,2,0
"20231229HULBLA",2023-12-29,"England Championship","Hull","Blackburn",3,2,"H",21,10,9,4,15,12,4,4,3,3,0,1,0,0,0,5,31,13,27,8,6,1
"20231229IPSQPR",2023-12-29,"England Championship","Ipswich","QPR",0,0,"D",7,10,5,2,13,5,5,9,3,2,0,0,0,0,0,0,17,7,18,14,5,0
"20231229MILNOR",2023-12-29,"England Championship","Millwall","Norwich",1,0,"H",11,11,5,3,11,12,5,3,4,5,1,0,1,0,1,1,22,8,23,8,9,1
"20231229PRESHE",2023-12-29,"England Championship","Preston","Sheffield Weds",0,1,"A",9,6,2,3,10,11,3,0,4,2,0,1,0,0,0,1,15,5,21,3,6,1
"20231229ROTSUN",2023-12-29,"England Championship","Rotherham","Sunderland",1,1,"D",13,10,4,3,10,9,4,8,2,1,0,0,0,0,0,2,23,7,19,12,3,0
"20231229WATSTO",2023-12-29,"England Championship","Watford","Stoke",1,1,"D",13,14,6,4,7,10,5,4,4,1,1,0,0,0,0,2,27,10,17,9,5,1
"20231229WESLEE",2023-12-29,"England Championship","West Brom","Leeds",1,0,"H",13,15,3,1,8,10,11,8,1,1,0,0,0,0,0,1,28,4,18,19,2,0
"20240101SUNPRE",2024-01-01,"England Championship","Sunderland","Preston",2,0,"H",7,12,4,3,6,12,2,3,0,1,0,0,0,0,0,2,19,7,18,5,1,0
"20240101BLAROT",2024-01-01,"England Championship","Blackburn","Rotherham",2,2,"D",18,13,9,4,5,11,5,5,0,1,0,0,0,0,0,4,31,13,16,10,1,0
"20240101BRIMIL",2024-01-01,"England Championship","Bristol City","Millwall",0,1,"A",5,11,1,2,5,10,6,5,1,2,0,0,0,0,0,1,16,3,15,11,3,0
"20240101LEEBIR",2024-01-01,"England Championship","Leeds","Birmingham",3,0,"H",21,8,11,1,10,14,6,3,0,2,0,0,0,0,0,3,29,12,24,9,2,0
"20240101LEIHUD",2024-01-01,"England Championship","Leicester","Huddersfield",4,1,"H",19,12,6,4,5,9,3,4,0,1,0,0,0,0,0,5,31,10,14,7,1,0
"20240101MIDCOV",2024-01-01,"England Championship","Middlesbrough","Coventry",1,3,"A",19,17,7,8,10,11,12,9,2,2,0,0,0,0,0,4,36,15,21,21,4,0
"20240101NORSOU",2024-01-01,"England Championship","Norwich","Southampton",1,1,"D",7,21,2,4,8,8,1,12,5,0,0,0,0,0,0,2,28,6,16,13,5,0
"20240101PLYWAT",2024-01-01,"England Championship","Plymouth","Watford",3,3,"D",31,18,11,5,11,12,9,5,2,3,0,0,0,0,0,6,49,16,23,14,5,0
"20240101QPRCAR",2024-01-01,"England Championship","QPR","Cardiff",1,2,"A",8,10,3,5,12,20,1,6,2,5,0,0,0,0,0,3,18,8,32,7,7,0
"20240101STOIPS",2024-01-01,"England Championship","Stoke","Ipswich",0,0,"D",8,13,4,2,7,15,8,5,1,2,1,0,0,0,0,0,21,6,22,13,3,1
"20240101SWAWES",2024-01-01,"England Championship","Swansea","West Brom",1,0,"H",10,10,4,5,10,7,3,5,2,0,0,0,0,0,0,1,20,9,17,8,2,0
"20240101SHEHUL",2024-01-01,"England Championship","Sheffield Weds","Hull",3,1,"H",23,5,6,1,13,13,10,4,3,4,0,1,0,0,0,4,28,7,26,14,7,1
"20240112HULNOR",2024-01-12,"England Championship","Hull","Norwich",1,2,"A",19,9,5,4,12,14,9,2,2,4,0,0,0,0,0,3,28,9,26,11,6,0
"20240113COVLEI",2024-01-13,"England Championship","Coventry","Leicester",3,1,"H",14,8,6,4,12,14,7,1,5,3,0,1,0,0,0,4,22,10,26,8,8,1
"20240113BIRSWA",2024-01-13,"England Championship","Birmingham","Swansea",2,2,"D",11,6,6,3,21,11,5,5,5,3,0,0,0,0,0,4,17,9,32,10,8,0
"20240113CARLEE",2024-01-13,"England Championship","Cardiff","Leeds",0,3,"A",9,15,1,7,5,7,5,4,1,1,0,0,0,0,0,3,24,8,12,9,2,0
"20240113HUDPLY",2024-01-13,"England Championship","Huddersfield","Plymouth",1,1,"D",13,9,4,3,13,16,3,5,1,4,0,0,0,0,0,2,22,7,29,8,5,0
"20240113MILMID",2024-01-13,"England Championship","Millwall","Middlesbrough",1,3,"A",15,14,5,6,9,10,5,4,3,1,0,0,0,0,0,4,29,11,19,9,4,0
"20240113PREBRI",2024-01-13,"England Championship","Preston","Bristol City",2,0,"H",12,15,7,6,13,7,8,6,1,2,0,0,0,0,0,2,27,13,20,14,3,0
"20240113ROTSTO",2024-01-13,"England Championship","Rotherham","Stoke",0,1,"A",3,4,0,3,11,13,3,6,2,3,0,0,0,0,0,1,7,3,24,9,5,0
"20240113SOUSHE",2024-01-13,"England Championship","Southampton","Sheffield Weds",4,0,"H",15,6,7,4,9,12,14,3,3,3,0,0,0,0,0,4,21,11,21,17,6,0
"20240113WESBLA",2024-01-13,"England Championship","West Brom","Blackburn",4,1,"H",16,12,8,3,8,9,6,3,2,0,0,0,1,0,1,5,28,11,17,9,2,0
"20240113IPSSUN",2024-01-13,"England Championship","Ipswich","Sunderland",2,1,"H",17,10,5,3,17,8,3,1,5,2,0,0,0,0,0,3,27,8,25,4,7,0
"20240114QPRWAT",2024-01-14,"England Championship","QPR","Watford",1,2,"A",16,9,7,2,17,13,8,4,3,3,0,0,0,0,0,3,25,9,30,12,6,0
"20240119SUNHUL",2024-01-19,"England Championship","Sunderland","Hull",0,1,"A",15,2,3,2,12,17,12,1,2,7,0,0,0,0,0,1,17,5,29,13,9,0
"20240120SWASOU",2024-01-20,"England Championship","Swansea","Southampton",1,3,"A",15,21,6,10,10,12,3,8,2,2,0,0,0,0,0,4,36,16,22,11,4,0
"20240120BLAHUD",2024-01-20,"England Championship","Blackburn","Huddersfield",1,1,"D",16,8,4,3,10,4,7,3,1,2,0,0,0,0,0,2,24,7,14,10,3,0
"20240120BRIWAT",2024-01-20,"England Championship","Bristol City","Watford",1,1,"D",15,14,6,2,8,16,7,8,1,2,0,0,0,0,0,2,29,8,24,15,3,0
"20240120MIDROT",2024-01-20,"England Championship","Middlesbrough","Rotherham",1,1,"D",15,6,3,2,8,8,13,2,1,3,0,0,0,0,0,2,21,5,16,15,4,0
"20240120NORWES",2024-01-20,"England Championship","Norwich","West Brom",2,0,"H",13,15,6,3,9,10,2,6,1,2,0,0,0,0,0,2,28,9,19,8,3,0
"20240120PLYCAR",2024-01-20,"England Championship","Plymouth","Cardiff",3,1,"H",15,6,5,3,9,7,5,5,4,2,0,0,0,0,0,4,21,8,16,10,6,0
"20240120QPRMIL",2024-01-20,"England Championship","QPR","Millwall",2,0,"H",12,2,5,1,10,8,2,3,0,2,0,0,0,0,0,2,14,6,18,5,2,0
"20240120SHECOV",2024-01-20,"England Championship","Sheffield Weds","Coventry",1,2,"A",11,16,5,6,14,11,6,7,4,5,0,0,0,0,0,3,27,11,25,13,9,0
"20240120STOBIR",2024-01-20,"England Championship","Stoke","Birmingham",1,2,"A",22,9,5,5,5,7,13,2,2,0,0,0,0,0,0,3,31,10,12,15,2,0
"20240121LEEPRE",2024-01-21,"England Championship","Leeds","Preston",2,1,"H",20,8,6,2,12,18,9,3,4,6,0,0,0,0,0,3,28,8,30,12,10,0
"20240122LEIIPS",2024-01-22,"England Championship","Leicester","Ipswich",1,1,"D",15,11,8,3,6,11,8,8,1,3,0,0,0,0,0,2,26,11,17,16,4,0
"20240124LEENOR",2024-01-24,"England Championship","Leeds","Norwich",1,0,"H",12,5,4,1,13,8,4,2,1,2,0,0,0,0,0,1,17,5,21,6,3,0
"20240127MILPRE",2024-01-27,"England Championship","Millwall","Preston",1,1,"D",17,11,8,4,19,6,8,3,3,3,0,0,0,0,0,2,28,12,25,11,6,0
"20240127SUNSTO",2024-01-27,"England Championship","Sunderland","Stoke",3,1,"H",8,15,5,4,10,9,3,6,1,3,0,0,0,0,0,4,23,9,19,9,4,0
"20240128QPRHUD",2024-01-28,"England Championship","QPR","Huddersfield",1,1,"D",7,13,4,3,15,16,4,10,4,3,0,0,0,0,0,2,20,7,31,14,7,0
"20240130COVBRI",2024-01-30,"England Championship","Coventry","Bristol City",2,2,"D",11,13,4,5,10,13,1,5,1,2,0,0,0,0,0,4,24,9,23,6,3,0
"20240130LEISWA",2024-01-30,"England Championship","Leicester","Swansea",3,1,"H",14,11,7,3,12,8,2,3,1,1,0,0,0,0,0,4,25,10,20,5,2,0
"20240131SHEWAT",2024-01-31,"England Championship","Sheffield Weds","Watford",0,0,"D",19,10,5,2,8,13,5,5,4,3,0,0,0,0,0,0,29,7,21,10,7,0
"20240202BRILEE",2024-02-02,"England Championship","Bristol City","Leeds",0,1,"A",7,14,1,6,10,10,2,4,1,0,0,0,0,0,0,1,21,7,20,6,1,0
"20240203BLAQPR",2024-02-03,"England Championship","Blackburn","QPR",1,2,"A",16,7,6,4,12,5,4,10,2,3,0,0,0,0,0,3,23,10,17,14,5,0
"20240203HUDSHE",2024-02-03,"England Championship","Huddersfield","Sheffield Weds",4,0,"H",12,12,6,3,10,18,7,8,3,1,0,0,0,0,0,4,24,9,28,15,4,0
"20240203HULMIL",2024-02-03,"England Championship","Hull","Millwall",1,0,"H",9,5,2,1,15,19,4,4,3,2,0,0,0,0,0,1,14,3,34,8,5,0
"20240203NORCOV",2024-02-03,"England Championship","Norwich","Coventry",2,1,"H",21,8,5,5,11,9,5,2,2,1,0,1,0,0,0,3,29,10,20,7,3,1
"20240203PREIPS",2024-02-03,"England Championship","Preston","Ipswich",3,2,"H",10,25,3,9,13,8,6,3,0,0,0,0,0,0,0,5,35,12,21,9,0,0
"20240203ROTSOU",2024-02-03,"England Championship","Rotherham","Southampton",0,2,"A",8,10,2,7,8,10,3,10,0,2,0,0,0,0,0,2,18,9,18,13,2,0
"20240203STOLEI",2024-02-03,"England Championship","Stoke","Leicester",0,5,"A",10,16,4,9,10,12,3,6,4,3,0,0,0,0,0,5,26,13,22,9,7,0
"20240203SWAPLY",2024-02-03,"England Championship","Swansea","Plymouth",0,1,"A",20,9,4,3,12,14,8,2,2,3,0,0,0,0,0,1,29,7,26,10,5,0
"20240203WATCAR",2024-02-03,"England Championship","Watford","Cardiff",0,1,"A",17,10,6,2,16,6,10,2,3,3,0,0,0,0,0,1,27,8,22,12,6,0
"20240203WESBIR",2024-02-03,"England Championship","West Brom","Birmingham",1,0,"H",10,13,2,5,12,16,4,8,2,3,0,0,0,0,0,1,23,7,28,12,5,0
"20240204MIDSUN",2024-02-04,"England Championship","Middlesbrough","Sunderland",1,1,"D",15,13,2,5,17,10,1,6,3,3,0,0,0,0,0,2,28,7,27,7,6,0
"20240209SHEBIR",2024-02-09,"England Championship","Sheffield Weds","Birmingham",2,0,"H",13,25,3,4,14,10,1,7,3,1,0,0,0,0,0,2,38,7,24,8,4,0
"20240210IPSWES",2024-02-10,"England Championship","Ipswich","West Brom",2,2,"D",21,5,7,2,12,3,9,3,2,3,0,0,0,0,0,4,26,9,15,12,5,0
"20240210BLASTO",2024-02-10,"England Championship","Blackburn","Stoke",3,1,"H",9,7,5,3,8,8,5,8,0,2,0,0,0,0,0,4,16,8,16,13,2,0
"20240210CARPRE",2024-02-10,"England Championship","Cardiff","Preston",0,2,"A",14,3,5,3,5,11,4,0,2,1,0,0,0,0,0,2,17,8,16,4,3,0
"20240210HULSWA",2024-02-10,"England Championship","Hull","Swansea",0,1,"A",9,13,3,5,7,10,2,4,1,3,0,0,0,0,0,1,22,8,17,6,4,0
"20240210LEEROT",2024-02-10,"England Championship","Leeds","Rotherham",3,0,"H",19,7,6,2,13,11,5,3,0,2,0,0,0,0,0,3,26,8,24,8,2,0
"20240210MIDBRI",2024-02-10,"England Championship","Middlesbrough","Bristol City",1,2,"A",16,12,6,7,11,11,7,1,1,0,0,0,0,0,0,3,28,13,22,8,1,0
"20240210QPRNOR",2024-02-10,"England Championship","QPR","Norwich",2,2,"D",14,12,4,4,25,11,1,8,2,4,0,0,0,0,0,4,26,8,36,9,6,0
"20240210SOUHUD",2024-02-10,"England Championship","Southampton","Huddersfield",5,3,"H",15,17,7,6,11,11,6,6,2,3,0,0,0,0,0,8,32,13,22,12,5,0
"20240210SUNPLY",2024-02-10,"England Championship","Sunderland","Plymouth",3,1,"H",14,5,5,2,17,13,8,2,1,5,0,0,0,0,0,4,19,7,30,10,6,0
"20240210WATLEI",2024-02-10,"England Championship","Watford","Leicester",1,2,"A",13,6,3,3,11,15,8,1,2,3,0,0,0,0,0,3,19,6,26,9,5,0
"20240211COVMIL",2024-02-11,"England Championship","Coventry","Millwall",2,1,"H",15,8,5,4,9,14,8,3,0,1,0,0,0,0,0,3,23,9,23,11,1,0
"20240213BIRBLA",2024-02-13,"England Championship","Birmingham","Blackburn",1,0,"H",18,8,3,3,9,16,6,4,2,3,0,0,0,0,0,1,26,6,25,10,5,0
"20240213LEISHE",2024-02-13,"England Championship","Leicester","Sheffield Weds",2,0,"H",10,13,3,4,15,12,4,7,1,2,0,0,0,0,0,2,23,7,27,11,3,0
"20240213NORWAT",2024-02-13,"England Championship","Norwich","Watford",4,2,"H",14,11,6,3,13,11,4,4,3,2,0,0,0,0,0,6,25,9,24,8,5,0
"20240213ROTHUL",2024-02-13,"England Championship","Rotherham","Hull",1,2,"A",11,20,6,8,13,6,4,9,2,1,0,0,0,0,0,3,31,14,19,13,3,0
"20240213SWALEE",2024-02-13,"England Championship","Swansea","Leeds",0,4,"A",7,13,1,8,11,10,5,2,3,1,0,0,0,0,0,4,20,9,21,7,4,0
"20240213BRISOU",2024-02-13,"England Championship","Bristol City","Southampton",3,1,"H",14,16,4,4,8,13,6,5,2,2,0,0,0,0,0,4,30,8,21,11,4,0
"20240213WESCAR",2024-02-13,"England Championship","West Brom","Cardiff",2,0,"H",11,11,3,1,8,11,4,4,1,2,0,0,0,0,0,2,22,4,19,8,3,0
"20240214HUDSUN",2024-02-14,"England Championship","Huddersfield","Sunderland",1,0,"H",12,12,6,5,14,15,6,10,2,4,0,0,0,0,0,1,24,11,29,16,6,0
"20240214PLYCOV",2024-02-14,"England Championship","Plymouth","Coventry",2,2,"D",13,17,4,7,8,19,1,9,1,3,0,0,0,0,0,4,30,11,27,10,4,0
"20240214PREMID",2024-02-14,"England Championship","Preston","Middlesbrough",2,1,"H",7,20,3,4,10,10,2,7,2,1,0,0,1,0,1,3,27,7,20,9,3,0
"20240214STOQPR",2024-02-14,"England Championship","Stoke","QPR",1,0,"H",14,10,5,1,12,11,5,7,0,1,0,0,0,0,0,1,24,6,23,12,1,0
"20240214MILIPS",2024-02-14,"England Championship","Millwall","Ipswich",0,4,"A",14,8,4,4,12,13,9,5,3,1,0,0,0,0,0,4,22,8,25,14,4,0
"20240216WESSOU",2024-02-16,"England Championship","West Brom","Southampton",0,2,"A",9,13,2,4,8,5,6,9,2,1,0,0,0,0,0,2,22,6,13,15,3,0
"20240217PLYLEE",2024-02-17,"England Championship","Plymouth","Leeds",0,2,"A",7,9,1,2,14,13,4,0,2,1,0,0,0,0,0,2,16,3,27,4,3,0
"20240217BIRSUN",2024-02-17,"England Championship","Birmingham","Sunderland",2,1,"H",16,10,5,4,18,14,5,5,4,4,0,0,0,0,0,3,26,9,32,10,8,0
"20240217BRIQPR",2024-02-17,"England Championship","Bristol City","QPR",0,1,"A",11,11,2,7,7,7,4,2,0,1,0,0,0,0,0,1,22,9,14,6,1,0
"20240217HUDHUL",2024-02-17,"England Championship","Huddersfield","Hull",1,2,"A",16,9,3,3,11,8,11,3,3,1,0,0,0,0,0,3,25,6,19,14,4,0
"20240217LEIMID",2024-02-17,"England Championship","Leicester","Middlesbrough",1,2,"A",24,5,2,2,10,8,12,4,1,4,0,0,0,0,0,3,29,4,18,16,5,0
"20240217MILSHE",2024-02-17,"England Championship","Millwall","Sheffield Weds",0,2,"A",9,5,3,2,14,15,5,5,3,1,0,1,0,0,0,2,14,5,29,10,4,1
"20240217NORCAR",2024-02-17,"England Championship","Norwich","Cardiff",4,1,"H",23,9,8,3,7,13,8,0,0,3,0,0,0,0,0,5,32,11,20,8,3,0
"20240217PREBLA",2024-02-17,"England Championship","Preston","Blackburn",2,2,"D",16,6,8,3,10,12,7,3,0,0,0,0,0,0,0,4,22,11,22,10,0,0
"20240217ROTWAT",2024-02-17,"England Championship","Rotherham","Watford",0,1,"A",19,8,1,1,13,11,7,6,2,1,0,0,0,0,0,1,27,2,24,13,3,0
"20240217STOCOV",2024-02-17,"England Championship","Stoke","Coventry",0,1,"A",13,9,1,3,13,10,5,4,2,1,0,0,0,0,0,1,22,4,23,9,3,0
"20240217SWAIPS",2024-02-17,"England Championship","Swansea","Ipswich",1,2,"A",15,15,3,6,5,13,9,6,1,1,0,0,0,0,0,3,30,9,18,15,2,0
"20240220CARBLA",2024-02-20,"England Championship","Cardiff","Blackburn",0,0,"D",11,4,5,1,10,12,4,1,2,3,0,0,0,0,0,0,15,6,22,5,5,0
"20240220IPSROT",2024-02-20,"England Championship","Ipswich","Rotherham",4,3,"H",11,13,7,5,16,16,2,6,1,2,0,0,0,0,0,7,24,12,32,8,3,0
"20240220PLYWES",2024-02-20,"England Championship","Plymouth","West Brom",0,3,"A",4,17,0,7,9,8,2,7,1,0,0,0,0,0,0,3,21,7,17,9,1,0
"20240220SOUHUL",2024-02-20,"England Championship","Southampton","Hull",1,2,"A",15,17,3,5,9,13,4,2,1,2,0,0,1,1,0,3,32,8,22,6,3,0
"20240223COVPRE",2024-02-23,"England Championship","Coventry","Preston",0,3,"A",10,10,4,3,9,19,6,6,1,3,0,0,0,0,0,3,20,7,28,12,4,0
"20240223LEELEI",2024-02-23,"England Championship","Leeds","Leicester",3,1,"H",15,16,4,5,15,11,2,5,5,2,0,0,0,0,0,4,31,9,26,7,7,0
"20240224HULWES",2024-02-24,"England Championship","Hull","West Brom",1,1,"D",9,11,3,4,10,11,8,3,0,0,0,0,0,0,0,2,20,7,21,11,0,0
"20240224BLANOR",2024-02-24,"England Championship","Blackburn","Norwich",1,1,"D",10,7,5,3,14,6,6,6,2,2,0,0,0,0,0,2,17,8,20,12,4,0
"20240224CARSTO",2024-02-24,"England Championship","Cardiff","Stoke",2,1,"H",11,14,5,6,13,14,2,6,4,2,0,0,0,0,0,3,25,11,27,8,6,0
"20240224IPSBIR",2024-02-24,"England Championship","Ipswich","Birmingham",3,1,"H",26,11,9,4,11,14,7,5,3,1,0,0,0,0,0,4,37,13,25,12,4,0
"20240224MIDPLY",2024-02-24,"England Championship","Middlesbrough","Plymouth",0,2,"A",11,22,0,11,12,10,6,6,1,1,0,0,0,0,0,2,33,11,22,12,2,0
"20240224QPRROT",2024-02-24,"England Championship","QPR","Rotherham",2,1,"H",18,14,9,4,9,17,9,0,4,1,0,0,0,0,0,3,32,13,26,9,5,0
"20240224SHEBRI",2024-02-24,"England Championship","Sheffield Weds","Bristol City",2,1,"H",15,12,7,2,8,7,4,6,1,3,1,0,0,0,0,3,27,9,15,10,4,1
"20240224SOUMIL",2024-02-24,"England Championship","Southampton","Millwall",1,2,"A",14,8,7,3,9,8,13,1,4,3,0,0,0,0,0,3,22,10,17,14,7,0
"20240224SUNSWA",2024-02-24,"England Championship","Sunderland","Swansea",1,2,"A",13,13,5,8,8,15,4,11,1,4,0,0,0,0,0,3,26,13,23,15,5,0
"20240224WATHUD",2024-02-24,"England Championship","Watford","Huddersfield",1,2,"A",12,11,4,5,16,12,3,5,2,2,0,0,0,0,0,3,23,9,28,8,4,0
"20240301WESCOV",2024-03-01,"England Championship","West Brom","Coventry",2,1,"H",7,17,2,3,10,12,4,4,2,1,0,0,0,0,0,3,24,5,22,8,3,0
"20240302BRICAR",2024-03-02,"England Championship","Bristol City","Cardiff",0,1,"A",17,9,3,4,7,14,8,3,2,2,0,0,0,0,0,1,26,7,21,11,4,0
"20240302HUDLEE",2024-03-02,"England Championship","Huddersfield","Leeds",1,1,"D",12,15,5,2,10,13,8,8,3,1,1,0,0,0,0,2,27,7,23,16,4,1
"20240302BIRSOU",2024-03-02,"England Championship","Birmingham","Southampton",3,4,"A",13,25,4,10,11,7,6,16,3,1,1,0,0,0,0,7,38,14,18,22,4,1
"20240302LEIQPR",2024-03-02,"England Championship","Leicester","QPR",1,2,"A",18,3,5,2,7,11,9,0,2,3,0,0,0,0,0,3,21,7,18,9,5,0
"20240302MILWAT",2024-03-02,"England Championship","Millwall","Watford",1,0,"H",6,12,2,3,12,14,4,3,3,1,0,0,0,0,0,1,18,5,26,7,4,0
"20240302NORSUN",2024-03-02,"England Championship","Norwich","Sunderland",1,0,"H",16,12,4,4,13,11,5,2,2,3,0,0,1,1,0,1,28,8,24,7,5,0
"20240302PLYIPS",2024-03-02,"England Championship","Plymouth","Ipswich",0,2,"A",9,14,2,6,11,22,5,7,1,3,0,0,0,0,0,2,23,8,33,12,4,0
"20240302PREHUL",2024-03-02,"England Championship","Preston","Hull",0,0,"D",16,15,4,4,12,6,8,8,1,1,0,0,0,0,0,0,31,8,18,16,2,0
"20240302ROTSHE",2024-03-02,"England Championship","Rotherham","Sheffield Weds",0,1,"A",7,17,1,4,16,14,2,10,1,2,0,0,0,0,0,1,24,5,30,12,3,0
"20240302STOMID",2024-03-02,"England Championship","Stoke","Middlesbrough",2,0,"H",11,10,5,3,16,5,6,3,3,1,0,0,0,0,0,2,21,8,21,9,4,0
"20240302SWABLA",2024-03-02,"England Championship","Swansea","Blackburn",2,1,"H",7,10,4,5,10,12,6,6,1,2,0,0,0,0,0,3,17,9,22,12,3,0
"20240305BLAMIL",2024-03-05,"England Championship","Blackburn","Millwall",1,1,"D",11,3,3,1,10,11,4,2,0,1,0,0,0,0,0,2,14,4,21,6,1,0
"20240305COVROT",2024-03-05,"England Championship","Coventry","Rotherham",5,0,"H",16,7,6,1,10,19,4,5,0,1,0,0,0,0,0,5,23,7,29,9,1,0
"20240305HULBIR",2024-03-05,"England Championship","Hull","Birmingham",1,1,"D",22,8,5,3,7,8,10,2,1,3,0,0,0,0,0,2,30,8,15,12,4,0
"20240305LEESTO",2024-03-05,"England Championship","Leeds","Stoke",1,0,"H",15,13,7,6,7,13,8,2,1,1,0,1,0,0,0,1,28,13,20,10,2,1
"20240305SHEPLY",2024-03-05,"England Championship","Sheffield Weds","Plymouth",1,0,"H",18,13,3,3,12,13,8,2,1,2,0,0,0,0,0,1,31,6,25,10,3,0
"20240305SUNLEI",2024-03-05,"England Championship","Sunderland","Leicester",0,1,"A",17,10,6,6,12,19,6,5,1,3,0,0,0,0,0,1,27,12,31,11,4,0
"20240305IPSBRI",2024-03-05,"England Championship","Ipswich","Bristol City",3,2,"H",14,11,8,4,6,15,4,5,1,3,0,0,0,0,0,5,25,12,21,9,4,0
"20240306CARHUD",2024-03-06,"England Championship","Cardiff","Huddersfield",1,0,"H",8,11,4,2,10,11,3,3,4,1,0,0,0,0,0,1,19,6,21,6,5,0
"20240306MIDNOR",2024-03-06,"England Championship","Middlesbrough","Norwich",3,1,"H",15,6,7,3,8,9,2,2,1,1,0,1,0,0,0,4,21,10,17,4,2,1
"20240306WATSWA",2024-03-06,"England Championship","Watford","Swansea",1,1,"D",19,11,3,2,18,10,9,3,4,2,0,0,0,0,0,2,30,5,28,12,6,0
"20240306QPRWES",2024-03-06,"England Championship","QPR","West Brom",2,2,"D",20,4,6,2,7,5,19,4,0,1,0,0,0,0,0,4,24,8,12,23,1,0
"20240308SHELEE",2024-03-08,"England Championship","Sheffield Weds","Leeds",0,2,"A",9,13,3,7,16,9,8,5,1,1,0,0,0,0,0,2,22,10,25,13,2,0
"20240309CARIPS",2024-03-09,"England Championship","Cardiff","Ipswich",2,1,"H",15,8,6,4,5,8,4,2,0,1,0,0,0,0,0,3,23,10,13,6,1,0
"20240309BLAPLY",2024-03-09,"England Championship","Blackburn","Plymouth",1,1,"D",8,20,4,7,13,10,1,5,2,1,1,0,0,0,0,2,28,11,23,6,3,1
"20240309HULLEI",2024-03-09,"England Championship","Hull","Leicester",2,2,"D",8,15,5,2,15,13,1,3,2,2,0,0,0,0,0,4,23,7,28,4,4,0
"20240309MILBIR",2024-03-09,"England Championship","Millwall","Birmingham",1,0,"H",12,16,5,1,17,10,4,4,2,1,0,0,0,0,0,1,28,6,27,8,3,0
"20240309NORROT",2024-03-09,"England Championship","Norwich","Rotherham",5,0,"H",18,2,8,0,9,12,4,3,1,0,0,0,0,0,0,5,20,8,21,7,1,0
"20240309PRESTO",2024-03-09,"England Championship","Preston","Stoke",1,2,"A",4,13,2,4,10,10,0,6,2,2,0,0,0,0,0,3,17,6,20,6,4,0
"20240309QPRMID",2024-03-09,"England Championship","QPR","Middlesbrough",0,2,"A",10,7,2,4,11,7,10,3,2,5,0,0,0,0,0,2,17,6,18,13,7,0
"20240309SOUSUN",2024-03-09,"England Championship","Southampton","Sunderland",4,2,"H",21,13,10,5,13,15,6,2,2,3,0,0,0,0,0,6,34,15,28,8,5,0
"20240309WATCOV",2024-03-09,"England Championship","Watford","Coventry",1,2,"A",19,8,5,3,12,12,5,4,1,5,0,0,0,0,0,3,27,8,24,9,6,0
"20240310HUDWES",2024-03-10,"England Championship","Huddersfield","West Brom",1,4,"A",14,12,6,8,9,11,5,5,1,1,0,0,0,0,0,5,26,14,20,10,2,0
"20240310BRISWA",2024-03-10,"England Championship","Bristol City","Swansea",1,0,"H",5,8,2,0,14,4,3,6,2,1,0,0,0,0,0,1,13,2,18,9,3,0
"20240312BIRMID",2024-03-12,"England Championship","Birmingham","Middlesbrough",0,1,"A",9,12,0,3,9,6,3,4,0,2,0,0,0,0,0,1,21,3,15,7,2,0
"20240316SWACAR",2024-03-16,"England Championship","Swansea","Cardiff",2,0,"H",20,11,5,2,12,11,10,5,2,1,0,0,0,0,0,2,31,7,23,15,3,0
"20240316BIRWAT",2024-03-16,"England Championship","Birmingham","Watford",0,1,"A",27,14,5,4,11,12,7,6,0,3,0,0,0,0,0,1,41,9,23,13,3,0
"20240316IPSSHE",2024-03-16,"England Championship","Ipswich","Sheffield Weds",6,0,"H",20,9,10,1,12,8,10,4,1,2,0,0,0,0,0,6,29,11,20,14,3,0
"20240316MIDBLA",2024-03-16,"England Championship","Middlesbrough","Blackburn",0,0,"D",16,12,3,3,10,9,8,5,3,3,0,0,0,0,0,0,28,6,19,13,6,0
"20240316PLYPRE",2024-03-16,"England Championship","Plymouth","Preston",0,1,"A",9,9,0,4,11,22,6,5,2,2,0,0,0,0,0,1,18,4,33,11,4,0
"20240316ROTHUD",2024-03-16,"England Championship","Rotherham","Huddersfield",0,0,"D",7,18,1,5,13,12,1,6,2,2,0,1,0,0,0,0,25,6,25,7,4,1
"20240316STONOR",2024-03-16,"England Championship","Stoke","Norwich",0,3,"A",10,16,1,7,12,7,7,6,1,0,0,0,0,0,0,3,26,8,19,13,1,0
"20240316SUNQPR",2024-03-16,"England Championship","Sunderland","QPR",0,0,"D",8,11,0,5,10,16,5,7,1,2,0,0,0,0,0,0,19,5,26,12,3,0
"20240316WESBRI",2024-03-16,"England Championship","West Brom","Bristol City",2,0,"H",12,10,4,5,6,14,3,7,4,2,0,0,0,0,0,2,22,9,20,10,6,0
"20240317LEEMIL",2024-03-17,"England Championship","Leeds","Millwall",2,0,"H",17,12,5,3,9,21,13,2,3,4,0,0,0,0,0,2,29,8,30,15,7,0
"20240329BRILEI",2024-03-29,"England Championship","Bristol City","Leicester",1,0,"H",16,11,6,3,12,13,5,6,2,0,0,0,0,0,0,1,27,9,25,11,2,0
"20240329MILWES",2024-03-29,"England Championship","Millwall","West Brom",1,1,"D",9,6,2,2,9,9,6,4,1,2,0,0,0,0,0,2,15,4,18,10,3,0
"20240329CARSUN",2024-03-29,"England Championship","Cardiff","Sunderland",0,2,"A",8,18,3,8,12,11,5,6,2,1,0,0,0,0,0,2,26,11,23,11,3,0
"20240329HUDCOV",2024-03-29,"England Championship","Huddersfield","Coventry",1,3,"A",15,12,4,7,13,18,10,4,1,4,0,0,0,0,0,4,27,11,31,14,5,0
"20240329HULSTO",2024-03-29,"England Championship","Hull","Stoke",0,2,"A",11,17,0,4,6,13,8,5,0,4,0,0,0,0,0,2,28,4,19,13,4,0
"20240329NORPLY",2024-03-29,"England Championship","Norwich","Plymouth",2,1,"H",23,9,4,4,11,12,13,3,0,7,0,0,0,0,0,3,32,8,23,16,7,0
"20240329PREROT",2024-03-29,"England Championship","Preston","Rotherham",3,0,"H",18,7,5,3,13,13,2,2,2,2,0,0,0,0,0,3,25,8,26,4,4,0
"20240329QPRBIR",2024-03-29,"England Championship","QPR","Birmingham",2,1,"H",18,13,6,3,11,12,6,2,2,2,0,0,0,0,0,3,31,9,23,8,4,0
"20240329SHESWA",2024-03-29,"England Championship","Sheffield Weds","Swansea",1,1,"D",14,8,4,4,10,8,3,4,1,1,0,0,0,0,0,2,22,8,18,7,2,0
"20240329SOUMID",2024-03-29,"England Championship","Southampton","Middlesbrough",1,1,"D",13,8,5,3,5,14,8,5,2,4,0,0,0,0,0,2,21,8,19,13,6,0
"20240329BLAIPS",2024-03-29,"England Championship","Blackburn","Ipswich",0,1,"A",8,11,3,3,13,13,9,2,2,3,0,0,0,0,0,1,19,6,26,11,5,0
"20240329WATLEE",2024-03-29,"England Championship","Watford","Leeds",2,2,"D",9,12,5,8,15,5,8,5,0,0,0,0,0,0,0,4,21,13,20,13,0,0
"20240401LEINOR",2024-04-01,"England Championship","Leicester","Norwich",3,1,"H",18,6,6,2,13,8,9,2,1,1,0,0,0,0,0,4,24,8,21,11,2,0
"20240401BIRPRE",2024-04-01,"England Championship","Birmingham","Preston",1,0,"H",11,4,4,1,7,9,0,0,1,1,0,0,0,0,0,1,15,5,16,0,2,0
"20240401COVCAR",2024-04-01,"England Championship","Coventry","Cardiff",1,2,"A",14,10,2,4,7,9,6,3,1,2,0,0,0,0,0,3,24,6,16,9,3,0
"20240401MIDSHE",2024-04-01,"England Championship","Middlesbrough","Sheffield Weds",2,0,"H",23,6,5,2,7,11,11,5,1,4,0,0,0,0,0,2,29,7,18,16,5,0
"20240401PLYBRI",2024-04-01,"England Championship","Plymouth","Bristol City",0,1,"A",12,14,2,6,14,12,9,6,2,3,1,0,0,0,0,1,26,8,26,15,5,1
"20240401ROTMIL",2024-04-01,"England Championship","Rotherham","Millwall",2,1,"H",5,21,4,7,11,10,2,11,2,0,0,0,0,0,0,3,26,11,21,13,2,0
"20240401STOHUD",2024-04-01,"England Championship","Stoke","Huddersfield",1,1,"D",15,12,6,3,14,13,6,7,3,1,0,0,0,0,0,2,27,9,27,13,4,0
"20240401SUNBLA",2024-04-01,"England Championship","Sunderland","Blackburn",1,5,"A",13,13,7,7,10,12,3,3,0,0,0,0,0,0,0,6,26,14,22,6,0,0
"20240401SWAQPR",2024-04-01,"England Championship","Swansea","QPR",0,1,"A",15,10,4,4,9,10,7,4,0,0,0,0,0,0,0,1,25,8,19,11,0,0
"20240401WESWAT",2024-04-01,"England Championship","West Brom","Watford",2,2,"D",10,12,4,7,6,13,7,3,0,1,0,0,0,0,0,4,22,11,19,10,1,0
"20240401IPSSOU",2024-04-01,"England Championship","Ipswich","Southampton",3,2,"H",13,17,6,8,14,12,0,7,3,1,0,1,0,0,0,5,30,14,26,7,4,1
"20240401LEEHUL",2024-04-01,"England Championship","Leeds","Hull",3,1,"H",14,11,6,2,19,13,4,3,2,2,0,0,0,0,0,4,25,8,32,7,4,0
"20240405ROTPLY",2024-04-05,"England Championship","Rotherham","Plymouth",0,1,"A",11,21,2,11,9,11,4,9,0,0,0,0,0,0,0,1,32,13,20,13,0,0
"20240406NORIPS",2024-04-06,"England Championship","Norwich","Ipswich",1,0,"H",12,10,3,3,10,16,4,6,0,1,0,0,0,0,0,1,22,6,26,10,1,0
"20240406BLASOU",2024-04-06,"England Championship","Blackburn","Southampton",0,0,"D",11,7,3,2,17,8,1,5,3,2,0,0,0,0,0,0,18,5,25,6,5,0
"20240406CARHUL",2024-04-06,"England Championship","Cardiff","Hull",1,3,"A",13,11,4,6,11,7,5,6,1,3,0,0,0,0,0,4,24,10,18,11,4,0
"20240406COVLEE",2024-04-06,"England Championship","Coventry","Leeds",2,1,"H",11,19,5,8,13,3,2,9,4,2,0,0,0,0,0,3,30,13,16,11,6,0
"20240406HUDMIL",2024-04-06,"England Championship","Huddersfield","Millwall",1,0,"H",17,6,7,1,7,21,10,3,4,4,0,0,0,0,0,1,23,8,28,13,8,0
"20240406LEIBIR",2024-04-06,"England Championship","Leicester","Birmingham",2,1,"H",17,11,9,5,7,11,10,0,2,2,0,0,0,0,0,3,28,14,18,10,4,0
"20240406MIDSWA",2024-04-06,"England Championship","Middlesbrough","Swansea",2,0,"H",12,7,4,1,16,16,4,6,2,2,0,0,0,0,0,2,19,5,32,10,4,0
"20240406QPRSHE",2024-04-06,"England Championship","QPR","Sheffield Weds",0,2,"A",16,7,1,4,13,10,5,2,3,3,0,0,0,0,0,2,23,5,23,7,6,0
"20240406STOWES",2024-04-06,"England Championship","Stoke","West Brom",2,2,"D",18,9,7,2,8,8,5,7,2,2,0,0,0,0,0,4,27,9,16,12,4,0
"20240406SUNBRI",2024-04-06,"England Championship","Sunderland","Bristol City",0,0,"D",20,8,7,2,12,10,4,4,1,1,0,0,0,0,0,0,28,9,22,8,2,0
"20240406WATPRE",2024-04-06,"England Championship","Watford","Preston",0,0,"D",11,9,2,1,6,13,7,5,2,1,0,0,0,0,0,0,20,3,19,12,3,0
"20240409MILLEI",2024-04-09,"England Championship","Millwall","Leicester",1,0,"H",6,11,4,3,11,6,3,9,3,1,0,0,0,0,0,1,17,7,17,12,4,0
"20240409PLYQPR",2024-04-09,"England Championship","Plymouth","QPR",1,1,"D",13,14,5,4,12,12,10,4,0,2,0,0,0,0,0,2,27,9,24,14,2,0
"20240409PREHUD",2024-04-09,"England Championship","Preston","Huddersfield",4,1,"H",14,8,7,2,10,13,8,2,3,2,0,0,0,0,0,5,22,9,23,10,5,0
"20240409SHENOR",2024-04-09,"England Championship","Sheffield Weds","Norwich",2,2,"D",11,13,5,6,15,9,10,3,2,1,0,0,0,0,0,4,24,11,24,13,3,0
"20240409SOUCOV",2024-04-09,"England Championship","Southampton","Coventry",2,1,"H",13,9,6,2,15,15,6,8,1,2,0,0,0,0,0,3,22,8,30,14,3,0
"20240409LEESUN",2024-04-09,"England Championship","Leeds","Sunderland",0,0,"D",12,6,1,3,10,13,13,2,2,4,0,0,0,0,0,0,18,4,23,15,6,0
"20240410BIRCAR",2024-04-10,"England Championship","Birmingham","Cardiff",0,1,"A",12,12,1,4,15,10,5,4,1,3,0,0,0,0,0,1,24,5,25,9,4,0
"20240410BRIBLA",2024-04-10,"England Championship","Bristol City","Blackburn",5,0,"H",15,9,7,4,7,15,6,8,0,2,0,0,0,0,0,5,24,11,22,14,2,0
"20240410HULMID",2024-04-10,"England Championship","Hull","Middlesbrough",2,2,"D",18,13,7,6,8,7,9,3,3,0,0,0,0,0,0,4,31,13,15,12,3,0
"20240410IPSWAT",2024-04-10,"England Championship","Ipswich","Watford",0,0,"D",15,10,4,3,13,16,3,4,2,1,0,0,0,0,0,0,25,7,29,7,3,0
"20240410SWASTO",2024-04-10,"England Championship","Swansea","Stoke",3,0,"H",12,10,4,1,15,16,2,6,3,3,0,0,0,0,0,3,22,5,31,8,6,0
"20240410WESROT",2024-04-10,"England Championship","West Brom","Rotherham",2,0,"H",11,12,4,1,4,9,4,5,0,1,0,0,0,0,0,2,23,5,13,9,1,0
"20240412PLYLEI",2024-04-12,"England Championship","Plymouth","Leicester",1,0,"H",5,17,3,4,12,12,0,13,5,2,0,0,0,0,0,1,22,7,24,13,7,0
"20240413LEEBLA",2024-04-13,"England Championship","Leeds","Blackburn",0,1,"A",19,3,5,2,5,15,12,1,1,4,0,0,0,0,0,1,22,7,20,13,5,0
"20240413BIRCOV",2024-04-13,"England Championship","Birmingham","Coventry",3,0,"H",15,12,4,2,13,12,3,6,3,2,0,0,0,0,0,3,27,6,25,9,5,0
"20240413BRIHUD",2024-04-13,"England Championship","Bristol City","Huddersfield",1,1,"D",9,13,3,4,7,18,12,4,1,6,0,0,0,0,0,2,22,7,25,16,7,0
"20240413HULQPR",2024-04-13,"England Championship","Hull","QPR",3,0,"H",7,11,5,3,12,17,4,4,2,1,0,0,0,0,0,3,18,8,29,8,3,0
"20240413IPSMID",2024-04-13,"England Championship","Ipswich","Middlesbrough",1,1,"D",21,11,5,5,11,6,6,4,2,2,0,0,1,1,0,2,32,10,17,10,4,0
"20240413MILCAR",2024-04-13,"England Championship","Millwall","Cardiff",3,1,"H",15,7,7,4,10,7,6,4,3,1,0,0,0,0,0,4,22,11,17,10,4,0
"20240413PRENOR",2024-04-13,"England Championship","Preston","Norwich",0,1,"A",12,15,2,5,11,9,5,6,3,1,0,0,0,0,0,1,27,7,20,11,4,0
"20240413SHESTO",2024-04-13,"England Championship","Sheffield Weds","Stoke",1,1,"D",15,8,5,2,9,20,8,1,1,4,0,0,0,0,0,2,23,7,29,9,5,0
"20240413SOUWAT",2024-04-13,"England Championship","Southampton","Watford",3,2,"H",13,12,4,6,6,15,6,3,1,3,0,0,0,0,0,5,25,10,21,9,4,0
"20240413SWAROT",2024-04-13,"England Championship","Swansea","Rotherham",1,0,"H",16,4,6,0,10,9,12,0,3,2,0,0,0,0,0,1,20,6,19,12,5,0
"20240413WESSUN",2024-04-13,"England Championship","West Brom","Sunderland",0,1,"A",8,9,3,3,15,12,1,5,3,3,1,0,0,0,0,1,17,6,27,6,6,1
"20240416SOUPRE",2024-04-16,"England Championship","Southampton","Preston",3,0,"H",23,1,6,1,7,12,5,0,0,2,0,0,0,0,0,3,24,7,19,5,2,0
"20240420LEIWES",2024-04-20,"England Championship","Leicester","West Brom",2,1,"H",11,18,3,6,15,13,4,6,3,2,0,0,0,0,0,3,29,9,28,10,5,0
"20240420CARSOU",2024-04-20,"England Championship","Cardiff","Southampton",2,1,"H",12,21,7,8,12,8,4,5,1,3,0,0,0,0,0,3,33,15,20,9,4,0
"20240420HUDSWA",2024-04-20,"England Championship","Huddersfield","Swansea",0,4,"A",9,19,0,7,15,10,4,7,2,1,0,0,0,0,0,4,28,7,25,11,3,0
"20240420NORBRI",2024-04-20,"England Championship","Norwich","Bristol City",1,1,"D",10,13,3,5,13,9,8,5,1,2,0,0,0,0,0,2,23,8,22,13,3,0
"20240420ROTBIR",2024-04-20,"England Championship","Rotherham","Birmingham",0,0,"D",11,6,4,2,16,11,7,6,4,2,0,0,0,0,0,0,17,6,27,13,6,0
"20240420STOPLY",2024-04-20,"England Championship","Stoke","Plymouth",3,0,"H",23,8,4,1,14,11,7,3,3,4,0,0,0,0,0,3,31,5,25,10,7,0
"20240420SUNMIL",2024-04-20,"England Championship","Sunderland","Millwall",0,1,"A",13,4,3,1,11,9,11,4,3,2,0,0,0,0,0,1,17,4,20,15,5,0
"20240420WATHUL",2024-04-20,"England Championship","Watford","Hull",0,0,"D",17,13,2,6,19,13,1,5,4,4,0,0,0,0,0,0,30,8,32,6,8,0
"20240420QPRPRE",2024-04-20,"England Championship","QPR","Preston",1,0,"H",18,10,7,2,9,16,5,3,2,4,0,0,0,0,0,1,28,9,25,8,6,0
"20240421BLASHE",2024-04-21,"England Championship","Blackburn","Sheffield Weds",1,3,"A",8,11,3,5,9,12,6,2,3,3,0,0,0,0,0,4,19,8,21,8,6,0
"20240422MIDLEE",2024-04-22,"England Championship","Middlesbrough","Leeds",3,4,"A",13,8,5,5,14,11,11,4,3,1,0,0,0,0,0,7,21,10,25,15,4,0
"20240423LEISOU",2024-04-23,"England Championship","Leicester","Southampton",5,0,"H",17,7,6,0,20,7,1,4,1,0,0,0,0,0,0,5,24,6,27,5,1,0
"20240424COVHUL",2024-04-24,"England Championship","Coventry","Hull",2,3,"A",7,14,3,8,7,13,4,8,2,4,0,0,0,0,0,5,21,11,20,12,6,0
"20240426QPRLEE",2024-04-26,"England Championship","QPR","Leeds",4,0,"H",11,15,5,5,9,14,7,8,1,2,0,0,0,0,0,4,26,10,23,15,3,0
"20240427BLACOV",2024-04-27,"England Championship","Blackburn","Coventry",0,0,"D",30,6,8,1,10,9,10,2,0,1,0,1,0,0,0,0,36,9,19,12,1,1
"20240427BRIROT",2024-04-27,"England Championship","Bristol City","Rotherham",2,0,"H",13,6,5,2,5,10,4,3,1,2,0,0,0,0,0,2,19,7,15,7,3,0
"20240427CARMID",2024-04-27,"England Championship","Cardiff","Middlesbrough",1,4,"A",15,12,4,7,7,10,4,1,0,0,0,0,0,0,0,5,27,11,17,5,0,0
"20240427HUDBIR",2024-04-27,"England Championship","Huddersfield","Birmingham",1,1,"D",12,12,4,2,7,19,9,5,1,4,0,0,0,0,0,2,24,6,26,14,5,0
"20240427MILPLY",2024-04-27,"England Championship","Millwall","Plymouth",1,0,"H",11,9,5,1,9,8,9,9,0,0,0,0,0,0,0,1,20,6,17,18,0,0
"20240427NORSWA",2024-04-27,"England Championship","Norwich","Swansea",2,2,"D",27,13,8,6,13,7,12,6,3,2,0,0,0,0,0,4,40,14,20,18,5,0
"20240427SHEWES",2024-04-27,"England Championship","Sheffield Weds","West Brom",3,0,"H",13,22,7,8,7,6,6,12,3,1,0,0,0,0,0,3,35,15,13,18,4,0
"20240427SOUSTO",2024-04-27,"England Championship","Southampton","Stoke",0,1,"A",14,15,3,8,4,14,8,7,2,1,0,0,0,0,0,1,29,11,18,15,3,0
"20240427WATSUN",2024-04-27,"England Championship","Watford","Sunderland",1,0,"H",10,11,3,6,11,9,3,3,2,1,0,0,0,0,0,1,21,9,20,6,3,0
"20240427HULIPS",2024-04-27,"England Championship","Hull","Ipswich",3,3,"D",14,21,7,11,13,14,6,8,1,3,0,0,0,0,0,6,35,18,27,14,4,0
"20240429PRELEI",2024-04-29,"England Championship","Preston","Leicester",0,3,"A",5,19,1,11,9,7,1,5,4,0,0,0,0,0,0,3,24,12,16,6,4,0
"20240430COVIPS",2024-04-30,"England Championship","Coventry","Ipswich",1,2,"A",13,14,3,9,10,13,7,6,1,1,0,0,0,0,0,3,27,12,23,13,2,0
"20240504BIRNOR",2024-05-04,"England Championship","Birmingham","Norwich",1,0,"H",12,5,3,2,10,8,6,3,2,0,0,0,0,0,0,1,17,5,18,9,2,0
"20240504COVQPR",2024-05-04,"England Championship","Coventry","QPR",1,2,"A",19,7,6,4,13,11,10,5,2,3,0,0,0,0,0,3,26,10,24,15,5,0
"20240504IPSHUD",2024-05-04,"England Championship","Ipswich","Huddersfield",2,0,"H",24,5,5,2,9,12,8,0,1,1,0,0,0,0,0,2,29,7,21,8,2,0
"20240504LEESOU",2024-05-04,"England Championship","Leeds","Southampton",1,2,"A",11,11,4,4,18,17,5,2,4,2,0,0,0,0,0,3,22,8,35,7,6,0
"20240504LEIBLA",2024-05-04,"England Championship","Leicester","Blackburn",0,2,"A",14,9,7,2,5,7,7,4,2,2,0,0,0,0,0,2,23,9,12,11,4,0
"20240504MIDWAT",2024-05-04,"England Championship","Middlesbrough","Watford",3,1,"H",14,14,6,4,9,5,3,3,1,1,0,0,0,0,0,4,28,10,14,6,2,0
"20240504PLYHUL",2024-05-04,"England Championship","Plymouth","Hull",1,0,"H",11,11,2,4,6,8,6,8,0,0,0,0,0,0,0,1,22,6,14,14,0,0
"20240504ROTCAR",2024-05-04,"England Championship","Rotherham","Cardiff",5,2,"H",16,20,7,5,9,6,4,6,1,0,0,0,1,1,0,7,36,12,15,10,1,0
"20240504STOBRI",2024-05-04,"England Championship","Stoke","Bristol City",4,0,"H",20,7,7,2,11,5,5,6,0,0,0,0,0,0,0,4,27,9,16,11,0,0
"20240504SUNSHE",2024-05-04,"England Championship","Sunderland","Sheffield Weds",0,2,"A",18,12,3,2,4,19,6,5,1,1,0,0,0,0,0,2,30,5,23,11,2,0
"20240504SWAMIL",2024-05-04,"England Championship","Swansea","Millwall",0,1,"A",9,12,2,4,3,9,4,5,0,2,1,1,0,0,0,1,21,6,12,9,2,2
"20240504WESPRE",2024-05-04,"England Championship","West Brom","Preston",3,0,"H",16,5,5,1,8,15,5,1,0,1,0,0,0,0,0,3,21,6,23,6,1,0
"20240809BLADER",2024-08-09,"England Championship","Blackburn","Derby",4,2,"H",11,12,7,4,9,10,1,9,1,3,0,0,0,0,0,6,23,11,19,10,4,0
"20240809PRESHE",2024-08-09,"England Championship","Preston","Sheffield United",0,2,"A",12,11,2,3,11,14,3,6,1,0,0,0,0,0,0,2,23,5,25,9,1,0
"20240810CARSUN",2024-08-10,"England Championship","Cardiff","Sunderland",0,2,"A",12,11,4,4,10,8,4,4,0,2,0,0,0,0,0,2,23,8,18,8,2,0
"20240810HULBRI",2024-08-10,"England Championship","Hull","Bristol City",1,1,"D",11,15,5,3,10,13,2,8,0,2,0,0,0,0,0,2,26,8,23,10,2,0
"20240810LEEPOR",2024-08-10,"England Championship","Leeds","Portsmouth",3,3,"D",22,5,10,4,19,21,12,0,2,4,0,0,0,0,0,6,27,14,40,12,6,0
"20240810MIDSWA",2024-08-10,"England Championship","Middlesbrough","Swansea",1,0,"H",18,5,4,0,14,12,6,9,1,4,0,0,1,0,1,1,23,4,26,15,5,0
"20240810MILWAT",2024-08-10,"England Championship","Millwall","Watford",2,3,"A",16,10,4,5,11,15,5,5,2,3,0,0,0,0,0,5,26,9,26,10,5,0
"20240810OXFNOR",2024-08-10,"England Championship","Oxford","Norwich",2,0,"H",12,10,4,2,4,14,5,5,1,3,0,0,0,0,0,2,22,6,18,10,4,0
"20240810QPRWES",2024-08-10,"England Championship","QPR","West Brom",1,3,"A",11,7,6,4,7,7,12,3,1,0,0,0,0,0,0,4,18,10,14,15,1,0
"20240810STOCOV",2024-08-10,"England Championship","Stoke","Coventry",1,0,"H",11,8,2,1,7,9,9,7,2,1,0,0,0,0,0,1,19,3,16,16,3,0
"20240811SHEPLY",2024-08-11,"England Championship","Sheffield Weds","Plymouth",4,0,"H",31,5,11,1,15,14,15,1,1,1,0,0,0,0,0,4,36,12,29,16,2,0
"20240812LUTBUR",2024-08-12,"England Championship","Luton","Burnley",1,4,"A",10,11,3,6,11,17,5,4,2,3,0,0,0,0,0,5,21,9,28,9,5,0
"20240816COVOXF",2024-08-16,"England Championship","Coventry","Oxford",3,2,"H",26,7,10,2,9,7,14,1,0,2,0,0,0,0,0,5,33,12,16,15,2,0
"20240817DERMID",2024-08-17,"England Championship","Derby","Middlesbrough",1,0,"H",3,20,2,4,13,5,3,8,3,1,0,0,0,0,0,1,23,6,18,11,4,0
"20240817PORLUT",2024-08-17,"England Championship","Portsmouth","Luton",0,0,"D",15,9,6,4,11,12,5,4,3,2,0,1,0,0,0,0,24,10,23,9,5,1
"20240817WESLEE",2024-08-17,"England Championship","West Brom","Leeds",0,0,"D",8,8,1,1,14,11,5,4,2,2,0,0,0,0,0,0,16,2,25,9,4,0
"20240817BRIMIL",2024-08-17,"England Championship","Bristol City","Millwall",4,3,"H",11,15,6,4,11,12,5,4,1,2,0,0,0,0,0,7,26,10,23,9,3,0
"20240817BURCAR",2024-08-17,"England Championship","Burnley","Cardiff",5,0,"H",9,11,4,4,19,6,2,5,2,1,0,0,1,0,1,5,20,8,25,7,3,0
"20240817NORBLA",2024-08-17,"England Championship","Norwich","Blackburn",2,2,"D",14,7,4,3,12,12,6,5,2,3,0,0,0,0,0,4,21,7,24,11,5,0
"20240817PLYHUL",2024-08-17,"England Championship","Plymouth","Hull",1,1,"D",16,14,7,2,13,16,6,3,3,1,0,0,0,0,0,2,30,9,29,9,4,0
"20240817SHEQPR",2024-08-17,"England Championship","Sheffield United","QPR",2,2,"D",14,14,3,3,15,9,4,9,2,2,0,1,0,0,0,4,28,6,24,13,4,1
"20240817SWAPRE",2024-08-17,"England Championship","Swansea","Preston",3,0,"H",12,5,6,2,11,21,5,3,1,3,0,0,0,0,0,3,17,8,32,8,4,0
"20240817WATSTO",2024-08-17,"England Championship","Watford","Stoke",3,0,"H",24,7,8,3,12,15,2,4,2,2,0,0,0,0,0,3,31,11,27,6,4,0
"20240818SUNSHE",2024-08-18,"England Championship","Sunderland","Sheffield Weds",4,0,"H",15,9,6,3,9,10,5,8,0,3,0,0,1,0,1,4,24,9,19,13,3,0
"20240823SHELEE",2024-08-23,"England Championship","Sheffield Weds","Leeds",0,2,"A",8,13,2,5,14,10,3,2,2,3,0,0,0,0,0,2,21,7,24,5,5,0
"20240824BRICOV",2024-08-24,"England Championship","Bristol City","Coventry",1,1,"D",12,8,7,1,8,16,8,2,2,4,0,0,0,0,0,2,20,8,24,10,6,0
"20240824HULMIL",2024-08-24,"England Championship","Hull","Millwall",0,0,"D",14,13,4,5,11,15,5,7,2,2,0,0,0,0,0,0,27,9,26,12,4,0
"20240824QPRPLY",2024-08-24,"England Championship","QPR","Plymouth",1,1,"D",30,6,10,1,10,14,11,1,2,3,0,2,0,0,0,2,36,11,24,12,5,2
"20240824BLAOXF",2024-08-24,"England Championship","Blackburn","Oxford",2,1,"H",18,13,4,3,14,8,7,5,2,1,0,0,0,0,0,3,31,7,22,12,3,0
"20240824MIDPOR",2024-08-24,"England Championship","Middlesbrough","Portsmouth",2,2,"D",29,7,7,3,10,15,15,2,0,5,0,0,0,0,0,4,36,10,25,17,5,0
"20240824NORSHE",2024-08-24,"England Championship","Norwich","Sheffield United",1,1,"D",7,12,5,4,14,7,1,5,5,2,0,0,0,0,0,2,19,9,21,6,7,0
"20240824PRELUT",2024-08-24,"England Championship","Preston","Luton",1,0,"H",6,17,2,4,16,10,2,13,6,1,0,0,0,0,0,1,23,6,26,15,7,0
"20240824STOWES",2024-08-24,"England Championship","Stoke","West Brom",1,2,"A",7,8,2,5,12,11,2,5,2,3,0,0,1,0,1,3,15,7,23,7,5,0
"20240824SUNBUR",2024-08-24,"England Championship","Sunderland","Burnley",1,0,"H",14,4,3,1,13,19,3,1,2,3,1,0,1,0,1,1,18,4,32,4,5,1
"20240824WATDER",2024-08-24,"England Championship","Watford","Derby",2,1,"H",12,8,3,3,10,11,4,2,2,3,0,0,0,0,0,3,20,6,21,6,5,0
"20240825SWACAR",2024-08-25,"England Championship","Swansea","Cardiff",1,1,"D",9,7,4,3,14,14,2,5,2,2,0,0,0,0,0,2,16,7,28,7,4,0
"20240830LUTQPR",2024-08-30,"England Championship","Luton","QPR",1,2,"A",11,11,5,4,13,10,4,5,3,2,0,0,0,0,0,3,22,9,23,9,5,0
"20240831BURBLA",2024-08-31,"England Championship","Burnley","Blackburn",1,1,"D",15,10,3,3,15,19,9,0,4,5,0,1,0,0,0,2,25,6,34,9,9,1
"20240831CARMID",2024-08-31,"England Championship","Cardiff","Middlesbrough",0,2,"A",12,10,3,5,13,10,4,6,2,1,0,0,0,0,0,2,22,8,23,10,3,0
"20240831COVNOR",2024-08-31,"England Championship","Coventry","Norwich",0,1,"A",14,9,5,1,11,10,6,3,4,3,0,0,0,0,0,1,23,6,21,9,7,0
"20240831DERBRI",2024-08-31,"England Championship","Derby","Bristol City",3,0,"H",19,13,7,5,15,11,6,9,1,0,0,0,0,0,0,3,32,12,26,15,1,0
"20240831LEEHUL",2024-08-31,"England Championship","Leeds","Hull",2,0,"H",16,9,5,2,12,15,8,7,2,1,0,0,0,0,0,2,25,7,27,15,3,0
"20240831MILSHE",2024-08-31,"England Championship","Millwall","Sheffield Weds",3,0,"H",18,4,4,1,16,13,6,6,2,1,0,0,0,0,0,3,22,5,29,12,3,0
"20240831OXFPRE",2024-08-31,"England Championship","Oxford","Preston",3,1,"H",10,10,5,4,8,21,2,5,2,2,0,1,0,0,0,4,20,9,29,7,4,1
"20240831PLYSTO",2024-08-31,"England Championship","Plymouth","Stoke",0,1,"A",15,15,7,7,14,17,10,4,1,3,0,0,0,0,0,1,30,14,31,14,4,0
"20240831PORSUN",2024-08-31,"England Championship","Portsmouth","Sunderland",1,3,"A",6,11,2,4,14,14,5,5,3,1,0,0,0,0,0,4,17,6,28,10,4,0
"20240831WESSWA",2024-08-31,"England Championship","West Brom","Swansea",1,0,"H",18,6,5,2,8,11,6,7,4,1,0,0,0,0,0,1,24,7,19,13,5,0
"20240901SHEWAT",2024-09-01,"England Championship","Sheffield United","Watford",1,0,"H",18,7,7,1,15,12,8,5,5,3,0,0,0,0,0,1,25,8,27,13,8,0
"20240913HULSHE",2024-09-13,"England Championship","Hull","Sheffield United",0,2,"A",10,9,2,4,6,10,16,3,1,4,0,0,0,0,0,2,19,6,16,19,5,0
"20240914LEEBUR",2024-09-14,"England Championship","Leeds","Burnley",0,1,"A",17,7,4,3,8,13,9,3,3,4,0,1,0,0,0,1,24,7,21,12,7,1
"20240914MILLUT",2024-09-14,"England Championship","Millwall","Luton",0,1,"A",11,10,3,6,8,20,6,4,2,3,0,0,0,0,0,1,21,9,28,10,5,0
"20240914OXFSTO",2024-09-14,"England Championship","Oxford","Stoke",1,0,"H",14,9,8,1,5,6,4,6,0,1,0,0,0,0,0,1,23,9,11,10,1,0
"20240914BLABRI",2024-09-14,"England Championship","Blackburn","Bristol City",3,0,"H",9,8,3,2,13,15,6,6,0,4,0,0,0,0,0,3,17,5,28,12,4,0
"20240914DERCAR",2024-09-14,"England Championship","Derby","Cardiff",1,0,"H",12,9,3,3,12,10,7,6,2,3,0,0,0,0,0,1,21,6,22,13,5,0
"20240914MIDPRE",2024-09-14,"England Championship","Middlesbrough","Preston",1,1,"D",16,6,6,2,6,21,9,2,0,5,0,0,0,0,0,2,22,8,27,11,5,0
"20240914PLYSUN",2024-09-14,"England Championship","Plymouth","Sunderland",3,2,"H",13,17,6,7,14,12,3,5,4,4,0,0,0,0,0,5,30,13,26,8,8,0
"20240914SHEQPR",2024-09-14,"England Championship","Sheffield Weds","QPR",1,1,"D",13,13,2,4,6,7,11,4,0,3,0,0,0,0,0,2,26,6,13,15,3,0
"20240914SWANOR",2024-09-14,"England Championship","Swansea","Norwich",1,0,"H",9,13,4,3,14,14,4,5,2,3,0,0,0,0,0,1,22,7,28,9,5,0
"20240914WATCOV",2024-09-14,"England Championship","Watford","Coventry",1,1,"D",18,17,6,5,9,10,6,10,2,2,0,0,0,0,0,2,35,11,19,16,4,0
"20240915PORWES",2024-09-15,"England Championship","Portsmouth","West Brom",0,3,"A",14,19,0,7,18,6,10,4,5,2,0,0,0,0,0,3,33,7,24,14,7,0
"20240920STOHUL",2024-09-20,"England Championship","Stoke","Hull",1,3,"A",14,13,2,3,12,10,2,5,3,2,0,0,0,0,0,4,27,5,22,7,5,0
"20240921NORWAT",2024-09-21,"England Championship","Norwich","Watford",4,1,"H",19,11,8,3,6,8,3,5,2,1,0,0,0,0,0,5,30,11,14,8,3,0
"20240921QPRMIL",2024-09-21,"England Championship","QPR","Millwall",1,1,"D",7,16,2,5,9,12,5,10,2,1,0,0,0,0,0,2,23,7,21,15,3,0
"20240921SUNMID",2024-09-21,"England Championship","Sunderland","Middlesbrough",1,0,"H",9,11,2,1,8,15,3,5,3,2,0,0,0,0,0,1,20,3,23,8,5,0
"20240921BRIOXF",2024-09-21,"England Championship","Bristol City","Oxford",2,1,"H",19,7,6,2,16,14,5,1,1,4,0,0,1,1,0,3,26,8,30,6,5,0
"20240921BURPOR",2024-09-21,"England Championship","Burnley","Portsmouth",2,1,"H",18,5,4,2,15,4,4,2,2,2,0,0,0,0,0,3,23,6,19,6,4,0
"20240921CARLEE",2024-09-21,"England Championship","Cardiff","Leeds",0,2,"A",3,15,2,7,10,14,0,4,2,2,1,0,0,0,0,2,18,9,24,4,4,1
"20240921COVSWA",2024-09-21,"England Championship","Coventry","Swansea",1,2,"A",20,11,7,4,12,5,6,3,2,3,0,0,0,0,0,3,31,11,17,9,5,0
"20240921LUTSHE",2024-09-21,"England Championship","Luton","Sheffield Weds",2,1,"H",15,12,3,6,9,14,8,5,1,1,0,1,0,0,0,3,27,9,23,13,2,1
"20240921SHEDER",2024-09-21,"England Championship","Sheffield United","Derby",1,0,"H",18,3,5,0,11,13,11,2,3,2,0,0,0,0,0,1,21,5,24,13,5,0
"20240921WESPLY",2024-09-21,"England Championship","West Brom","Plymouth",1,0,"H",17,17,4,4,9,9,5,2,3,2,0,0,0,0,0,1,34,8,18,7,5,0
"20240922PREBLA",2024-09-22,"England Championship","Preston","Blackburn",0,0,"D",7,6,5,3,10,16,4,4,4,4,1,1,0,0,0,0,13,8,26,8,8,2
"20240927PLYLUT",2024-09-27,"England Championship","Plymouth","Luton",3,1,"H",19,16,6,2,4,13,3,15,1,4,0,0,0,0,0,4,35,8,17,18,5,0
"20240928BLAQPR",2024-09-28,"England Championship","Blackburn","QPR",2,0,"H",19,6,12,1,16,11,8,2,3,2,0,1,0,0,0,2,25,13,27,10,5,1
"20240928DERNOR",2024-09-28,"England Championship","Derby","Norwich",2,3,"A",16,10,5,5,13,7,9,5,3,2,0,0,0,0,0,5,26,10,20,14,5,0
"20240928SHEWES",2024-09-28,"England Championship","Sheffield Weds","West Brom",3,2,"H",12,12,5,3,11,14,5,4,5,3,0,0,0,0,0,5,24,8,25,9,8,0
"20240928HULCAR",2024-09-28,"England Championship","Hull","Cardiff",4,1,"H",18,16,9,5,9,12,7,5,3,4,0,0,0,0,0,5,34,14,21,12,7,0
"20240928LEECOV",2024-09-28,"England Championship","Leeds","Coventry",3,0,"H",13,7,8,2,16,15,7,3,1,1,0,0,0,0,0,3,20,10,31,10,2,0
"20240928MIDSTO",2024-09-28,"England Championship","Middlesbrough","Stoke",2,0,"H",26,7,9,1,10,17,7,2,4,7,0,0,0,0,0,2,33,10,27,9,11,0
"20240928MILPRE",2024-09-28,"England Championship","Millwall","Preston",3,1,"H",14,11,6,4,16,10,3,8,2,2,1,0,0,0,0,4,25,10,26,11,4,1
"20240928OXFBUR",2024-09-28,"England Championship","Oxford","Burnley",0,0,"D",3,14,1,1,8,13,2,6,1,2,0,0,0,0,0,0,17,2,21,8,3,0
"20240928PORSHE",2024-09-28,"England Championship","Portsmouth","Sheffield United",0,0,"D",9,12,2,4,12,19,15,9,2,2,0,0,0,0,0,0,21,6,31,24,4,0
"20240928WATSUN",2024-09-28,"England Championship","Watford","Sunderland",2,1,"H",13,17,5,5,11,11,4,6,2,1,0,0,0,0,0,3,30,10,22,10,3,0
"20240929SWABRI",2024-09-29,"England Championship","Swansea","Bristol City",1,1,"D",7,15,2,6,10,15,3,8,1,3,0,0,0,0,0,2,22,8,25,11,4,0
"20241001BURPLY",2024-10-01,"England Championship","Burnley","Plymouth",1,0,"H",11,7,3,0,14,8,7,1,1,0,0,0,0,0,0,1,18,3,22,8,1,0
"20241001CARMIL",2024-10-01,"England Championship","Cardiff","Millwall",1,0,"H",10,11,5,5,14,12,5,6,1,3,0,0,0,0,0,1,21,10,26,11,4,0
"20241001COVBLA",2024-10-01,"England Championship","Coventry","Blackburn",3,0,"H",18,10,8,3,12,12,5,1,1,3,0,0,0,0,0,3,28,11,24,6,4,0
"20241001LUTOXF",2024-10-01,"England Championship","Luton","Oxford",2,2,"D",12,19,4,8,13,12,5,6,3,3,1,0,0,0,0,4,31,12,25,11,6,1
"20241001NORLEE",2024-10-01,"England Championship","Norwich","Leeds",1,1,"D",7,14,1,3,12,18,9,6,2,4,0,0,1,0,1,2,21,4,30,15,6,0
"20241001QPRHUL",2024-10-01,"England Championship","QPR","Hull",1,3,"A",21,15,7,6,12,11,5,6,1,3,0,0,0,0,0,4,36,13,23,11,4,0
"20241001SUNDER",2024-10-01,"England Championship","Sunderland","Derby",2,0,"H",9,13,3,5,7,19,1,8,2,2,0,0,0,0,0,2,22,8,26,9,4,0
"20241001WESMID",2024-10-01,"England Championship","West Brom","Middlesbrough",0,1,"A",11,15,1,4,7,6,5,4,2,1,0,0,0,0,0,1,26,5,13,9,3,0
"20241002PREWAT",2024-10-02,"England Championship","Preston","Watford",3,0,"H",15,10,6,6,12,12,7,5,2,0,0,0,0,0,0,3,25,12,24,12,2,0
"20241002SHESWA",2024-10-02,"England Championship","Sheffield United","Swansea",1,0,"H",15,7,3,1,13,9,5,5,3,2,0,0,0,0,0,1,22,4,22,10,5,0
"20241002STOPOR",2024-10-02,"England Championship","Stoke","Portsmouth",6,1,"H",20,9,8,2,9,13,3,5,2,1,0,0,0,0,0,7,29,10,22,8,3,0
"20241002BRISHE",2024-10-02,"England Championship","Bristol City","Sheffield Weds",0,0,"D",10,8,2,1,10,12,6,5,2,1,0,0,0,0,0,0,18,3,22,11,3,0
"20241004SUNLEE",2024-10-04,"England Championship","Sunderland","Leeds",2,2,"D",14,15,4,4,11,16,8,1,3,3,0,0,0,0,0,4,29,8,27,9,6,0
"20241005BURPRE",2024-10-05,"England Championship","Burnley","Preston",0,0,"D",9,9,1,2,10,12,2,3,3,4,0,0,0,0,0,0,18,3,22,5,7,0
"20241005NORHUL",2024-10-05,"England Championship","Norwich","Hull",4,0,"H",19,16,9,5,11,14,4,7,3,4,0,0,0,0,0,4,35,14,25,11,7,0
"20241005POROXF",2024-10-05,"England Championship","Portsmouth","Oxford",1,1,"D",21,13,8,3,11,10,11,4,0,1,0,0,0,0,0,2,34,11,21,15,1,0
"20241005COVSHE",2024-10-05,"England Championship","Coventry","Sheffield Weds",1,2,"A",13,13,2,5,12,17,6,6,4,3,0,0,0,0,0,3,26,7,29,12,7,0
"20241005DERQPR",2024-10-05,"England Championship","Derby","QPR",2,0,"H",10,11,5,3,12,10,6,9,1,1,0,0,0,0,0,2,21,8,22,15,2,0
"20241005PLYBLA",2024-10-05,"England Championship","Plymouth","Blackburn",2,1,"H",17,7,7,4,8,16,5,5,4,3,0,0,0,0,0,3,24,11,24,10,7,0
"20241005SHELUT",2024-10-05,"England Championship","Sheffield United","Luton",2,0,"H",15,8,7,2,10,8,5,6,2,1,0,0,0,0,0,2,23,9,18,11,3,0
"20241005SWASTO",2024-10-05,"England Championship","Swansea","Stoke",0,0,"D",19,10,5,4,8,14,5,9,0,4,0,0,0,0,0,0,29,9,22,14,4,0
"20241005WATMID",2024-10-05,"England Championship","Watford","Middlesbrough",2,1,"H",9,11,4,5,15,11,7,5,3,1,0,0,0,0,0,3,20,9,26,12,4,0
"20241005WESMIL",2024-10-05,"England Championship","West Brom","Millwall",0,0,"D",13,6,3,4,8,15,5,2,2,3,0,0,0,0,0,0,19,7,23,7,5,0
"20241006BRICAR",2024-10-06,"England Championship","Bristol City","Cardiff",1,1,"D",16,15,2,2,8,12,4,6,2,1,0,0,0,0,0,2,31,4,20,10,3,0
"20241018LEESHE",2024-10-18,"England Championship","Leeds","Sheffield United",2,0,"H",13,5,4,0,10,10,7,3,1,2,0,0,0,0,0,2,18,4,20,10,3,0
"20241019CARPLY",2024-10-19,"England Championship","Cardiff","Plymouth",5,0,"H",25,6,11,2,15,10,9,1,3,1,0,1,0,0,0,5,31,13,25,10,4,1
"20241019LUTWAT",2024-10-19,"England Championship","Luton","Watford",3,0,"H",13,9,5,1,22,20,11,4,3,2,0,0,0,0,0,3,22,6,42,15,5,0
"20241019OXFWES",2024-10-19,"England Championship","Oxford","West Brom",1,1,"D",12,14,3,3,16,10,5,8,3,1,0,0,0,0,0,2,26,6,26,13,4,0
"20241019PRECOV",2024-10-19,"England Championship","Preston","Coventry",1,0,"H",18,12,3,1,12,12,9,9,4,0,0,0,0,0,0,1,30,4,24,18,4,0
"20241019BLASWA",2024-10-19,"England Championship","Blackburn","Swansea",1,0,"H",8,14,3,2,15,5,3,8,1,2,0,0,0,0,0,1,22,5,20,11,3,0
"20241019MIDBRI",2024-10-19,"England Championship","Middlesbrough","Bristol City",0,2,"A",20,9,2,3,13,10,7,0,5,3,0,0,0,0,0,2,29,5,23,7,8,0
"20241019MILDER",2024-10-19,"England Championship","Millwall","Derby",1,1,"D",16,5,6,1,12,14,9,5,2,0,0,0,0,0,0,2,21,7,26,14,2,0
"20241019QPRPOR",2024-10-19,"England Championship","QPR","Portsmouth",1,2,"A",15,11,8,3,11,11,3,5,1,3,0,0,0,0,0,3,26,11,22,8,4,0
"20241019SHEBUR",2024-10-19,"England Championship","Sheffield Weds","Burnley",0,2,"A",13,14,3,6,10,11,10,3,1,2,0,0,0,0,0,2,27,9,21,13,3,0
"20241019STONOR",2024-10-19,"England Championship","Stoke","Norwich",1,1,"D",14,12,5,4,7,9,8,7,0,1,0,0,0,0,0,2,26,9,16,15,1,0
"20241020HULSUN",2024-10-20,"England Championship","Hull","Sunderland",0,1,"A",8,10,0,2,12,8,4,4,1,1,0,0,1,0,1,1,18,2,20,8,2,0
"20241022CARPOR",2024-10-22,"England Championship","Cardiff","Portsmouth",2,0,"H",24,8,10,2,9,13,12,5,2,2,0,0,0,0,0,2,32,12,22,17,4,0
"20241022LEEWAT",2024-10-22,"England Championship","Leeds","Watford",2,1,"H",24,9,7,3,7,11,10,4,2,1,0,0,0,0,0,3,33,10,18,14,3,0
"20241022OXFDER",2024-10-22,"England Championship","Oxford","Derby",1,1,"D",11,17,3,4,8,8,1,6,1,5,0,0,0,0,0,2,28,7,16,7,6,0
"20241022PRENOR",2024-10-22,"England Championship","Preston","Norwich",2,2,"D",8,9,2,3,12,15,5,2,2,3,0,0,0,0,0,4,17,5,27,7,5,0
"20241022SHESWA",2024-10-22,"England Championship","Sheffield Weds","Swansea",0,0,"D",8,9,0,1,8,5,9,6,0,4,0,0,0,0,0,0,17,1,13,15,4,0
"20241022STOBRI",2024-10-22,"England Championship","Stoke","Bristol City",2,2,"D",10,28,6,10,10,5,6,13,3,1,0,0,0,0,0,4,38,16,15,19,4,0
"20241022QPRCOV",2024-10-22,"England Championship","QPR","Coventry",1,1,"D",16,8,5,3,7,13,7,3,2,1,0,0,0,0,0,2,24,8,20,10,3,0
"20241023BLAWES",2024-10-23,"England Championship","Blackburn","West Brom",0,0,"D",8,9,2,4,10,7,4,4,2,0,0,0,0,0,0,0,17,6,17,8,2,0
"20241023HULBUR",2024-10-23,"England Championship","Hull","Burnley",1,1,"D",11,11,2,5,4,15,4,8,0,1,0,0,0,0,0,2,22,7,19,12,1,0
"20241023LUTSUN",2024-10-23,"England Championship","Luton","Sunderland",1,2,"A",19,9,4,5,14,12,10,3,2,4,0,0,0,0,0,3,28,9,26,13,6,0
"20241023MILPLY",2024-10-23,"England Championship","Millwall","Plymouth",1,0,"H",13,9,6,2,12,11,6,2,5,1,0,0,0,0,0,1,22,8,23,8,6,0
"20241023MIDSHE",2024-10-23,"England Championship","Middlesbrough","Sheffield United",1,0,"H",18,9,6,5,7,4,8,6,0,1,0,0,0,0,0,1,27,11,11,14,1,0
"20241025PORSHE",2024-10-25,"England Championship","Portsmouth","Sheffield Weds",1,2,"A",9,9,2,3,10,14,7,7,1,3,0,0,0,0,0,3,18,5,24,14,4,0
"20241026BRILEE",2024-10-26,"England Championship","Bristol City","Leeds",0,0,"D",4,17,0,5,11,10,7,6,1,3,0,0,0,0,0,0,21,5,21,13,4,0
"20241026COVLUT",2024-10-26,"England Championship","Coventry","Luton",3,2,"H",26,9,10,5,9,16,11,5,2,3,0,1,0,0,0,5,35,15,25,16,5,1
"20241026WATBLA",2024-10-26,"England Championship","Watford","Blackburn",1,0,"H",10,12,1,2,9,17,6,3,5,4,0,0,0,0,0,1,22,3,26,9,9,0
"20241026BURQPR",2024-10-26,"England Championship","Burnley","QPR",0,0,"D",22,2,4,0,7,10,16,1,0,1,0,0,0,0,0,0,24,4,17,17,1,0
"20241026DERHUL",2024-10-26,"England Championship","Derby","Hull",1,1,"D",14,11,3,5,10,11,5,3,1,4,0,0,0,0,0,2,25,8,21,8,5,0
"20241026PLYPRE",2024-10-26,"England Championship","Plymouth","Preston",3,3,"D",12,16,6,8,12,16,2,1,0,3,0,0,0,0,0,6,28,14,28,3,3,0
"20241026SHESTO",2024-10-26,"England Championship","Sheffield United","Stoke",2,0,"H",19,7,6,3,12,14,5,3,4,2,0,0,0,0,0,2,26,9,26,8,6,0
"20241026SUNOXF",2024-10-26,"England Championship","Sunderland","Oxford",2,0,"H",13,5,6,2,9,8,8,2,2,2,0,0,0,0,0,2,18,8,17,10,4,0
"20241026SWAMIL",2024-10-26,"England Championship","Swansea","Millwall",0,1,"A",17,6,5,2,13,14,10,6,1,4,0,0,0,0,0,1,23,7,27,16,5,0
"20241026WESCAR",2024-10-26,"England Championship","West Brom","Cardiff",0,0,"D",19,5,4,0,9,18,12,1,4,3,0,0,0,0,0,0,24,4,27,13,7,0
"20241027NORMID",2024-10-27,"England Championship","Norwich","Middlesbrough",3,3,"D",9,14,3,8,15,7,3,2,2,3,1,0,0,0,0,6,23,11,22,5,5,1
"20241101LUTWES",2024-11-01,"England Championship","Luton","West Brom",1,1,"D",13,10,5,3,10,13,6,3,1,2,0,0,0,0,0,2,23,8,23,9,3,0
"20241102BLASHE",2024-11-02,"England Championship","Blackburn","Sheffield United",0,2,"A",9,20,0,9,11,14,5,8,1,2,0,0,0,0,0,2,29,9,25,13,3,0
"20241102OXFSWA",2024-11-02,"England Championship","Oxford","Swansea",1,2,"A",9,16,2,5,15,8,1,8,1,1,0,0,0,0,0,3,25,7,23,9,2,0
"20241102STODER",2024-11-02,"England Championship","Stoke","Derby",2,1,"H",13,9,4,3,10,14,9,4,2,3,0,0,0,0,0,3,22,7,24,13,5,0
"20241102CARNOR",2024-11-02,"England Championship","Cardiff","Norwich",2,1,"H",11,16,5,6,11,15,4,4,3,2,0,0,0,0,0,3,27,11,26,8,5,0
"20241102HULPOR",2024-11-02,"England Championship","Hull","Portsmouth",1,1,"D",10,9,3,5,12,7,5,3,1,4,0,0,0,0,0,2,19,8,19,8,5,0
"20241102LEEPLY",2024-11-02,"England Championship","Leeds","Plymouth",3,0,"H",23,0,7,0,11,15,9,0,0,0,0,0,0,0,0,3,23,7,26,9,0,0
"20241102MIDCOV",2024-11-02,"England Championship","Middlesbrough","Coventry",0,3,"A",9,10,1,4,4,12,6,8,1,3,1,0,0,0,0,3,19,5,16,14,4,1
"20241102PREBRI",2024-11-02,"England Championship","Preston","Bristol City",1,3,"A",14,5,2,3,11,20,4,1,4,3,0,0,0,0,0,4,19,5,31,5,7,0
"20241102QPRSUN",2024-11-02,"England Championship","QPR","Sunderland",0,0,"D",17,8,3,1,12,10,6,6,1,2,0,1,0,0,0,0,25,4,22,12,3,1
"20241102SHEWAT",2024-11-02,"England Championship","Sheffield Weds","Watford",2,6,"A",14,16,6,8,14,16,6,2,3,3,0,0,0,0,0,8,30,14,30,8,6,0
"20241103MILBUR",2024-11-03,"England Championship","Millwall","Burnley",1,0,"H",12,8,3,0,17,12,2,3,2,2,0,0,0,0,0,1,20,3,29,5,4,0
"20241105BRISHE",2024-11-05,"England Championship","Bristol City","Sheffield United",1,2,"A",12,11,2,4,8,12,2,5,0,2,1,0,0,0,0,3,23,6,20,7,2,1
"20241105OXFHUL",2024-11-05,"England Championship","Oxford","Hull",1,0,"H",4,12,2,2,8,10,2,6,2,1,0,0,0,0,0,1,16,4,18,8,3,0
"20241105QPRMID",2024-11-05,"England Championship","QPR","Middlesbrough",1,4,"A",7,12,5,8,8,11,8,5,0,2,0,0,0,0,0,5,19,13,19,13,2,0
"20241105SHENOR",2024-11-05,"England Championship","Sheffield Weds","Norwich",2,0,"H",12,5,5,3,6,16,2,5,0,0,0,0,0,0,0,2,17,8,22,7,0,0
"20241105PLYPOR",2024-11-05,"England Championship","Plymouth","Portsmouth",1,0,"H",10,14,4,4,8,21,5,6,4,2,0,0,0,0,0,1,24,8,29,11,6,0
"20241105SWAWAT",2024-11-05,"England Championship","Swansea","Watford",1,0,"H",12,7,3,0,9,10,6,8,3,2,0,0,0,0,0,1,19,3,19,14,5,0
"20241106BLASTO",2024-11-06,"England Championship","Blackburn","Stoke",0,2,"A",25,15,8,7,8,8,9,4,1,2,0,0,0,0,0,2,40,15,16,13,3,0
"20241106COVDER",2024-11-06,"England Championship","Coventry","Derby",1,2,"A",11,3,3,1,5,11,9,6,0,2,0,0,0,0,0,3,14,4,16,15,2,0
"20241106MILLEE",2024-11-06,"England Championship","Millwall","Leeds",1,0,"H",6,14,3,4,11,14,2,12,2,1,0,0,0,0,0,1,20,7,25,14,3,0
"20241106LUTCAR",2024-11-06,"England Championship","Luton","Cardiff",1,0,"H",8,10,3,3,12,13,6,6,2,1,0,0,0,0,0,1,18,6,25,12,3,0
"20241106PRESUN",2024-11-06,"England Championship","Preston","Sunderland",0,0,"D",14,10,2,2,20,11,4,4,2,1,0,0,0,0,0,0,24,4,31,8,3,0
"20241107WESBUR",2024-11-07,"England Championship","West Brom","Burnley",0,0,"D",11,12,1,4,6,20,2,8,3,3,0,0,0,0,0,0,23,5,26,10,6,0
"20241108WATOXF",2024-11-08,"England Championship","Watford","Oxford",1,0,"H",16,10,8,3,12,8,11,4,5,2,0,0,0,0,0,1,26,11,20,15,7,0
"20241109CARBLA",2024-11-09,"England Championship","Cardiff","Blackburn",1,3,"A",20,10,8,7,11,6,12,1,0,3,0,0,0,0,0,4,30,15,17,13,3,0
"20241109MIDLUT",2024-11-09,"England Championship","Middlesbrough","Luton",5,1,"H",11,5,6,3,6,15,1,1,1,4,0,0,1,0,1,6,16,9,21,2,5,0
"20241109STOMIL",2024-11-09,"England Championship","Stoke","Millwall",1,1,"D",8,7,3,1,13,8,9,2,2,2,0,0,0,0,0,2,15,4,21,11,4,0
"20241109DERPLY",2024-11-09,"England Championship","Derby","Plymouth",1,1,"D",20,5,4,2,7,11,8,3,1,4,0,0,0,0,0,2,25,6,18,11,5,0
"20241109LEEQPR",2024-11-09,"England Championship","Leeds","QPR",2,0,"H",21,5,6,0,12,13,7,1,1,2,0,0,0,0,0,2,26,6,25,8,3,0
"20241109NORBRI",2024-11-09,"England Championship","Norwich","Bristol City",0,2,"A",9,9,3,2,16,8,3,3,2,0,0,0,0,0,0,2,18,5,24,6,2,0
"20241109PORPRE",2024-11-09,"England Championship","Portsmouth","Preston",3,1,"H",18,6,6,1,12,13,11,5,1,0,0,0,1,0,1,4,24,7,25,16,1,0
"20241109SUNCOV",2024-11-09,"England Championship","Sunderland","Coventry",2,2,"D",9,8,5,3,10,16,2,7,3,4,0,0,0,0,0,4,17,8,26,9,7,0
"20241110SHESHE",2024-11-10,"England Championship","Sheffield United","Sheffield Weds",1,0,"H",8,10,1,0,15,22,5,6,1,3,0,0,0,0,0,1,18,1,37,11,4,0
"20241110HULWES",2024-11-10,"England Championship","Hull","West Brom",1,2,"A",13,5,3,3,16,10,4,3,1,2,0,0,0,0,0,3,18,6,26,7,3,0
"20241110BURSWA",2024-11-10,"England Championship","Burnley","Swansea",1,0,"H",2,9,7,4,13,12,5,1,1,3,0,0,0,0,0,1,11,11,25,6,4,0
"20241122PLYWAT",2024-11-22,"England Championship","Plymouth","Watford",2,2,"D",10,12,3,5,5,13,2,8,2,1,0,0,0,0,0,4,22,8,18,10,3,0
"20241123BRIBUR",2024-11-23,"England Championship","Bristol City","Burnley",0,1,"A",7,14,2,5,9,15,8,3,3,4,0,0,0,0,0,1,21,7,24,11,7,0
"20241123COVSHE",2024-11-23,"England Championship","Coventry","Sheffield United",2,2,"D",20,7,6,2,13,6,12,2,4,2,0,1,0,0,0,4,27,8,19,14,6,1
"20241123SHECAR",2024-11-23,"England Championship","Sheffield Weds","Cardiff",1,1,"D",16,9,3,4,8,13,6,2,0,1,0,0,0,0,0,2,25,7,21,8,1,0
"20241123LUTHUL",2024-11-23,"England Championship","Luton","Hull",1,0,"H",7,14,2,2,10,10,10,4,2,1,0,0,0,0,0,1,21,4,20,14,3,0
"20241123MILSUN",2024-11-23,"England Championship","Millwall","Sunderland",1,1,"D",11,9,5,6,14,16,10,2,1,2,0,0,0,0,0,2,20,11,30,12,3,0
"20241123OXFMID",2024-11-23,"England Championship","Oxford","Middlesbrough",2,6,"A",11,16,7,12,9,8,6,9,1,3,0,0,0,0,0,8,27,19,17,15,4,0
"20241123PREDER",2024-11-23,"England Championship","Preston","Derby",1,1,"D",11,5,3,1,8,12,7,3,2,2,0,0,0,0,0,2,16,4,20,10,4,0
"20241123QPRSTO",2024-11-23,"England Championship","QPR","Stoke",1,1,"D",23,9,5,5,9,10,10,4,3,2,0,0,1,0,1,2,32,10,19,14,5,0
"20241123WESNOR",2024-11-23,"England Championship","West Brom","Norwich",2,2,"D",22,11,6,5,4,12,11,2,1,2,0,0,0,0,0,4,33,11,16,13,3,0
"20241124SWALEE",2024-11-24,"England Championship","Swansea","Leeds",3,4,"A",10,13,5,4,11,11,1,2,1,2,0,0,0,0,0,7,23,9,22,3,3,0
"20241126BURCOV",2024-11-26,"England Championship","Burnley","Coventry",2,0,"H",12,3,3,1,10,7,6,2,0,1,0,0,1,0,1,2,15,4,17,8,1,0
"20241126HULSHE",2024-11-26,"England Championship","Hull","Sheffield Weds",0,2,"A",9,16,3,4,12,9,4,6,1,2,0,0,0,0,0,2,25,7,21,10,3,0
"20241126NORPLY",2024-11-26,"England Championship","Norwich","Plymouth",6,1,"H",19,13,10,4,11,5,8,4,0,1,0,0,0,0,0,7,32,14,16,12,1,0
"20241126SHEOXF",2024-11-26,"England Championship","Sheffield United","Oxford",3,0,"H",14,9,8,3,8,7,7,7,1,1,0,0,0,0,0,3,23,11,15,14,2,0
"20241126STOPRE",2024-11-26,"England Championship","Stoke","Preston",0,0,"D",12,8,1,3,7,10,8,10,1,1,0,0,0,0,0,0,20,4,17,18,2,0
"20241126WATBRI",2024-11-26,"England Championship","Watford","Bristol City",1,0,"H",7,14,1,5,15,11,3,6,2,2,0,0,0,0,0,1,21,6,26,9,4,0
"20241126SUNWES",2024-11-26,"England Championship","Sunderland","West Brom",0,0,"D",18,2,2,0,9,7,13,2,0,0,0,0,0,0,0,0,20,2,16,15,0,0
"20241127CARQPR",2024-11-27,"England Championship","Cardiff","QPR",0,2,"A",24,10,7,5,12,5,14,4,0,1,0,0,0,0,0,2,34,12,17,18,1,0
"20241127LEELUT",2024-11-27,"England Championship","Leeds","Luton",3,0,"H",20,7,11,4,9,12,9,1,1,2,0,0,0,0,0,3,27,15,21,10,3,0
"20241127MIDBLA",2024-11-27,"England Championship","Middlesbrough","Blackburn",0,1,"A",10,7,2,2,7,7,5,3,1,0,0,0,0,0,0,1,17,4,14,8,1,0
"20241127DERSWA",2024-11-27,"England Championship","Derby","Swansea",1,2,"A",18,3,7,2,16,14,6,2,3,1,0,0,0,0,0,3,21,9,30,8,4,0
"20241129SHESUN",2024-11-29,"England Championship","Sheffield United","Sunderland",1,0,"H",14,16,4,2,12,8,8,8,4,2,1,1,0,0,0,1,30,6,20,16,6,2
"20241130MIDHUL",2024-11-30,"England Championship","Middlesbrough","Hull",3,1,"H",21,10,9,3,9,10,7,6,1,2,0,0,0,0,0,4,31,12,19,13,3,0
"20241130OXFMIL",2024-11-30,"England Championship","Oxford","Millwall",1,1,"D",8,11,3,3,10,14,2,11,0,4,0,0,0,0,0,2,19,6,24,13,4,0
"20241130WATQPR",2024-11-30,"England Championship","Watford","QPR",0,0,"D",17,16,6,1,17,14,7,5,2,3,0,0,0,0,0,0,33,7,31,12,5,0
"20241130BLALEE",2024-11-30,"England Championship","Blackburn","Leeds",1,0,"H",11,13,2,5,9,12,3,9,2,2,0,0,0,0,0,1,24,7,21,12,4,0
"20241130BRIPLY",2024-11-30,"England Championship","Bristol City","Plymouth",4,0,"H",25,4,12,2,7,16,5,2,1,3,0,0,0,0,0,4,29,14,23,7,4,0
"20241130COVCAR",2024-11-30,"England Championship","Coventry","Cardiff",2,2,"D",11,10,6,4,10,15,5,1,1,5,0,0,0,0,0,4,21,10,25,6,6,0
"20241130NORLUT",2024-11-30,"England Championship","Norwich","Luton",4,2,"H",16,12,6,3,9,12,6,5,1,2,0,0,0,0,0,6,28,9,21,11,3,0
"20241130PREWES",2024-11-30,"England Championship","Preston","West Brom",1,1,"D",13,8,6,3,12,10,7,4,2,1,0,0,1,1,0,2,21,9,22,11,3,0
"20241130STOBUR",2024-11-30,"England Championship","Stoke","Burnley",0,2,"A",14,16,5,4,10,5,6,4,2,0,0,0,0,0,0,2,30,9,15,10,2,0
"20241130SWAPOR",2024-11-30,"England Championship","Swansea","Portsmouth",2,2,"D",22,6,6,4,8,11,9,1,2,4,0,0,0,0,0,4,28,10,19,10,6,0
"20241201DERSHE",2024-12-01,"England Championship","Derby","Sheffield Weds",1,2,"A",13,10,4,2,20,7,7,5,5,1,0,0,0,0,0,3,23,6,27,12,6,0
"20241206BURMID",2024-12-06,"England Championship","Burnley","Middlesbrough",1,1,"D",15,10,4,5,12,10,11,3,1,0,0,0,0,0,0,2,25,9,22,14,1,0
"20241207LEEDER",2024-12-07,"England Championship","Leeds","Derby",2,0,"H",18,3,6,1,6,10,10,2,0,1,0,0,0,0,0,2,21,7,16,12,1,0
"20241207SHEPRE",2024-12-07,"England Championship","Sheffield Weds","Preston",1,1,"D",13,14,4,7,16,9,6,3,4,2,0,0,0,0,0,2,27,11,25,9,6,0
"20241207SUNSTO",2024-12-07,"England Championship","Sunderland","Stoke",2,1,"H",25,11,10,3,5,9,9,4,0,0,0,0,0,0,0,3,36,13,14,13,0,0
"20241207HULBLA",2024-12-07,"England Championship","Hull","Blackburn",0,1,"A",14,5,6,1,10,14,9,2,2,4,0,0,0,0,0,1,19,7,24,11,6,0
"20241207LUTSWA",2024-12-07,"England Championship","Luton","Swansea",1,1,"D",8,20,2,10,16,10,5,8,0,0,0,0,0,0,0,2,28,12,26,13,0,0
"20241207MILCOV",2024-12-07,"England Championship","Millwall","Coventry",0,1,"A",9,14,0,3,11,11,7,8,2,1,0,0,0,0,0,1,23,3,22,15,3,0
"20241207PORBRI",2024-12-07,"England Championship","Portsmouth","Bristol City",3,0,"H",13,11,8,2,14,12,6,7,3,3,0,0,0,0,0,3,24,10,26,13,6,0
"20241207QPRNOR",2024-12-07,"England Championship","QPR","Norwich",3,0,"H",9,5,5,1,8,12,2,10,5,2,0,0,0,0,0,3,14,6,20,12,7,0
"20241208WESSHE",2024-12-08,"England Championship","West Brom","Sheffield United",2,2,"D",11,12,4,5,8,13,6,5,2,4,0,0,0,0,0,4,23,9,21,11,6,0
"20241210BURDER",2024-12-10,"England Championship","Burnley","Derby",0,0,"D",14,6,4,1,8,15,6,2,1,1,0,0,0,0,0,0,20,5,23,8,2,0
"20241210LUTSTO",2024-12-10,"England Championship","Luton","Stoke",2,1,"H",18,15,8,4,7,16,10,4,1,2,0,0,0,0,0,3,33,12,23,14,3,0
"20241210PLYSWA",2024-12-10,"England Championship","Plymouth","Swansea",1,2,"A",14,10,2,2,10,20,6,3,0,3,0,0,0,0,0,3,24,4,30,9,3,0
"20241210PORNOR",2024-12-10,"England Championship","Portsmouth","Norwich",0,0,"D",15,5,1,4,14,21,8,3,3,5,0,0,0,0,0,0,20,5,35,11,8,0
"20241210SHEBLA",2024-12-10,"England Championship","Sheffield Weds","Blackburn",0,1,"A",16,8,4,3,8,12,8,3,0,2,0,0,0,0,0,1,24,7,20,11,2,0
"20241210SUNBRI",2024-12-10,"England Championship","Sunderland","Bristol City",1,1,"D",21,7,5,2,10,12,8,4,2,5,0,0,1,0,1,2,28,7,22,12,7,0
"20241210LEEMID",2024-12-10,"England Championship","Leeds","Middlesbrough",3,1,"H",17,6,5,2,11,17,7,4,1,2,0,0,0,0,0,4,23,7,28,11,3,0
"20241211CARPRE",2024-12-11,"England Championship","Cardiff","Preston",0,2,"A",13,14,4,4,11,16,7,2,2,5,0,0,0,0,0,2,27,8,27,9,7,0
"20241211HULWAT",2024-12-11,"England Championship","Hull","Watford",1,1,"D",13,12,4,2,15,7,6,2,2,3,0,0,0,0,0,2,25,6,22,8,5,0
"20241211MILSHE",2024-12-11,"England Championship","Millwall","Sheffield United",0,1,"A",11,9,3,1,10,9,7,3,0,2,0,0,0,0,0,1,20,4,19,10,2,0
"20241211QPROXF",2024-12-11,"England Championship","QPR","Oxford",2,0,"H",11,4,4,1,11,20,0,4,2,2,0,0,0,0,0,2,15,5,31,4,4,0
"20241211WESCOV",2024-12-11,"England Championship","West Brom","Coventry",2,0,"H",10,16,2,4,5,7,9,9,1,1,0,0,0,0,0,2,26,6,12,18,2,0
"20241213DERPOR",2024-12-13,"England Championship","Derby","Portsmouth",4,0,"H",17,3,7,0,8,6,5,3,0,1,0,0,0,0,0,4,20,7,14,8,1,0
"20241214BRIQPR",2024-12-14,"England Championship","Bristol City","QPR",1,1,"D",17,5,5,2,5,9,10,3,1,2,0,0,0,0,0,2,22,7,14,13,3,0
"20241214COVHUL",2024-12-14,"England Championship","Coventry","Hull",2,1,"H",18,10,7,4,16,11,10,2,3,3,0,0,0,0,0,3,28,11,27,12,6,0
"20241214PRELEE",2024-12-14,"England Championship","Preston","Leeds",1,1,"D",5,18,2,4,16,7,2,8,3,1,0,0,0,0,0,2,23,6,23,10,4,0
"20241214BLALUT",2024-12-14,"England Championship","Blackburn","Luton",2,0,"H",12,10,6,4,14,11,4,4,3,2,0,1,0,0,0,2,22,10,25,8,5,1
"20241214MIDMIL",2024-12-14,"England Championship","Middlesbrough","Millwall",1,0,"H",11,12,2,4,14,10,3,4,2,2,0,0,0,0,0,1,23,6,24,7,4,0
"20241214OXFSHE",2024-12-14,"England Championship","Oxford","Sheffield Weds",1,3,"A",11,15,5,9,9,11,7,11,0,1,0,0,1,1,0,4,26,14,20,18,1,0
"20241214SHEPLY",2024-12-14,"England Championship","Sheffield United","Plymouth",2,0,"H",10,12,3,4,10,13,2,3,0,2,0,0,0,0,0,2,22,7,23,5,2,0
"20241214STOCAR",2024-12-14,"England Championship","Stoke","Cardiff",2,2,"D",14,19,5,4,10,10,4,4,4,1,0,0,0,0,0,4,33,9,20,8,5,0
"20241214SWASUN",2024-12-14,"England Championship","Swansea","Sunderland",2,3,"A",10,13,4,5,12,14,2,4,1,4,0,0,0,0,0,5,23,9,26,6,5,0
"20241215WATWES",2024-12-15,"England Championship","Watford","West Brom",2,1,"H",14,15,7,6,9,7,4,5,2,3,0,0,0,0,0,3,29,13,16,9,5,0
"20241215NORBUR",2024-12-15,"England Championship","Norwich","Burnley",1,2,"A",12,10,6,5,14,13,6,5,3,1,0,0,0,0,0,3,22,11,27,11,4,0
"20241220LUTDER",2024-12-20,"England Championship","Luton","Derby",2,1,"H",18,10,5,3,12,14,7,4,1,3,0,0,0,0,0,3,28,8,26,11,4,0
"20241221HULSWA",2024-12-21,"England Championship","Hull","Swansea",2,1,"H",12,8,5,2,12,11,3,5,2,2,0,0,1,0,1,3,20,7,23,8,4,0
"20241221PORCOV",2024-12-21,"England Championship","Portsmouth","Coventry",4,1,"H",12,7,7,3,14,14,10,2,1,0,0,0,0,0,0,5,19,10,28,12,1,0
"20241221SHESTO",2024-12-21,"England Championship","Sheffield Weds","Stoke",2,0,"H",6,15,4,4,12,12,6,6,2,2,1,0,0,0,0,2,21,8,24,12,4,1
"20241221BURWAT",2024-12-21,"England Championship","Burnley","Watford",2,1,"H",15,9,5,2,12,16,7,3,3,1,0,0,0,0,0,3,24,7,28,10,4,0
"20241221CARSHE",2024-12-21,"England Championship","Cardiff","Sheffield United",0,2,"A",8,12,2,5,13,11,3,6,3,1,0,0,0,0,0,2,20,7,24,9,4,0
"20241221LEEOXF",2024-12-21,"England Championship","Leeds","Oxford",4,0,"H",23,6,9,0,7,7,5,0,0,1,0,0,0,0,0,4,29,9,14,5,1,0
"20241221MILBLA",2024-12-21,"England Championship","Millwall","Blackburn",1,0,"H",17,6,4,1,12,15,6,4,0,2,0,0,0,0,0,1,23,5,27,10,2,0
"20241221PLYMID",2024-12-21,"England Championship","Plymouth","Middlesbrough",3,3,"D",12,17,5,6,8,8,3,6,2,2,0,0,0,0,0,6,29,11,16,9,4,0
"20241221QPRPRE",2024-12-21,"England Championship","QPR","Preston",2,1,"H",16,2,4,2,10,16,5,1,1,0,0,1,1,0,1,3,18,6,26,6,1,1
"20241221SUNNOR",2024-12-21,"England Championship","Sunderland","Norwich",2,1,"H",7,7,4,4,15,14,4,2,5,3,0,1,0,0,0,3,14,8,29,6,8,1
"20241222WESBRI",2024-12-22,"England Championship","West Brom","Bristol City",2,0,"H",17,8,4,2,8,17,6,1,2,3,0,0,0,0,0,2,25,6,25,7,5,0
"20241226BLASUN",2024-12-26,"England Championship","Blackburn","Sunderland",2,2,"D",12,13,3,4,11,14,5,4,2,3,0,0,0,0,0,4,25,7,25,9,5,0
"20241226BRILUT",2024-12-26,"England Championship","Bristol City","Luton",1,0,"H",10,7,3,2,9,9,5,4,2,1,0,0,0,0,0,1,17,5,18,9,3,0
"20241226COVPLY",2024-12-26,"England Championship","Coventry","Plymouth",4,0,"H",19,5,9,1,7,11,4,4,0,1,0,1,0,0,0,4,24,10,18,8,1,1
"20241226MIDSHE",2024-12-26,"England Championship","Middlesbrough","Sheffield Weds",3,3,"D",7,15,4,5,11,12,1,9,0,2,1,0,0,0,0,6,22,9,23,10,2,1
"20241226NORMIL",2024-12-26,"England Championship","Norwich","Millwall",2,1,"H",9,8,4,2,8,11,4,2,2,1,0,0,0,0,0,3,17,6,19,6,3,0
"20241226OXFCAR",2024-12-26,"England Championship","Oxford","Cardiff",3,2,"H",13,8,5,3,14,7,3,0,1,1,0,0,0,0,0,5,21,8,21,3,2,0
"20241226PREHUL",2024-12-26,"England Championship","Preston","Hull",1,0,"H",8,10,2,4,10,13,2,2,3,1,0,0,0,0,0,1,18,6,23,4,4,0
"20241226SHEBUR",2024-12-26,"England Championship","Sheffield United","Burnley",0,2,"A",9,8,3,4,10,14,6,5,3,1,0,0,0,0,0,2,17,7,24,11,4,0
"20241226SWAQPR",2024-12-26,"England Championship","Swansea","QPR",3,0,"H",10,4,8,0,13,8,3,3,2,3,0,0,0,0,0,3,14,8,21,6,5,0
"20241226WATPOR",2024-12-26,"England Championship","Watford","Portsmouth",2,1,"H",13,5,6,1,12,13,11,5,1,6,1,0,0,0,0,3,18,7,25,16,7,1
"20241226DERWES",2024-12-26,"England Championship","Derby","West Brom",2,1,"H",13,14,4,3,13,8,5,3,1,1,0,0,0,0,0,3,27,7,21,8,2,0
"20241226STOLEE",2024-12-26,"England Championship","Stoke","Leeds",0,2,"A",3,20,2,5,8,8,1,7,4,0,0,0,0,0,0,2,23,7,16,8,4,0
"20241229NORQPR",2024-12-29,"England Championship","Norwich","QPR",1,1,"D",19,4,4,0,15,18,4,4,1,4,0,0,0,0,0,2,23,4,33,8,5,0
"20241229PRESHE",2024-12-29,"England Championship","Preston","Sheffield Weds",3,1,"H",14,18,7,3,15,18,3,6,0,2,0,0,0,0,0,4,32,10,33,9,2,0
"20241229SHEWES",2024-12-29,"England Championship","Sheffield United","West Brom",1,1,"D",14,10,2,6,12,11,2,2,3,2,0,0,0,0,0,2,24,8,23,4,5,0
"20241229BLAHUL",2024-12-29,"England Championship","Blackburn","Hull",0,1,"A",14,8,2,3,12,16,8,3,3,0,0,0,0,0,0,1,22,5,28,11,3,0
"20241229BRIPOR",2024-12-29,"England Championship","Bristol City","Portsmouth",3,0,"H",20,5,7,2,11,10,10,4,1,1,0,0,0,0,0,3,25,9,21,14,2,0
"20241229COVMIL",2024-12-29,"England Championship","Coventry","Millwall",0,0,"D",6,10,1,2,13,15,5,5,0,1,0,0,0,0,0,0,16,3,28,10,1,0
"20241229OXFPLY",2024-12-29,"England Championship","Oxford","Plymouth",2,0,"H",14,11,5,2,9,15,9,6,0,2,0,0,0,0,0,2,25,7,24,15,2,0
"20241229STOSUN",2024-12-29,"England Championship","Stoke","Sunderland",1,0,"H",11,22,4,7,17,11,4,12,5,2,0,0,0,0,0,1,33,11,28,16,7,0
"20241229SWALUT",2024-12-29,"England Championship","Swansea","Luton",2,1,"H",12,4,9,1,14,17,8,1,1,2,0,1,0,0,0,3,16,10,31,9,3,1
"20241229WATCAR",2024-12-29,"England Championship","Watford","Cardiff",1,2,"A",9,9,1,3,15,12,4,2,2,3,0,0,0,0,0,3,18,4,27,6,5,0
"20241229DERLEE",2024-12-29,"England Championship","Derby","Leeds",0,1,"A",4,17,1,6,14,9,2,9,1,1,0,0,0,0,0,1,21,7,23,11,2,0
"20241229MIDBUR",2024-12-29,"England Championship","Middlesbrough","Burnley",0,0,"D",8,8,3,1,10,12,1,4,1,3,0,0,0,0,0,0,16,4,22,5,4,0
"20220101BURCRE",2022-01-01,"England League 1","Burton","Crewe",4,1,"H",20,10,9,2,12,3,3,4,0,2,0,0,0,0,0,5,30,11,15,7,2,0
"20220101CHAWYC",2022-01-01,"England League 1","Charlton","Wycombe",0,1,"A",13,10,2,4,10,16,1,4,2,4,0,0,0,0,0,1,23,6,26,5,6,0
"20220101MILGIL",2022-01-01,"England League 1","Milton Keynes Dons","Gillingham",0,0,"D",17,6,3,1,10,16,6,2,1,4,0,0,0,0,0,0,23,4,26,8,5,0
"20220101OXFCHE",2022-01-01,"England League 1","Oxford","Cheltenham",1,1,"D",16,8,4,4,8,11,9,3,1,5,0,0,0,0,0,2,24,8,19,12,6,0
"20220101ROTBOL",2022-01-01,"England League 1","Rotherham","Bolton",2,1,"H",15,12,5,5,16,9,11,3,2,3,0,0,0,0,0,3,27,10,25,14,5,0
"20220102MORDON",2022-01-02,"England League 1","Morecambe","Doncaster",4,3,"H",24,8,8,4,9,13,8,3,1,2,0,0,0,0,0,7,32,12,22,11,3,0
"20220102SHRSHE",2022-01-02,"England League 1","Shrewsbury","Sheffield Weds",1,0,"H",11,14,6,5,11,7,4,8,2,2,0,0,0,0,0,1,25,11,18,12,4,0
"20220103CAMPOR",2022-01-03,"England League 1","Cambridge","Portsmouth",0,0,"D",10,13,6,2,12,18,1,11,2,3,1,0,0,0,0,0,23,8,30,12,5,1
"20220108WYCSUN",2022-01-08,"England League 1","Wycombe","Sunderland",3,3,"D",15,21,8,7,12,10,3,10,2,1,0,0,0,0,0,6,36,15,22,13,3,0
"20220108ACCMIL",2022-01-08,"England League 1","Accrington","Milton Keynes Dons",1,1,"D",9,23,3,7,10,12,2,14,1,1,1,0,0,0,0,2,32,10,22,16,2,1
"20220108CHEBUR",2022-01-08,"England League 1","Cheltenham","Burton",1,1,"D",16,7,4,3,6,10,8,2,1,2,0,0,0,0,0,2,23,7,16,10,3,0
"20220108DONFLE",2022-01-08,"England League 1","Doncaster","Fleetwood Town",0,1,"A",6,15,2,6,14,4,3,4,2,2,0,0,0,0,0,1,21,8,18,7,4,0
"20220108GILIPS",2022-01-08,"England League 1","Gillingham","Ipswich",0,4,"A",6,15,0,5,11,10,5,5,1,1,1,0,0,0,0,4,21,5,21,10,2,1
"20220108LINOXF",2022-01-08,"England League 1","Lincoln","Oxford",2,0,"H",10,14,4,3,15,5,4,2,0,0,0,1,0,0,0,2,24,7,20,6,0,1
"20220111MILAFC",2022-01-11,"England League 1","Milton Keynes Dons","AFC Wimbledon",1,0,"H",22,7,5,1,5,10,3,3,0,0,0,1,0,0,0,1,29,6,15,6,0,1
"20220111SUNLIN",2022-01-11,"England League 1","Sunderland","Lincoln",1,3,"A",11,8,5,4,14,14,8,5,2,7,1,0,0,0,0,4,19,9,28,13,9,1
"20220111BOLWYC",2022-01-11,"England League 1","Bolton","Wycombe",0,2,"A",15,8,3,5,7,15,7,5,0,4,0,0,0,0,0,2,23,8,22,12,4,0
"20220112CRECHA",2022-01-12,"England League 1","Crewe","Charlton",2,1,"H",9,11,4,6,11,20,6,3,2,3,0,0,0,0,0,3,20,10,31,9,5,0
"20220115ACCSUN",2022-01-15,"England League 1","Accrington","Sunderland",1,1,"D",20,13,3,4,11,10,4,12,1,0,1,0,0,0,0,2,33,7,21,16,1,1
"20220115AFCMOR",2022-01-15,"England League 1","AFC Wimbledon","Morecambe",0,0,"D",15,7,3,1,15,10,7,3,2,2,0,0,0,0,0,0,22,4,25,10,4,0
"20220115BOLIPS",2022-01-15,"England League 1","Bolton","Ipswich",2,0,"H",8,14,4,3,5,7,5,12,2,3,0,0,0,0,0,2,22,7,12,17,5,0
"20220115CHECHA",2022-01-15,"England League 1","Cheltenham","Charlton",1,1,"D",14,10,7,5,17,11,4,5,3,2,0,0,0,0,0,2,24,12,28,9,5,0
"20220115CRESHR",2022-01-15,"England League 1","Crewe","Shrewsbury",0,0,"D",9,12,1,3,4,13,0,9,2,0,0,0,0,0,0,0,21,4,17,9,2,0
"20220115DONWIG",2022-01-15,"England League 1","Doncaster","Wigan",1,2,"A",7,13,2,5,10,9,1,6,3,1,0,0,0,0,0,3,20,7,19,7,4,0
"20220115FLEROT",2022-01-15,"England League 1","Fleetwood Town","Rotherham",1,0,"H",9,16,4,5,13,15,4,8,2,0,0,0,0,0,0,1,25,9,28,12,2,0
"20220115GILBUR",2022-01-15,"England League 1","Gillingham","Burton",1,3,"A",13,7,5,4,9,13,6,2,2,1,0,0,0,0,0,4,20,9,22,8,3,0
"20220115LINCAM",2022-01-15,"England League 1","Lincoln","Cambridge",0,1,"A",16,13,7,5,10,6,8,1,0,1,0,0,0,0,0,1,29,12,16,9,1,0
"20220115PORMIL",2022-01-15,"England League 1","Portsmouth","Milton Keynes Dons",1,2,"A",22,14,6,6,10,9,5,1,2,2,0,0,0,0,0,3,36,12,19,6,4,0
"20220115SHEPLY",2022-01-15,"England League 1","Sheffield Weds","Plymouth",4,2,"H",22,3,7,2,10,9,8,3,2,1,0,0,0,0,0,6,25,9,19,11,3,0
"20220115WYCOXF",2022-01-15,"England League 1","Wycombe","Oxford",2,0,"H",9,15,5,7,9,8,2,6,2,2,0,0,0,0,0,2,24,12,17,8,4,0
"20220118AFCPOR",2022-01-18,"England League 1","AFC Wimbledon","Portsmouth",0,0,"D",12,12,1,5,16,11,6,8,2,2,0,0,0,0,0,0,24,6,27,14,4,0
"20220118CAMDON",2022-01-18,"England League 1","Cambridge","Doncaster",3,1,"H",8,11,5,5,7,10,1,4,2,1,0,0,0,0,0,4,19,10,17,5,3,0
"20220118MORWIG",2022-01-18,"England League 1","Morecambe","Wigan",1,2,"A",13,11,5,4,8,12,1,4,1,1,0,0,0,0,0,3,24,9,20,5,2,0
"20220122BURAFC",2022-01-22,"England League 1","Burton","AFC Wimbledon",1,1,"D",21,12,6,3,11,4,8,1,2,0,0,0,0,0,0,2,33,9,15,9,2,0
"20220122CAMCRE",2022-01-22,"England League 1","Cambridge","Crewe",1,0,"H",11,14,2,3,16,13,5,6,3,2,0,0,0,0,0,1,25,5,29,11,5,0
"20220122CHAFLE",2022-01-22,"England League 1","Charlton","Fleetwood Town",2,0,"H",13,9,5,2,20,10,4,6,2,1,0,0,0,0,0,2,22,7,30,10,3,0
"20220122IPSACC",2022-01-22,"England League 1","Ipswich","Accrington",2,1,"H",11,13,4,4,13,11,1,6,3,3,0,0,0,0,0,3,24,8,24,7,6,0
"20220122MILDON",2022-01-22,"England League 1","Milton Keynes Dons","Doncaster",0,1,"A",25,7,6,3,3,13,6,5,1,3,0,0,0,0,0,1,32,9,16,11,4,0
"20220122MORWYC",2022-01-22,"England League 1","Morecambe","Wycombe",3,2,"H",19,17,6,4,9,20,5,3,2,2,0,0,0,0,0,5,36,10,29,8,4,0
"20220122OXFSHE",2022-01-22,"England League 1","Oxford","Sheffield Weds",3,2,"H",17,18,8,5,11,9,8,4,1,2,0,0,0,0,0,5,35,13,20,12,3,0
"20220122PLYLIN",2022-01-22,"England League 1","Plymouth","Lincoln",1,2,"A",18,18,8,5,10,12,6,3,1,4,0,0,0,0,0,3,36,13,22,9,5,0
"20220122ROTCHE",2022-01-22,"England League 1","Rotherham","Cheltenham",1,0,"H",10,5,2,2,11,20,6,2,0,4,0,0,0,0,0,1,15,4,31,8,4,0
"20220122SHRBOL",2022-01-22,"England League 1","Shrewsbury","Bolton",0,1,"A",21,10,6,3,16,8,6,4,2,1,0,0,0,0,0,1,31,9,24,10,3,0
"20220122SUNPOR",2022-01-22,"England League 1","Sunderland","Portsmouth",1,0,"H",8,11,4,2,14,16,3,4,1,2,0,0,0,0,0,1,19,6,30,7,3,0
"20220122WIGGIL",2022-01-22,"England League 1","Wigan","Gillingham",3,2,"H",15,7,9,2,10,10,5,1,1,1,0,0,0,0,0,5,22,11,20,6,2,0
"20220125AFCIPS",2022-01-25,"England League 1","AFC Wimbledon","Ipswich",0,2,"A",12,8,4,2,7,10,1,9,1,1,0,1,0,0,0,2,20,6,17,10,2,1
"20220125BURMIL",2022-01-25,"England League 1","Burton","Milton Keynes Dons",0,1,"A",9,21,4,7,11,7,4,6,2,0,0,0,0,0,0,1,30,11,18,10,2,0
"20220125FLEPLY",2022-01-25,"England League 1","Fleetwood Town","Plymouth",3,3,"D",23,9,11,6,12,12,4,2,1,1,0,0,0,0,0,6,32,17,24,6,2,0
"20220125GILSHR",2022-01-25,"England League 1","Gillingham","Shrewsbury",0,0,"D",14,4,3,1,11,11,7,2,3,1,0,0,0,0,0,0,18,4,22,9,4,0
"20220129ACCMOR",2022-01-29,"England League 1","Accrington","Morecambe",2,2,"D",33,4,7,4,10,8,12,4,2,2,0,0,0,0,0,4,37,11,18,16,4,0
"20220129AFCSHR",2022-01-29,"England League 1","AFC Wimbledon","Shrewsbury",1,1,"D",13,9,5,3,14,12,1,6,3,2,0,0,0,0,0,2,22,8,26,7,5,0
"20220129BOLSUN",2022-01-29,"England League 1","Bolton","Sunderland",6,0,"H",15,7,7,2,12,14,2,1,1,1,0,0,0,0,0,6,22,9,26,3,2,0
"20220129CHEWIG",2022-01-29,"England League 1","Cheltenham","Wigan",0,0,"D",8,8,1,2,14,15,2,3,0,2,1,0,0,0,0,0,16,3,29,5,2,1
"20220129CREROT",2022-01-29,"England League 1","Crewe","Rotherham",0,2,"A",6,15,2,1,12,11,0,6,2,2,1,0,0,0,0,2,21,3,23,6,4,1
"20220129DONPLY",2022-01-29,"England League 1","Doncaster","Plymouth",1,3,"A",17,14,5,5,11,9,4,6,2,1,0,0,0,0,0,4,31,10,20,10,3,0
"20220129FLECAM",2022-01-29,"England League 1","Fleetwood Town","Cambridge",1,1,"D",18,8,3,3,10,10,8,5,1,2,0,0,0,0,0,2,26,6,20,13,3,0
"20220129GILOXF",2022-01-29,"England League 1","Gillingham","Oxford",2,7,"A",14,15,9,8,16,10,7,1,3,0,0,0,0,0,0,9,29,17,26,8,3,0
"20220129LINBUR",2022-01-29,"England League 1","Lincoln","Burton",1,2,"A",12,19,2,8,11,19,10,5,0,2,0,0,0,0,0,3,31,10,30,15,2,0
"20220129SHEIPS",2022-01-29,"England League 1","Sheffield Weds","Ipswich",1,0,"H",11,10,4,0,9,7,5,5,1,0,0,0,0,0,0,1,21,4,16,10,1,0
"20220129WYCMIL",2022-01-29,"England League 1","Wycombe","Milton Keynes Dons",0,1,"A",9,8,3,5,13,10,3,4,2,6,0,0,0,0,0,1,17,8,23,7,8,0
"20220131PORCHA",2022-01-31,"England League 1","Portsmouth","Charlton",1,2,"A",15,15,2,3,5,14,4,8,1,4,0,0,0,0,0,3,30,5,19,12,5,0
"20220201AFCCHE",2022-02-01,"England League 1","AFC Wimbledon","Cheltenham",2,2,"D",15,10,6,4,7,13,5,2,3,3,0,0,0,0,0,4,25,10,20,7,6,0
"20220201DONROT",2022-02-01,"England League 1","Doncaster","Rotherham",0,5,"A",3,15,1,7,8,11,3,7,1,0,0,0,0,0,0,5,18,8,19,10,1,0
"20220201GILCRE",2022-02-01,"England League 1","Gillingham","Crewe",1,0,"H",9,16,2,4,8,7,8,9,2,0,0,0,0,0,0,1,25,6,15,17,2,0
"20220201SHEMOR",2022-02-01,"England League 1","Sheffield Weds","Morecambe",2,0,"H",19,9,5,4,8,8,11,3,1,1,0,0,0,0,0,2,28,9,16,14,2,0
"20220201WIGOXF",2022-02-01,"England League 1","Wigan","Oxford",1,1,"D",12,5,3,1,13,14,5,1,2,4,0,0,0,0,0,2,17,4,27,6,6,0
"20220201BOLCAM",2022-02-01,"England League 1","Bolton","Cambridge",2,0,"H",17,9,6,0,10,7,8,5,1,1,0,0,0,0,0,2,26,6,17,13,2,0
"20220205BURSHE",2022-02-05,"England League 1","Burton","Sheffield Weds",0,2,"A",13,8,6,4,10,17,6,8,3,1,0,0,0,0,0,2,21,10,27,14,4,0
"20220205CHAAFC",2022-02-05,"England League 1","Charlton","AFC Wimbledon",3,2,"H",12,13,5,3,11,11,11,6,4,0,0,0,0,0,0,5,25,8,22,17,4,0
"20220205IPSGIL",2022-02-05,"England League 1","Ipswich","Gillingham",1,0,"H",11,13,2,1,13,6,4,4,0,1,0,0,1,1,0,1,24,3,19,8,1,0
"20220205MILLIN",2022-02-05,"England League 1","Milton Keynes Dons","Lincoln",2,1,"H",11,8,7,4,12,10,6,4,2,0,0,0,0,0,0,3,19,11,22,10,2,0
"20220205MORBOL",2022-02-05,"England League 1","Morecambe","Bolton",1,1,"D",13,9,7,1,10,11,5,1,1,1,0,1,0,0,0,2,22,8,21,6,2,1
"20220205OXFPOR",2022-02-05,"England League 1","Oxford","Portsmouth",3,2,"H",28,3,10,3,12,14,14,2,4,7,0,1,0,0,0,5,31,13,26,16,11,1
"20220205ROTACC",2022-02-05,"England League 1","Rotherham","Accrington",1,0,"H",11,14,4,7,14,14,5,2,3,4,1,0,0,0,0,1,25,11,28,7,7,1
"20220205SHRFLE",2022-02-05,"England League 1","Shrewsbury","Fleetwood Town",1,1,"D",9,11,4,3,8,11,7,3,1,2,0,1,0,0,0,2,20,7,19,10,3,1
"20220205SUNDON",2022-02-05,"England League 1","Sunderland","Doncaster",1,2,"A",21,10,10,5,7,10,10,2,1,0,0,0,0,0,0,3,31,15,17,12,1,0
"20220208ACCOXF",2022-02-08,"England League 1","Accrington","Oxford",2,0,"H",15,15,7,3,11,12,2,4,1,2,0,0,0,0,0,2,30,10,23,6,3,0
"20220208AFCROT",2022-02-08,"England League 1","AFC Wimbledon","Rotherham",0,1,"A",3,20,1,4,14,9,0,8,2,1,0,0,0,0,0,1,23,5,23,8,3,0
"20220208CHESUN",2022-02-08,"England League 1","Cheltenham","Sunderland",2,1,"H",7,10,3,5,11,11,3,5,1,3,0,0,0,0,0,3,17,8,22,8,4,0
"20220208CREPLY",2022-02-08,"England League 1","Crewe","Plymouth",1,4,"A",7,18,2,9,7,13,3,7,1,2,0,0,0,0,0,5,25,11,20,10,3,0
"20220208DONIPS",2022-02-08,"England League 1","Doncaster","Ipswich",0,1,"A",3,17,0,7,7,7,7,6,0,2,0,0,0,0,0,1,20,7,14,13,2,0
"20220208FLEMIL",2022-02-08,"England League 1","Fleetwood Town","Milton Keynes Dons",1,1,"D",7,10,2,3,20,10,3,2,3,2,0,0,0,0,0,2,17,5,30,5,5,0
"20220208GILCAM",2022-02-08,"England League 1","Gillingham","Cambridge",1,0,"H",13,7,5,1,12,12,4,0,2,0,0,0,0,0,0,1,20,6,24,4,2,0
"20220208LINMOR",2022-02-08,"England League 1","Lincoln","Morecambe",2,1,"H",9,17,5,3,7,10,1,3,2,1,0,0,0,0,0,3,26,8,17,4,3,0
"20220208PORBUR",2022-02-08,"England League 1","Portsmouth","Burton",2,1,"H",22,10,6,4,12,20,9,4,2,4,0,0,0,0,0,3,32,10,32,13,6,0
"20220208SHEWIG",2022-02-08,"England League 1","Sheffield Weds","Wigan",1,0,"H",11,7,4,1,14,9,6,0,2,1,0,0,0,0,0,1,18,5,23,6,3,0
"20220208WYCSHR",2022-02-08,"England League 1","Wycombe","Shrewsbury",0,0,"D",26,2,10,0,11,10,8,1,1,3,0,0,0,0,0,0,28,10,21,9,4,0
"20220208BOLCHA",2022-02-08,"England League 1","Bolton","Charlton",2,1,"H",7,9,3,3,14,16,1,3,3,4,0,0,0,0,0,3,16,6,30,4,7,0
"20220212ACCCRE",2022-02-12,"England League 1","Accrington","Crewe",4,1,"H",15,10,8,4,13,15,3,4,2,3,0,0,0,0,0,5,25,12,28,7,5,0
"20220212AFCSUN",2022-02-12,"England League 1","AFC Wimbledon","Sunderland",1,1,"D",11,8,6,1,22,18,9,5,4,7,1,0,0,0,0,2,19,7,40,14,11,1
"20220212BURCAM",2022-02-12,"England League 1","Burton","Cambridge",2,2,"D",14,9,3,2,7,11,6,4,1,1,0,0,0,0,0,4,23,5,18,10,2,0
"20220212CHEFLE",2022-02-12,"England League 1","Cheltenham","Fleetwood Town",2,0,"H",11,7,3,1,7,7,10,0,1,2,0,0,0,0,0,2,18,4,14,10,3,0
"20220212LINWYC",2022-02-12,"England League 1","Lincoln","Wycombe",1,1,"D",7,28,4,6,14,16,5,2,5,0,0,1,0,0,0,2,35,10,30,7,5,1
"20220212MILIPS",2022-02-12,"England League 1","Milton Keynes Dons","Ipswich",0,0,"D",7,9,4,2,9,14,7,6,3,3,0,0,0,0,0,0,16,6,23,13,6,0
"20220212MORGIL",2022-02-12,"England League 1","Morecambe","Gillingham",1,1,"D",22,8,5,3,9,11,4,2,0,2,0,0,0,0,0,2,30,8,20,6,2,0
"20220212OXFBOL",2022-02-12,"England League 1","Oxford","Bolton",2,3,"A",13,6,5,5,9,10,10,1,3,1,0,0,0,0,0,5,19,10,19,11,4,0
"20220212PLYSHR",2022-02-12,"England League 1","Plymouth","Shrewsbury",1,0,"H",14,6,4,2,6,21,8,6,3,1,0,0,0,0,0,1,20,6,27,14,4,0
"20220212PORDON",2022-02-12,"England League 1","Portsmouth","Doncaster",4,0,"H",15,8,9,3,12,13,3,1,1,0,0,0,0,0,0,4,23,12,25,4,1,0
"20220212WIGCHA",2022-02-12,"England League 1","Wigan","Charlton",2,1,"H",8,6,3,1,9,18,6,2,1,3,0,0,0,0,0,3,14,4,27,8,4,0
"20220213SHEROT",2022-02-13,"England League 1","Sheffield Weds","Rotherham",0,2,"A",15,9,6,2,12,6,6,5,2,0,0,0,0,0,0,2,24,8,18,11,2,0
"20220215BURBOL",2022-02-15,"England League 1","Burton","Bolton",3,1,"H",10,18,5,9,14,7,8,4,1,1,0,0,1,0,1,4,28,14,21,12,2,0
"20220215LINDON",2022-02-15,"England League 1","Lincoln","Doncaster",0,1,"A",14,8,5,1,10,13,9,1,0,1,1,0,1,1,0,1,22,6,23,10,1,1
"20220215WIGCRE",2022-02-15,"England League 1","Wigan","Crewe",2,0,"H",20,6,9,0,17,16,3,1,2,1,0,0,0,0,0,2,26,9,33,4,3,0
"20220218ROTWIG",2022-02-18,"England League 1","Rotherham","Wigan",1,1,"D",5,3,2,1,16,21,6,1,2,4,0,0,0,0,0,2,8,3,37,7,6,0
"20220219BOLAFC",2022-02-19,"England League 1","Bolton","AFC Wimbledon",4,0,"H",17,6,4,1,8,11,6,2,1,1,0,0,0,0,0,4,23,5,19,8,2,0
"20220219CAMACC",2022-02-19,"England League 1","Cambridge","Accrington",2,0,"H",8,18,4,3,8,10,5,10,0,1,0,0,0,0,0,2,26,7,18,15,1,0
"20220219CHAOXF",2022-02-19,"England League 1","Charlton","Oxford",0,4,"A",6,12,2,7,8,14,4,8,6,4,1,0,1,0,1,4,18,9,22,12,10,1
"20220219DONSHE",2022-02-19,"England League 1","Doncaster","Sheffield Weds",1,3,"A",6,14,4,5,9,9,0,9,1,1,0,0,0,0,0,4,20,9,18,9,2,0
"20220219GILPLY",2022-02-19,"England League 1","Gillingham","Plymouth",0,2,"A",2,22,0,5,9,12,2,2,1,1,0,0,0,0,0,2,24,5,21,4,2,0
"20220219IPSBUR",2022-02-19,"England League 1","Ipswich","Burton",3,0,"H",17,10,6,4,13,9,5,9,1,2,0,0,0,0,0,3,27,10,22,14,3,0
"20220219SUNMIL",2022-02-19,"England League 1","Sunderland","Milton Keynes Dons",1,2,"A",8,6,1,5,10,13,8,5,1,2,0,0,2,0,2,3,14,6,23,13,3,0
"20220219WYCCHE",2022-02-19,"England League 1","Wycombe","Cheltenham",5,5,"D",10,11,6,5,17,8,2,4,3,1,0,0,0,0,0,10,21,11,25,6,4,0
"20220222CAMPLY",2022-02-22,"England League 1","Cambridge","Plymouth",2,0,"H",14,9,8,1,6,11,8,7,2,2,0,0,0,0,0,2,23,9,17,15,4,0
"20220222CHAMIL",2022-02-22,"England League 1","Charlton","Milton Keynes Dons",0,2,"A",7,9,0,3,17,6,4,3,1,0,0,0,0,0,0,2,16,3,23,7,1,0
"20220222CREOXF",2022-02-22,"England League 1","Crewe","Oxford",0,1,"A",10,19,1,2,11,11,4,8,2,2,0,0,0,0,0,1,29,3,22,12,4,0
"20220222DONACC",2022-02-22,"England League 1","Doncaster","Accrington",2,0,"H",11,24,3,9,9,8,3,6,0,2,0,0,0,0,0,2,35,12,17,9,2,0
"20220222GILAFC",2022-02-22,"England League 1","Gillingham","AFC Wimbledon",0,0,"D",20,11,4,2,9,4,7,1,2,1,0,0,0,0,0,0,31,6,13,8,3,0
"20220222IPSCHE",2022-02-22,"England League 1","Ipswich","Cheltenham",0,0,"D",17,6,4,1,9,11,8,1,1,4,0,0,0,0,0,0,23,5,20,9,5,0
"20220222ROTMOR",2022-02-22,"England League 1","Rotherham","Morecambe",2,0,"H",20,17,4,7,10,15,4,8,1,1,0,0,0,0,0,2,37,11,25,12,2,0
"20220222SHRPOR",2022-02-22,"England League 1","Shrewsbury","Portsmouth",1,2,"A",8,15,1,6,9,12,7,7,0,1,1,0,0,0,0,3,23,7,21,14,1,1
"20220222SUNBUR",2022-02-22,"England League 1","Sunderland","Burton",1,1,"D",21,11,7,6,9,14,9,4,1,2,0,0,0,0,0,2,32,13,23,13,3,0
"20220222WYCWIG",2022-02-22,"England League 1","Wycombe","Wigan",1,3,"A",10,11,3,5,9,16,1,7,0,1,0,0,0,0,0,4,21,8,25,8,1,0
"20220222BOLLIN",2022-02-22,"England League 1","Bolton","Lincoln",3,1,"H",15,8,5,3,16,9,5,6,3,0,0,0,0,0,0,4,23,8,25,11,3,0
"20220226ACCWYC",2022-02-26,"England League 1","Accrington","Wycombe",3,2,"H",13,10,5,3,10,15,3,4,2,3,1,0,0,0,0,5,23,8,25,7,5,1
"20220226AFCDON",2022-02-26,"England League 1","AFC Wimbledon","Doncaster",2,2,"D",14,8,3,3,14,16,8,0,2,3,0,0,0,0,0,4,22,6,30,8,5,0
"20220226BURSHR",2022-02-26,"England League 1","Burton","Shrewsbury",0,2,"A",12,7,2,3,14,6,11,4,0,0,0,0,0,0,0,2,19,5,20,15,0,0
"20220226CHECRE",2022-02-26,"England League 1","Cheltenham","Crewe",1,2,"A",14,6,4,2,17,12,8,7,2,2,0,0,0,0,0,3,20,6,29,15,4,0
"20220226LINGIL",2022-02-26,"England League 1","Lincoln","Gillingham",0,2,"A",10,10,2,4,7,17,3,3,2,4,0,0,0,0,0,2,20,6,24,6,6,0
"20220226MILBOL",2022-02-26,"England League 1","Milton Keynes Dons","Bolton",2,0,"H",10,7,6,1,8,15,3,7,0,1,0,0,0,0,0,2,17,7,23,10,1,0
"20220226MORIPS",2022-02-26,"England League 1","Morecambe","Ipswich",1,1,"D",4,22,1,8,5,10,0,12,0,2,0,0,0,0,0,2,26,9,15,12,2,0
"20220226OXFCAM",2022-02-26,"England League 1","Oxford","Cambridge",4,2,"H",17,8,5,5,10,9,7,1,2,3,0,0,0,0,0,6,25,10,19,8,5,0
"20220226PLYROT",2022-02-26,"England League 1","Plymouth","Rotherham",0,1,"A",16,15,6,5,8,12,6,4,2,2,0,0,0,0,0,1,31,11,20,10,4,0
"20220226PORFLE",2022-02-26,"England League 1","Portsmouth","Fleetwood Town",3,3,"D",23,5,6,4,10,13,8,2,1,3,0,0,0,0,0,6,28,10,23,10,4,0
"20220226SHECHA",2022-02-26,"England League 1","Sheffield Weds","Charlton",2,0,"H",10,4,3,1,12,14,9,4,3,2,0,0,0,0,0,2,14,4,26,13,5,0
"20220226WIGSUN",2022-02-26,"England League 1","Wigan","Sunderland",0,3,"A",6,13,3,4,16,17,2,6,4,6,0,0,0,0,0,3,19,7,33,8,10,0
"20220301POROXF",2022-03-01,"England League 1","Portsmouth","Oxford",3,2,"H",9,13,5,3,12,14,3,4,1,1,0,0,0,0,0,5,22,8,26,7,2,0
"20220301SHEBUR",2022-03-01,"England League 1","Sheffield Weds","Burton",5,2,"H",19,12,6,3,11,9,8,1,2,2,0,0,0,0,0,7,31,9,20,9,4,0
"20220301SHRROT",2022-03-01,"England League 1","Shrewsbury","Rotherham",0,0,"D",14,14,5,2,13,6,6,7,1,0,0,0,0,0,0,0,28,7,19,13,1,0
"20220301WIGFLE",2022-03-01,"England League 1","Wigan","Fleetwood Town",2,0,"H",20,6,5,2,11,11,9,1,3,0,1,1,0,0,0,2,26,7,22,10,3,2
"20220301WYCCAM",2022-03-01,"England League 1","Wycombe","Cambridge",3,0,"H",14,9,4,3,13,5,5,2,2,1,0,0,0,0,0,3,23,7,18,7,3,0
"20220305CAMSHR",2022-03-05,"England League 1","Cambridge","Shrewsbury",0,0,"D",5,21,0,4,6,13,3,11,1,2,0,0,0,0,0,0,26,4,19,14,3,0
"20220305CHASUN",2022-03-05,"England League 1","Charlton","Sunderland",0,0,"D",8,17,0,8,10,16,1,9,4,1,0,0,0,0,0,0,25,8,26,10,5,0
"20220305CHEDON",2022-03-05,"England League 1","Cheltenham","Doncaster",4,0,"H",21,7,6,2,11,14,4,1,3,1,0,1,0,0,0,4,28,8,25,5,4,1
"20220305CREWYC",2022-03-05,"England League 1","Crewe","Wycombe",1,3,"A",9,16,2,5,7,13,5,1,2,1,0,0,0,0,0,4,25,7,20,6,3,0
"20220305FLEIPS",2022-03-05,"England League 1","Fleetwood Town","Ipswich",0,2,"A",6,11,3,4,9,8,3,4,1,2,0,0,0,0,0,2,17,7,17,7,3,0
"20220305GILBOL",2022-03-05,"England League 1","Gillingham","Bolton",0,3,"A",8,19,1,9,9,8,7,4,0,1,1,0,0,0,0,3,27,10,17,11,1,1
"20220305LINSHE",2022-03-05,"England League 1","Lincoln","Sheffield Weds",3,1,"H",14,15,9,1,12,8,8,7,2,1,0,0,0,0,0,4,29,10,20,15,3,0
"20220305OXFBUR",2022-03-05,"England League 1","Oxford","Burton",4,1,"H",24,16,9,7,7,9,10,7,0,1,0,0,0,0,0,5,40,16,16,17,1,0
"20220305PLYMOR",2022-03-05,"England League 1","Plymouth","Morecambe",2,0,"H",11,9,4,4,5,10,7,3,0,2,0,0,0,0,0,2,20,8,15,10,2,0
"20220305PORACC",2022-03-05,"England League 1","Portsmouth","Accrington",4,0,"H",11,25,4,6,12,8,6,9,2,2,1,0,0,0,0,4,36,10,20,15,4,1
"20220305ROTMIL",2022-03-05,"England League 1","Rotherham","Milton Keynes Dons",1,2,"A",16,4,4,3,17,9,4,3,1,2,0,1,0,0,0,3,20,7,26,7,3,1
"20220305WIGAFC",2022-03-05,"England League 1","Wigan","AFC Wimbledon",1,0,"H",22,8,9,3,14,15,9,2,2,0,0,0,0,0,0,1,30,12,29,11,2,0
"20220308CREPOR",2022-03-08,"England League 1","Crewe","Portsmouth",1,3,"A",17,17,4,12,13,11,7,5,1,2,0,0,0,0,0,4,34,16,24,12,3,0
"20220308IPSLIN",2022-03-08,"England League 1","Ipswich","Lincoln",2,0,"H",17,4,3,1,12,10,9,3,1,3,0,0,0,0,0,2,21,4,22,12,4,0
"20220308MILCHE",2022-03-08,"England League 1","Milton Keynes Dons","Cheltenham",3,1,"H",9,9,6,4,13,9,3,4,0,1,0,0,0,0,0,4,18,10,22,7,1,0
"20220308PLYAFC",2022-03-08,"England League 1","Plymouth","AFC Wimbledon",2,0,"H",9,10,2,2,8,9,6,6,2,0,0,0,0,0,0,2,19,4,17,12,2,0
"20220308SUNFLE",2022-03-08,"England League 1","Sunderland","Fleetwood Town",3,1,"H",14,11,7,5,13,13,3,2,2,0,0,1,1,0,1,4,25,12,26,5,2,1
"20220308BOLMOR",2022-03-08,"England League 1","Bolton","Morecambe",1,1,"D",25,4,4,3,8,14,13,1,0,4,0,0,0,0,0,2,29,7,22,14,4,0
"20220312ACCCHA",2022-03-12,"England League 1","Accrington","Charlton",2,1,"H",17,5,6,3,16,19,2,6,3,3,1,0,0,0,0,3,22,9,35,8,6,1
"20220312AFCLIN",2022-03-12,"England League 1","AFC Wimbledon","Lincoln",0,2,"A",13,7,5,5,17,13,10,2,4,3,0,1,0,0,0,2,20,10,30,12,7,1
"20220312BOLPLY",2022-03-12,"England League 1","Bolton","Plymouth",0,1,"A",14,9,5,6,11,7,6,5,0,0,0,0,0,0,0,1,23,11,18,11,0,0
"20220312BURFLE",2022-03-12,"England League 1","Burton","Fleetwood Town",3,2,"H",22,10,6,5,9,8,10,5,1,2,0,0,0,0,0,5,32,11,17,15,3,0
"20220312DONGIL",2022-03-12,"England League 1","Doncaster","Gillingham",0,1,"A",15,8,4,3,10,8,6,2,1,0,0,0,0,0,0,1,23,7,18,8,1,0
"20220312IPSPOR",2022-03-12,"England League 1","Ipswich","Portsmouth",0,0,"D",14,6,3,1,12,8,11,3,2,2,0,0,0,0,0,0,20,4,20,14,4,0
"20220312MILWIG",2022-03-12,"England League 1","Milton Keynes Dons","Wigan",1,1,"D",5,6,2,1,11,15,6,4,2,3,0,0,1,0,1,2,11,3,26,10,5,0
"20220312MORCHE",2022-03-12,"England League 1","Morecambe","Cheltenham",1,3,"A",22,18,8,9,3,6,6,6,0,1,0,0,0,0,0,4,40,17,9,12,1,0
"20220312SHECAM",2022-03-12,"England League 1","Sheffield Weds","Cambridge",6,0,"H",23,6,10,2,9,5,6,2,0,0,0,0,0,0,0,6,29,12,14,8,0,0
"20220312SHROXF",2022-03-12,"England League 1","Shrewsbury","Oxford",1,2,"A",14,8,5,3,12,3,8,0,1,0,0,0,0,0,0,3,22,8,15,8,1,0
"20220312SUNCRE",2022-03-12,"England League 1","Sunderland","Crewe",2,0,"H",14,3,7,1,13,11,7,2,5,3,0,0,0,0,0,2,17,8,24,9,8,0
"20220312WYCROT",2022-03-12,"England League 1","Wycombe","Rotherham",0,0,"D",12,12,1,4,10,12,2,2,1,2,0,0,0,0,0,0,24,5,22,4,3,0
"20220315CHAGIL",2022-03-15,"England League 1","Charlton","Gillingham",1,0,"H",16,7,4,2,10,10,4,4,2,1,0,0,0,0,0,1,23,6,20,8,3,0
"20220315CREWIG",2022-03-15,"England League 1","Crewe","Wigan",0,2,"A",7,13,2,4,14,14,2,5,1,2,0,0,0,0,0,2,20,6,28,7,3,0
"20220315PLYPOR",2022-03-15,"England League 1","Plymouth","Portsmouth",1,0,"H",20,13,6,0,10,9,4,10,2,2,0,0,0,0,0,1,33,6,19,14,4,0
"20220315ROTLIN",2022-03-15,"England League 1","Rotherham","Lincoln",2,1,"H",13,10,7,3,15,12,6,3,2,2,0,0,0,0,0,3,23,10,27,9,4,0
"20220315SHEACC",2022-03-15,"England League 1","Sheffield Weds","Accrington",1,1,"D",12,7,5,2,13,6,7,1,1,0,0,0,0,0,0,2,19,7,19,8,1,0
"20220315SHRMOR",2022-03-15,"England League 1","Shrewsbury","Morecambe",5,0,"H",14,8,6,0,9,7,0,2,0,2,0,0,0,0,0,5,22,6,16,2,2,0
"20220315WYCFLE",2022-03-15,"England League 1","Wycombe","Fleetwood Town",1,0,"H",19,9,3,4,20,12,3,3,2,2,0,0,0,0,0,1,28,7,32,6,4,0
"20220319CAMMIL",2022-03-19,"England League 1","Cambridge","Milton Keynes Dons",0,1,"A",11,8,2,4,14,12,1,8,1,3,0,0,0,0,0,1,19,6,26,9,4,0
"20220319CHABUR",2022-03-19,"England League 1","Charlton","Burton",2,0,"H",7,13,3,0,12,13,1,5,0,6,0,0,2,0,2,2,20,3,25,6,6,0
"20220319CHEAFC",2022-03-19,"England League 1","Cheltenham","AFC Wimbledon",3,1,"H",14,11,4,4,7,10,5,2,2,1,0,0,0,0,0,4,25,8,17,7,3,0
"20220319CREBOL",2022-03-19,"England League 1","Crewe","Bolton",0,1,"A",2,16,1,5,13,16,7,7,1,1,0,0,0,0,0,1,18,6,29,14,2,0
"20220319FLEDON",2022-03-19,"England League 1","Fleetwood Town","Doncaster",0,0,"D",10,8,3,4,10,15,6,5,0,1,0,0,0,0,0,0,18,7,25,11,1,0
"20220319GILSHE",2022-03-19,"England League 1","Gillingham","Sheffield Weds",0,0,"D",10,12,6,2,9,12,4,4,3,3,0,0,0,0,0,0,22,8,21,8,6,0
"20220319LINSUN",2022-03-19,"England League 1","Lincoln","Sunderland",0,0,"D",8,16,2,4,15,15,7,9,2,1,0,0,0,0,0,0,24,6,30,16,3,0
"20220319OXFIPS",2022-03-19,"England League 1","Oxford","Ipswich",1,1,"D",16,12,4,6,8,10,5,4,2,2,0,0,0,0,0,2,28,10,18,9,4,0
"20220319PLYACC",2022-03-19,"England League 1","Plymouth","Accrington",4,0,"H",16,16,7,4,7,12,6,9,1,1,0,1,0,0,0,4,32,11,19,15,2,1
"20220319PORWYC",2022-03-19,"England League 1","Portsmouth","Wycombe",0,0,"D",6,15,1,4,13,21,2,8,3,1,0,0,0,0,0,0,21,5,34,10,4,0
"20220319ROTSHR",2022-03-19,"England League 1","Rotherham","Shrewsbury",0,3,"A",12,18,2,10,5,11,6,7,1,3,1,0,0,0,0,3,30,12,16,13,4,1
"20220319WIGMOR",2022-03-19,"England League 1","Wigan","Morecambe",4,1,"H",20,5,10,2,6,10,6,3,0,1,0,0,0,0,0,5,25,12,16,9,1,0
"20220322PLYCHE",2022-03-22,"England League 1","Plymouth","Cheltenham",2,0,"H",17,16,6,9,9,3,5,3,0,1,0,0,0,0,0,2,33,15,12,8,1,0
"20220326ACCGIL",2022-03-26,"England League 1","Accrington","Gillingham",1,2,"A",20,10,8,4,10,15,5,4,2,1,0,0,0,0,0,3,30,12,25,9,3,0
"20220326AFCCAM",2022-03-26,"England League 1","AFC Wimbledon","Cambridge",0,1,"A",6,5,1,2,16,13,4,2,2,2,0,0,0,0,0,1,11,3,29,6,4,0
"20220326DONCHA",2022-03-26,"England League 1","Doncaster","Charlton",0,1,"A",8,14,1,9,6,11,3,2,1,4,0,0,0,0,0,1,22,10,17,5,5,0
"20220326IPSPLY",2022-03-26,"England League 1","Ipswich","Plymouth",1,0,"H",18,3,4,0,13,9,4,4,2,1,0,0,0,0,0,1,21,4,22,8,3,0
"20220326SHECHE",2022-03-26,"England League 1","Sheffield Weds","Cheltenham",4,1,"H",15,8,6,3,14,11,8,2,1,3,0,0,0,0,0,5,23,9,25,10,4,0
"20220326SHRLIN",2022-03-26,"England League 1","Shrewsbury","Lincoln",1,0,"H",12,6,3,0,19,8,8,5,3,0,0,0,0,0,0,1,18,3,27,13,3,0
"20220402WIGBOL",2022-04-02,"England League 1","Wigan","Bolton",1,1,"D",10,5,1,2,11,9,4,3,1,1,0,0,0,0,0,2,15,3,20,7,2,0
"20220402ACCCHE",2022-04-02,"England League 1","Accrington","Cheltenham",4,4,"D",21,7,8,6,13,10,6,2,1,1,1,0,0,0,0,8,28,14,23,8,2,1
"20220402CHALIN",2022-04-02,"England League 1","Charlton","Lincoln",1,2,"A",17,10,3,4,12,7,9,4,0,1,1,1,0,0,0,3,27,7,19,13,1,2
"20220402CREFLE",2022-04-02,"England League 1","Crewe","Fleetwood Town",1,3,"A",17,13,7,7,7,10,10,1,0,0,0,0,0,0,0,4,30,14,17,11,0,0
"20220402IPSCAM",2022-04-02,"England League 1","Ipswich","Cambridge",0,1,"A",12,8,6,3,11,4,6,5,4,3,0,0,0,0,0,1,20,9,15,11,7,0
"20220402MILSHR",2022-04-02,"England League 1","Milton Keynes Dons","Shrewsbury",2,0,"H",10,7,6,2,3,12,4,2,0,5,0,0,0,0,0,2,17,8,15,6,5,0
"20220402MORBUR",2022-04-02,"England League 1","Morecambe","Burton",3,0,"H",22,8,8,2,6,10,11,7,1,1,0,1,0,0,0,3,30,10,16,18,2,1
"20220402PLYOXF",2022-04-02,"England League 1","Plymouth","Oxford",1,0,"H",11,8,1,2,11,14,1,3,1,3,0,0,0,0,0,1,19,3,25,4,4,0
"20220402SHEAFC",2022-04-02,"England League 1","Sheffield Weds","AFC Wimbledon",2,1,"H",16,7,5,3,8,7,9,4,2,1,0,0,1,0,1,3,23,8,15,13,3,0
"20220402SUNGIL",2022-04-02,"England League 1","Sunderland","Gillingham",1,0,"H",25,5,5,0,12,13,8,1,2,4,0,0,0,0,0,1,30,5,25,9,6,0
"20220402WYCDON",2022-04-02,"England League 1","Wycombe","Doncaster",2,0,"H",19,17,9,5,12,9,11,4,1,1,0,0,0,0,0,2,36,14,21,15,2,0
"20220405AFCCHA",2022-04-05,"England League 1","AFC Wimbledon","Charlton",1,1,"D",14,8,4,3,14,13,10,3,1,2,0,1,0,0,0,2,22,7,27,13,3,1
"20220405CAMWYC",2022-04-05,"England League 1","Cambridge","Wycombe",1,4,"A",9,18,2,6,8,11,3,6,1,0,0,0,0,0,0,5,27,8,19,9,1,0
"20220405FLELIN",2022-04-05,"England League 1","Fleetwood Town","Lincoln",1,1,"D",17,12,4,4,15,11,4,5,2,3,0,0,0,0,0,2,29,8,26,9,5,0
"20220405MILCRE",2022-04-05,"England League 1","Milton Keynes Dons","Crewe",2,1,"H",9,4,4,1,12,14,5,3,0,1,0,0,0,0,0,3,13,5,26,8,1,0
"20220405MOROXF",2022-04-05,"England League 1","Morecambe","Oxford",2,1,"H",6,20,3,7,12,8,1,9,2,1,0,0,0,0,0,3,26,10,20,10,3,0
"20220405WIGACC",2022-04-05,"England League 1","Wigan","Accrington",3,0,"H",14,14,7,3,14,15,5,2,1,2,0,0,0,0,0,3,28,10,29,7,3,0
"20220405BOLPOR",2022-04-05,"England League 1","Bolton","Portsmouth",1,1,"D",12,12,6,5,10,11,1,3,2,0,0,0,0,0,0,2,24,11,21,4,2,0
"20220409AFCMIL",2022-04-09,"England League 1","AFC Wimbledon","Milton Keynes Dons",1,1,"D",8,14,3,6,17,11,1,6,3,2,0,0,0,0,0,2,22,9,28,7,5,0
"20220409BOLSHE",2022-04-09,"England League 1","Bolton","Sheffield Weds",1,1,"D",8,21,2,5,12,15,4,10,4,2,0,0,0,0,0,2,29,7,27,14,6,0
"20220409BURPLY",2022-04-09,"England League 1","Burton","Plymouth",0,0,"D",6,9,3,2,17,11,1,3,2,1,0,0,0,0,0,0,15,5,28,4,3,0
"20220409CAMMOR",2022-04-09,"England League 1","Cambridge","Morecambe",2,1,"H",15,19,5,5,12,12,3,5,0,1,0,0,0,0,0,3,34,10,24,8,1,0
"20220409CHEPOR",2022-04-09,"England League 1","Cheltenham","Portsmouth",1,0,"H",19,17,7,5,8,9,7,9,1,0,0,0,0,0,0,1,36,12,17,16,1,0
"20220409DONCRE",2022-04-09,"England League 1","Doncaster","Crewe",2,0,"H",19,12,9,2,15,12,7,2,1,2,0,0,0,0,0,2,31,11,27,9,3,0
"20220409FLEACC",2022-04-09,"England League 1","Fleetwood Town","Accrington",1,2,"A",11,24,3,7,21,14,5,9,1,3,1,0,0,0,0,3,35,10,35,14,4,1
"20220409GILWYC",2022-04-09,"England League 1","Gillingham","Wycombe",1,1,"D",18,13,5,6,12,10,6,3,2,1,0,1,0,0,0,2,31,11,22,9,3,1
"20220409LINWIG",2022-04-09,"England League 1","Lincoln","Wigan",1,3,"A",13,14,4,6,8,14,5,8,1,4,0,0,0,0,0,4,27,10,22,13,5,0
"20220409OXFSUN",2022-04-09,"England League 1","Oxford","Sunderland",1,2,"A",20,11,6,5,9,14,5,4,0,2,0,0,0,0,0,3,31,11,23,9,2,0
"20220409ROTCHA",2022-04-09,"England League 1","Rotherham","Charlton",0,1,"A",10,9,1,5,9,12,9,3,0,1,0,0,0,0,0,1,19,6,21,12,1,0
"20220409SHRIPS",2022-04-09,"England League 1","Shrewsbury","Ipswich",1,1,"D",5,8,1,4,13,12,3,3,4,3,0,1,0,0,0,2,13,5,25,6,7,1
"20220412BURWIG",2022-04-12,"England League 1","Burton","Wigan",0,0,"D",9,10,3,2,16,11,5,4,3,3,0,0,0,0,0,0,19,5,27,9,6,0
"20220412PORROT",2022-04-12,"England League 1","Portsmouth","Rotherham",3,0,"H",10,9,6,1,17,17,5,4,2,3,0,0,0,0,0,3,19,7,34,9,5,0
"20220415ACCBUR",2022-04-15,"England League 1","Accrington","Burton",0,0,"D",17,6,5,2,10,11,5,7,1,2,0,0,0,0,0,0,23,7,21,12,3,0
"20220415CHAMOR",2022-04-15,"England League 1","Charlton","Morecambe",2,3,"A",23,11,4,4,6,5,6,6,1,0,0,0,0,0,0,5,34,8,11,12,1,0
"20220415CHEGIL",2022-04-15,"England League 1","Cheltenham","Gillingham",2,2,"D",18,12,10,6,15,15,5,5,2,1,0,0,0,0,0,4,30,16,30,10,3,0
"20220415CREAFC",2022-04-15,"England League 1","Crewe","AFC Wimbledon",3,1,"H",21,12,5,5,4,12,6,5,0,0,0,0,0,0,0,4,33,10,16,11,0,0
"20220415DONBOL",2022-04-15,"England League 1","Doncaster","Bolton",1,2,"A",19,11,6,2,12,14,8,3,2,4,0,0,0,0,0,3,30,8,26,11,6,0
"20220415FLEOXF",2022-04-15,"England League 1","Fleetwood Town","Oxford",2,3,"A",19,11,6,5,9,10,5,0,1,2,0,0,0,0,0,5,30,11,19,5,3,0
"20220415PORLIN",2022-04-15,"England League 1","Portsmouth","Lincoln",3,2,"H",17,26,7,6,12,8,5,7,1,1,0,0,0,0,0,5,43,13,20,12,2,0
"20220415SUNSHR",2022-04-15,"England League 1","Sunderland","Shrewsbury",3,2,"H",18,9,7,3,6,11,4,2,2,3,0,0,1,0,1,5,27,10,17,6,5,0
"20220415WYCPLY",2022-04-15,"England League 1","Wycombe","Plymouth",2,0,"H",13,9,5,2,12,7,5,2,2,0,0,0,0,0,0,2,22,7,19,7,2,0
"20220416ROTIPS",2022-04-16,"England League 1","Rotherham","Ipswich",1,0,"H",14,3,3,1,4,16,10,6,1,5,0,0,0,0,0,1,17,4,20,16,6,0
"20220416WIGCAM",2022-04-16,"England League 1","Wigan","Cambridge",1,2,"A",11,9,2,5,10,7,8,4,2,3,0,0,0,0,0,3,20,7,17,12,5,0
"20220416MILSHE",2022-04-16,"England League 1","Milton Keynes Dons","Sheffield Weds",2,3,"A",10,6,4,4,9,16,3,2,2,3,0,0,0,0,0,5,16,8,25,5,5,0
"20220418AFCWYC",2022-04-18,"England League 1","AFC Wimbledon","Wycombe",1,1,"D",9,17,2,5,16,12,2,7,2,2,0,0,0,0,0,2,26,7,28,9,4,0
"20220418BOLACC",2022-04-18,"England League 1","Bolton","Accrington",3,1,"H",17,15,3,6,11,13,3,1,4,4,0,1,0,0,0,4,32,9,24,4,8,1
"20220418GILFLE",2022-04-18,"England League 1","Gillingham","Fleetwood Town",0,0,"D",16,7,6,3,8,7,1,3,3,0,1,1,0,0,0,0,23,9,15,4,3,2
"20220418LINCHE",2022-04-18,"England League 1","Lincoln","Cheltenham",3,0,"H",15,11,8,4,7,22,6,2,0,3,0,0,0,0,0,3,26,12,29,8,3,0
"20220418MORPOR",2022-04-18,"England League 1","Morecambe","Portsmouth",1,1,"D",19,9,5,3,12,5,10,5,1,0,0,0,0,0,0,2,28,8,17,15,1,0
"20220418PLYSUN",2022-04-18,"England League 1","Plymouth","Sunderland",0,0,"D",7,10,1,2,11,12,7,3,1,2,0,0,0,0,0,0,17,3,23,10,3,0
"20220418SHRDON",2022-04-18,"England League 1","Shrewsbury","Doncaster",3,3,"D",19,17,8,8,10,6,8,4,1,0,0,0,0,0,0,6,36,16,16,12,1,0
"20220419BURROT",2022-04-19,"England League 1","Burton","Rotherham",2,0,"H",13,21,7,5,14,8,6,13,2,2,0,0,0,0,0,2,34,12,22,19,4,0
"20220419CAMCHA",2022-04-19,"England League 1","Cambridge","Charlton",0,2,"A",10,14,1,9,9,13,8,7,0,2,0,0,0,0,0,2,24,10,22,15,2,0
"20220419IPSWIG",2022-04-19,"England League 1","Ipswich","Wigan",2,2,"D",10,7,4,5,12,9,5,2,4,2,0,0,1,0,1,4,17,9,21,7,6,0
"20220419OXFMIL",2022-04-19,"England League 1","Oxford","Milton Keynes Dons",1,0,"H",8,10,2,2,10,6,8,3,3,0,0,0,0,0,0,1,18,4,16,11,3,0
"20220419SHECRE",2022-04-19,"England League 1","Sheffield Weds","Crewe",1,0,"H",18,1,5,1,12,10,7,4,1,2,0,0,0,0,0,1,19,6,22,11,3,0
"20220423ACCLIN",2022-04-23,"England League 1","Accrington","Lincoln",2,1,"H",18,8,5,4,14,10,2,1,0,3,1,0,0,0,0,3,26,9,24,3,3,1
"20220423CHASHR",2022-04-23,"England League 1","Charlton","Shrewsbury",2,0,"H",16,12,8,6,11,14,7,3,0,0,0,0,0,0,0,2,28,14,25,10,0,0
"20220423CHEBOL",2022-04-23,"England League 1","Cheltenham","Bolton",1,2,"A",8,13,4,4,12,8,4,7,2,0,0,0,0,0,0,3,21,8,20,11,2,0
"20220423CREIPS",2022-04-23,"England League 1","Crewe","Ipswich",1,1,"D",11,18,4,7,9,11,4,6,2,2,0,0,0,0,0,2,29,11,20,10,4,0
"20220423DONBUR",2022-04-23,"England League 1","Doncaster","Burton",2,0,"H",6,14,3,2,8,15,1,12,0,3,0,0,0,0,0,2,20,5,23,13,3,0
"20220423FLEAFC",2022-04-23,"England League 1","Fleetwood Town","AFC Wimbledon",1,1,"D",10,5,3,1,15,15,4,1,2,5,0,0,0,0,0,2,15,4,30,5,7,0
"20220423MILMOR",2022-04-23,"England League 1","Milton Keynes Dons","Morecambe",2,0,"H",12,4,7,0,8,17,5,3,2,4,0,0,0,0,0,2,16,7,25,8,6,0
"20220423PORGIL",2022-04-23,"England League 1","Portsmouth","Gillingham",3,1,"H",16,9,9,2,10,9,5,2,0,2,0,0,0,0,0,4,25,11,19,7,2,0
"20220423ROTOXF",2022-04-23,"England League 1","Rotherham","Oxford",2,1,"H",16,6,6,2,12,14,6,3,3,2,0,0,1,1,0,3,22,8,26,9,5,0
"20220423SUNCAM",2022-04-23,"England League 1","Sunderland","Cambridge",5,1,"H",28,4,11,1,10,10,4,2,0,2,0,1,0,0,0,6,32,12,20,6,2,1
"20220423WIGPLY",2022-04-23,"England League 1","Wigan","Plymouth",1,1,"D",11,5,4,2,12,8,15,3,3,1,0,0,0,0,0,2,16,6,20,18,4,0
"20220423WYCSHE",2022-04-23,"England League 1","Wycombe","Sheffield Weds",1,0,"H",6,15,3,3,13,8,2,12,2,2,0,0,0,0,0,1,21,6,21,14,4,0
"20220426FLESHE",2022-04-26,"England League 1","Fleetwood Town","Sheffield Weds",2,3,"A",5,22,2,6,12,10,1,8,3,2,0,0,0,0,0,5,27,8,22,9,5,0
"20220426PORWIG",2022-04-26,"England League 1","Portsmouth","Wigan",3,2,"H",15,12,5,5,13,16,5,7,1,2,0,0,0,0,0,5,27,10,29,12,3,0
"20220426SUNROT",2022-04-26,"England League 1","Sunderland","Rotherham",1,1,"D",5,13,0,2,7,16,4,10,1,1,0,0,0,0,0,2,18,2,23,14,2,0
"20220430AFCACC",2022-04-30,"England League 1","AFC Wimbledon","Accrington",3,4,"A",11,18,5,7,9,18,4,6,0,2,0,0,0,0,0,7,29,12,27,10,2,0
"20220430BOLFLE",2022-04-30,"England League 1","Bolton","Fleetwood Town",4,2,"H",14,10,6,5,4,8,5,5,0,2,0,0,0,0,0,6,24,11,12,10,2,0
"20220430BURWYC",2022-04-30,"England League 1","Burton","Wycombe",1,2,"A",13,12,3,6,9,10,3,12,2,2,0,0,0,0,0,3,25,9,19,15,4,0
"20220430CAMCHE",2022-04-30,"England League 1","Cambridge","Cheltenham",2,2,"D",18,15,7,3,9,13,10,6,2,3,0,1,0,0,0,4,33,10,22,16,5,1
"20220430GILROT",2022-04-30,"England League 1","Gillingham","Rotherham",0,2,"A",7,17,2,7,10,11,4,10,3,3,0,0,0,0,0,2,24,9,21,14,6,0
"20220430IPSCHA",2022-04-30,"England League 1","Ipswich","Charlton",4,0,"H",21,10,4,2,14,8,6,5,0,1,0,0,0,0,0,4,31,6,22,11,1,0
"20220430LINCRE",2022-04-30,"England League 1","Lincoln","Crewe",2,1,"H",15,12,11,5,10,5,4,8,0,0,0,0,1,1,0,3,27,16,15,12,0,0
"20220430MORSUN",2022-04-30,"England League 1","Morecambe","Sunderland",0,1,"A",5,7,0,3,15,13,4,3,4,1,0,0,0,0,0,1,12,3,28,7,5,0
"20220430OXFDON",2022-04-30,"England League 1","Oxford","Doncaster",1,1,"D",14,6,6,2,12,15,5,7,0,1,0,0,1,1,0,2,20,8,27,12,1,0
"20220430PLYMIL",2022-04-30,"England League 1","Plymouth","Milton Keynes Dons",0,5,"A",10,22,4,11,16,9,1,8,1,0,1,0,0,0,0,5,32,15,25,9,1,1
"20220430SHEPOR",2022-04-30,"England League 1","Sheffield Weds","Portsmouth",4,1,"H",13,11,8,3,8,14,7,4,3,1,0,0,0,0,0,5,24,11,22,11,4,0
"20220430SHRWIG",2022-04-30,"England League 1","Shrewsbury","Wigan",0,3,"A",7,11,4,4,19,11,0,6,2,0,0,0,0,0,0,3,18,8,30,6,2,0
"20220730ACCCHA",2022-07-30,"England League 1","Accrington","Charlton",2,2,"D",22,11,6,3,12,13,6,4,3,0,0,0,0,0,0,4,33,9,25,10,3,0
"20220730BRIFOR",2022-07-30,"England League 1","Bristol Rvs","Forest Green",1,2,"A",8,17,3,7,14,13,4,7,1,3,0,0,0,0,0,3,25,10,27,11,4,0
"20220730CAMMIL",2022-07-30,"England League 1","Cambridge","Milton Keynes Dons",1,0,"H",12,8,3,0,11,7,3,5,2,3,0,0,0,0,0,1,20,3,18,8,5,0
"20220730CHEPET",2022-07-30,"England League 1","Cheltenham","Peterboro",2,3,"A",13,18,5,6,10,11,2,5,2,2,0,0,0,0,0,5,31,11,21,7,4,0
"20220730DEROXF",2022-07-30,"England League 1","Derby","Oxford",1,0,"H",13,7,4,2,13,12,7,3,4,2,0,0,0,0,0,1,20,6,25,10,6,0
"20220730IPSBOL",2022-07-30,"England League 1","Ipswich","Bolton",1,1,"D",17,4,5,1,13,14,8,6,2,2,0,0,0,0,0,2,21,6,27,14,4,0
"20220730LINEXE",2022-07-30,"England League 1","Lincoln","Exeter",1,1,"D",11,7,2,2,6,11,8,4,1,2,0,0,1,0,1,2,18,4,17,12,3,0
"20220730MORSHR",2022-07-30,"England League 1","Morecambe","Shrewsbury",0,0,"D",7,17,2,1,12,13,4,3,2,2,0,0,0,0,0,0,24,3,25,7,4,0
"20220730PLYBAR",2022-07-30,"England League 1","Plymouth","Barnsley",1,0,"H",19,9,5,1,2,15,2,6,0,2,0,0,0,0,0,1,28,6,17,8,2,0
"20220730PORFLE",2022-07-30,"England League 1","Port Vale","Fleetwood Town",2,1,"H",13,7,2,2,12,11,10,5,3,1,0,0,0,0,0,3,20,4,23,15,4,0
"20220730SHEPOR",2022-07-30,"England League 1","Sheffield Weds","Portsmouth",3,3,"D",17,7,6,5,17,12,7,0,4,0,1,0,0,0,0,6,24,11,29,7,4,1
"20220730WYCBUR",2022-07-30,"England League 1","Wycombe","Burton",3,0,"H",16,11,7,1,6,6,2,5,0,0,0,0,0,0,0,3,27,8,12,7,0,0
"20220806BARCHE",2022-08-06,"England League 1","Barnsley","Cheltenham",1,0,"H",13,7,3,2,13,10,8,1,0,4,0,0,0,0,0,1,20,5,23,9,4,0
"20220806BOLWYC",2022-08-06,"England League 1","Bolton","Wycombe",3,0,"H",21,17,6,3,12,6,4,7,0,2,0,0,0,0,0,3,38,9,18,11,2,0
"20220806BURBRI",2022-08-06,"England League 1","Burton","Bristol Rvs",0,4,"A",4,23,1,5,7,7,3,13,2,1,1,0,1,1,0,4,27,6,14,16,3,1
"20220806CHADER",2022-08-06,"England League 1","Charlton","Derby",1,0,"H",14,13,7,2,11,7,5,4,2,1,0,0,0,0,0,1,27,9,18,9,3,0
"20220806EXEPOR",2022-08-06,"England League 1","Exeter","Port Vale",4,0,"H",18,6,7,2,11,8,4,7,2,0,0,0,0,0,0,4,24,9,19,11,2,0
"20220806FLEPLY",2022-08-06,"England League 1","Fleetwood Town","Plymouth",2,1,"H",11,15,4,5,16,15,2,10,1,4,0,0,0,0,0,3,26,9,31,12,5,0
"20220806FORIPS",2022-08-06,"England League 1","Forest Green","Ipswich",1,2,"A",9,20,5,10,12,15,3,8,1,1,0,0,1,1,0,3,29,15,27,11,2,0
"20220806MILSHE",2022-08-06,"England League 1","Milton Keynes Dons","Sheffield Weds",0,1,"A",10,15,5,4,8,14,5,3,0,4,0,0,0,0,0,1,25,9,22,8,4,0
"20220806OXFCAM",2022-08-06,"England League 1","Oxford","Cambridge",1,0,"H",15,9,6,0,13,11,7,3,2,1,0,0,0,0,0,1,24,6,24,10,3,0
"20220806PETMOR",2022-08-06,"England League 1","Peterboro","Morecambe",3,0,"H",18,7,9,2,16,10,9,2,1,1,0,0,0,0,0,3,25,11,26,11,2,0
"20220806PORLIN",2022-08-06,"England League 1","Portsmouth","Lincoln",0,0,"D",16,4,6,0,10,15,3,4,0,1,0,0,0,0,0,0,20,6,25,7,1,0
"20220806SHRACC",2022-08-06,"England League 1","Shrewsbury","Accrington",0,1,"A",13,11,4,2,13,7,8,7,0,2,1,0,1,1,0,1,24,6,20,15,2,1
"20220813BRIOXF",2022-08-13,"England League 1","Bristol Rvs","Oxford",1,0,"H",6,7,3,2,11,12,7,4,2,3,0,0,0,0,0,1,13,5,23,11,5,0
"20220813ACCBUR",2022-08-13,"England League 1","Accrington","Burton",4,4,"D",20,15,8,5,8,15,4,4,0,0,0,0,1,1,0,8,35,13,23,8,0,0
"20220813CAMEXE",2022-08-13,"England League 1","Cambridge","Exeter",2,1,"H",16,17,5,2,4,8,8,7,3,2,0,0,1,0,1,3,33,7,12,15,5,0
"20220813CHEPOR",2022-08-13,"England League 1","Cheltenham","Portsmouth",0,2,"A",13,16,2,5,10,16,5,3,2,1,0,0,0,0,0,2,29,7,26,8,3,0
"20220813DERBAR",2022-08-13,"England League 1","Derby","Barnsley",2,1,"H",6,8,2,2,7,13,6,5,1,1,0,0,0,0,0,3,14,4,20,11,2,0
"20220813IPSMIL",2022-08-13,"England League 1","Ipswich","Milton Keynes Dons",3,0,"H",18,6,9,2,8,6,10,3,0,1,0,0,0,0,0,3,24,11,14,13,1,0
"20220813LINFOR",2022-08-13,"England League 1","Lincoln","Forest Green",1,1,"D",17,9,3,4,9,8,5,4,3,3,0,0,0,0,0,2,26,7,17,9,6,0
"20220813MORFLE",2022-08-13,"England League 1","Morecambe","Fleetwood Town",1,1,"D",15,19,7,5,13,11,5,7,2,1,0,1,0,0,0,2,34,12,24,12,3,1
"20220813PLYPET",2022-08-13,"England League 1","Plymouth","Peterboro",2,0,"H",17,5,8,3,11,15,5,5,2,2,0,0,0,0,0,2,22,11,26,10,4,0
"20220813PORBOL",2022-08-13,"England League 1","Port Vale","Bolton",0,0,"D",17,13,4,5,9,11,3,7,2,1,0,1,0,0,0,0,30,9,20,10,3,1
"20220813SHECHA",2022-08-13,"England League 1","Sheffield Weds","Charlton",1,0,"H",7,11,2,3,16,13,3,3,1,1,0,0,0,0,0,1,18,5,29,6,2,0
"20220813WYCSHR",2022-08-13,"England League 1","Wycombe","Shrewsbury",1,2,"A",18,6,9,2,7,13,12,4,3,0,0,0,0,0,0,3,24,11,20,16,3,0
"20220816BARBRI",2022-08-16,"England League 1","Barnsley","Bristol Rvs",3,0,"H",16,7,5,0,14,8,6,2,0,3,0,0,0,0,0,3,23,5,22,8,3,0
"20220816BOLMOR",2022-08-16,"England League 1","Bolton","Morecambe",1,0,"H",16,9,3,1,6,11,7,1,1,1,0,0,0,0,0,1,25,4,17,8,2,0
"20220816BURIPS",2022-08-16,"England League 1","Burton","Ipswich",0,1,"A",14,16,4,3,13,9,5,12,1,2,0,0,0,0,0,1,30,7,22,17,3,0
"20220816CHAPLY",2022-08-16,"England League 1","Charlton","Plymouth",5,1,"H",19,13,9,4,9,9,6,3,0,0,0,1,0,0,0,6,32,13,18,9,0,1
"20220816EXEWYC",2022-08-16,"England League 1","Exeter","Wycombe",3,1,"H",15,11,5,5,8,9,10,2,0,3,0,0,0,0,0,4,26,10,17,12,3,0
"20220816FLECHE",2022-08-16,"England League 1","Fleetwood Town","Cheltenham",0,0,"D",14,15,5,2,9,8,6,5,7,3,0,0,0,0,0,0,29,7,17,11,10,0
"20220816MILPOR",2022-08-16,"England League 1","Milton Keynes Dons","Port Vale",2,1,"H",9,11,5,3,9,14,4,4,1,1,0,0,0,0,0,3,20,8,23,8,2,0
"20220816OXFLIN",2022-08-16,"England League 1","Oxford","Lincoln",1,2,"A",15,5,5,3,14,16,10,2,2,3,0,0,0,0,0,3,20,8,30,12,5,0
"20220816PETSHE",2022-08-16,"England League 1","Peterboro","Sheffield Weds",2,0,"H",20,9,6,2,7,12,9,7,1,2,0,1,0,0,0,2,29,8,19,16,3,1
"20220816PORCAM",2022-08-16,"England League 1","Portsmouth","Cambridge",4,1,"H",9,6,5,4,8,19,1,4,0,3,0,0,1,1,0,5,15,9,27,5,3,0
"20220816SHRDER",2022-08-16,"England League 1","Shrewsbury","Derby",0,0,"D",10,12,1,4,9,8,5,10,3,1,0,0,0,0,0,0,22,5,17,15,4,0
"20220820BARWYC",2022-08-20,"England League 1","Barnsley","Wycombe",0,3,"A",12,14,5,8,8,12,7,5,3,2,0,0,0,0,0,3,26,13,20,12,5,0
"20220820BOLSHE",2022-08-20,"England League 1","Bolton","Sheffield Weds",0,2,"A",9,9,3,3,8,13,4,1,2,1,0,0,0,0,0,2,18,6,21,5,3,0
"20220820BURPOR",2022-08-20,"England League 1","Burton","Port Vale",0,2,"A",11,12,3,7,9,6,7,6,0,0,0,0,0,0,0,2,23,10,15,13,0,0
"20220820CHACAM",2022-08-20,"England League 1","Charlton","Cambridge",1,1,"D",15,10,5,4,8,4,8,4,1,2,0,0,0,0,0,2,25,9,12,12,3,0
"20220820EXECHE",2022-08-20,"England League 1","Exeter","Cheltenham",0,1,"A",16,4,6,3,13,8,12,0,0,4,0,0,0,0,0,1,20,9,21,12,4,0
"20220820FLEDER",2022-08-20,"England League 1","Fleetwood Town","Derby",0,0,"D",7,27,2,8,13,5,5,13,1,1,0,0,0,0,0,0,34,10,18,18,2,0
"20220820FORPLY",2022-08-20,"England League 1","Forest Green","Plymouth",0,3,"A",10,8,6,5,10,9,6,2,1,1,0,0,0,0,0,3,18,11,19,8,2,0
"20220820MILACC",2022-08-20,"England League 1","Milton Keynes Dons","Accrington",1,1,"D",10,16,4,4,15,16,2,5,2,4,0,0,0,0,0,2,26,8,31,7,6,0
"20220820OXFMOR",2022-08-20,"England League 1","Oxford","Morecambe",1,1,"D",27,3,10,1,12,18,8,0,2,4,0,0,0,0,0,2,30,11,30,8,6,0
"20220820PETLIN",2022-08-20,"England League 1","Peterboro","Lincoln",4,0,"H",14,4,10,1,12,12,4,5,1,2,0,0,0,0,0,4,18,11,24,9,3,0
"20220820PORBRI",2022-08-20,"England League 1","Portsmouth","Bristol Rvs",3,1,"H",23,8,7,2,9,14,12,2,3,5,0,0,0,0,0,4,31,9,23,14,8,0
"20220820SHRIPS",2022-08-20,"England League 1","Shrewsbury","Ipswich",0,3,"A",4,13,1,6,9,11,2,8,1,1,0,0,0,0,0,3,17,7,20,10,2,0
"20220827ACCEXE",2022-08-27,"England League 1","Accrington","Exeter",0,0,"D",18,7,2,0,10,15,4,6,1,1,0,0,0,0,0,0,25,2,25,10,2,0
"20220827BRISHR",2022-08-27,"England League 1","Bristol Rvs","Shrewsbury",1,1,"D",9,20,2,5,12,9,4,9,1,1,0,0,0,0,0,2,29,7,21,13,2,0
"20220827CAMBUR",2022-08-27,"England League 1","Cambridge","Burton",4,3,"H",21,12,9,3,8,20,6,5,2,4,0,1,0,0,0,7,33,12,28,11,6,1
"20220827CHEOXF",2022-08-27,"England League 1","Cheltenham","Oxford",1,2,"A",7,14,4,5,12,10,3,6,4,3,1,1,0,0,0,3,21,9,22,9,7,2
"20220827DERPET",2022-08-27,"England League 1","Derby","Peterboro",2,1,"H",16,13,5,4,12,14,8,4,1,2,0,1,0,0,0,3,29,9,26,12,3,1
"20220827IPSBAR",2022-08-27,"England League 1","Ipswich","Barnsley",2,2,"D",12,9,7,4,13,15,4,2,2,4,0,0,0,0,0,4,21,11,28,6,6,0
"20220827LINFLE",2022-08-27,"England League 1","Lincoln","Fleetwood Town",2,2,"D",6,19,4,9,11,15,3,6,3,4,0,0,0,0,0,4,25,13,26,9,7,0
"20220827MORMIL",2022-08-27,"England League 1","Morecambe","Milton Keynes Dons",0,4,"A",17,17,5,10,13,13,6,3,0,0,0,0,0,0,0,4,34,15,26,9,0,0
"20220827PLYBOL",2022-08-27,"England League 1","Plymouth","Bolton",2,0,"H",9,14,4,4,9,10,2,10,2,1,0,0,0,0,0,2,23,8,19,12,3,0
"20220827PORPOR",2022-08-27,"England League 1","Port Vale","Portsmouth",0,1,"A",8,11,4,1,10,13,3,4,2,1,0,0,0,0,0,1,19,5,23,7,3,0
"20220827SHEFOR",2022-08-27,"England League 1","Sheffield Weds","Forest Green",5,0,"H",15,3,8,0,7,11,4,1,1,3,0,0,0,0,0,5,18,8,18,5,4,0
"20220827WYCCHA",2022-08-27,"England League 1","Wycombe","Charlton",1,1,"D",16,9,4,2,12,6,9,2,4,3,0,0,0,0,0,2,25,6,18,11,7,0
"20220903ACCIPS",2022-09-03,"England League 1","Accrington","Ipswich",0,2,"A",10,18,3,7,17,9,6,12,3,3,0,0,0,0,0,2,28,10,26,18,6,0
"20220903BOLCHA",2022-09-03,"England League 1","Bolton","Charlton",3,1,"H",17,9,5,5,12,9,5,5,2,1,0,0,1,1,0,4,26,10,21,10,3,0
"20220903BRIMOR",2022-09-03,"England League 1","Bristol Rvs","Morecambe",2,2,"D",23,8,7,4,10,14,11,2,2,1,0,0,0,0,0,4,31,11,24,13,3,0
"20220903CAMLIN",2022-09-03,"England League 1","Cambridge","Lincoln",2,0,"H",9,6,2,4,9,10,4,1,0,1,0,0,0,0,0,2,15,6,19,5,1,0
"20220903DERPLY",2022-09-03,"England League 1","Derby","Plymouth",2,3,"A",12,13,3,6,11,9,4,6,1,1,0,0,0,0,0,5,25,9,20,10,2,0
"20220903EXEMIL",2022-09-03,"England League 1","Exeter","Milton Keynes Dons",1,0,"H",15,4,4,3,9,8,8,0,1,1,0,0,0,0,0,1,19,7,17,8,2,0
"20220903FLEWYC",2022-09-03,"England League 1","Fleetwood Town","Wycombe",1,1,"D",20,7,5,5,10,8,12,2,1,1,0,1,0,0,0,2,27,10,18,14,2,1
"20220903FORSHR",2022-09-03,"England League 1","Forest Green","Shrewsbury",0,2,"A",14,5,6,4,11,16,6,5,3,2,0,0,0,0,0,2,19,10,27,11,5,0
"20220903OXFBUR",2022-09-03,"England League 1","Oxford","Burton",2,1,"H",8,9,4,1,9,13,4,6,1,2,0,0,0,0,0,3,17,5,22,10,3,0
"20220903PORCHE",2022-09-03,"England League 1","Port Vale","Cheltenham",2,2,"D",10,6,3,2,7,10,2,1,0,0,0,0,0,0,0,4,16,5,17,3,0,0
"20220903PORPET",2022-09-03,"England League 1","Portsmouth","Peterboro",2,1,"H",13,10,2,3,13,13,1,7,2,1,0,0,0,0,0,3,23,5,26,8,3,0
"20220903SHEBAR",2022-09-03,"England League 1","Sheffield Weds","Barnsley",0,2,"A",11,14,3,5,13,11,10,1,2,4,0,0,0,0,0,2,25,8,24,11,6,0
"20220906FORACC",2022-09-06,"England League 1","Forest Green","Accrington",2,1,"H",12,17,5,4,7,21,1,8,3,1,0,0,0,0,0,3,29,9,28,9,4,0
"20220913BARPOR",2022-09-13,"England League 1","Barnsley","Port Vale",1,1,"D",17,15,5,4,15,7,9,7,4,0,0,0,0,0,0,2,32,9,22,16,4,0
"20220913BURPOR",2022-09-13,"England League 1","Burton","Portsmouth",0,2,"A",9,13,1,2,13,10,4,4,2,1,0,0,0,0,0,2,22,3,23,8,3,0
"20220913CHAFOR",2022-09-13,"England League 1","Charlton","Forest Green",1,1,"D",17,9,6,2,15,10,4,6,2,3,1,0,0,0,0,2,26,8,25,10,5,1
"20220913CHECAM",2022-09-13,"England League 1","Cheltenham","Cambridge",2,1,"H",13,8,5,2,10,9,6,3,3,2,0,0,0,0,0,3,21,7,19,9,5,0
"20220913IPSBRI",2022-09-13,"England League 1","Ipswich","Bristol Rvs",2,0,"H",19,5,7,3,12,11,7,1,3,1,0,2,0,0,0,2,24,10,23,8,4,2
"20220913LINDER",2022-09-13,"England League 1","Lincoln","Derby",2,0,"H",11,10,4,5,9,9,4,4,3,2,0,0,0,0,0,2,21,9,18,8,5,0
"20220913MILBOL",2022-09-13,"England League 1","Milton Keynes Dons","Bolton",0,2,"A",4,9,0,4,12,14,3,5,1,1,0,0,0,0,0,2,13,4,26,8,2,0
"20220913MORSHE",2022-09-13,"England League 1","Morecambe","Sheffield Weds",0,3,"A",4,29,1,11,7,2,3,9,0,1,0,0,0,0,0,3,33,12,9,12,1,0
"20220913PETFLE",2022-09-13,"England League 1","Peterboro","Fleetwood Town",0,1,"A",19,8,5,3,12,12,11,5,3,2,0,0,0,0,0,1,27,8,24,16,5,0
"20220913PLYOXF",2022-09-13,"England League 1","Plymouth","Oxford",1,0,"H",22,8,5,1,11,14,8,3,1,2,0,0,0,0,0,1,30,6,25,11,3,0
"20220913SHREXE",2022-09-13,"England League 1","Shrewsbury","Exeter",3,2,"H",18,15,7,5,7,7,5,10,0,1,0,0,0,0,0,5,33,12,14,15,1,0
"20220913WYCACC",2022-09-13,"England League 1","Wycombe","Accrington",1,0,"H",13,18,7,4,15,6,3,11,1,2,0,0,0,0,0,1,31,11,21,14,3,0
"20220917ACCCHE",2022-09-17,"England League 1","Accrington","Cheltenham",1,0,"H",13,11,3,1,8,14,6,4,3,2,0,0,0,0,0,1,24,4,22,10,5,0
"20220917BOLPET",2022-09-17,"England League 1","Bolton","Peterboro",1,0,"H",7,3,3,0,17,16,6,4,4,3,0,0,0,0,0,1,10,3,33,10,7,0
"20220917BRILIN",2022-09-17,"England League 1","Bristol Rvs","Lincoln",3,6,"A",15,13,7,8,9,10,9,5,2,0,0,0,0,0,0,9,28,15,19,14,2,0
"20220917CAMBAR",2022-09-17,"England League 1","Cambridge","Barnsley",0,3,"A",9,10,4,5,6,11,3,5,2,2,0,1,0,0,0,3,19,9,17,8,4,1
"20220917DERWYC",2022-09-17,"England League 1","Derby","Wycombe",2,1,"H",26,12,12,5,4,12,8,5,1,2,0,0,0,0,0,3,38,17,16,13,3,0
"20220917EXEBUR",2022-09-17,"England League 1","Exeter","Burton",0,2,"A",15,17,2,5,12,15,5,7,2,4,0,0,0,0,0,2,32,7,27,12,6,0
"20220917FLECHA",2022-09-17,"England League 1","Fleetwood Town","Charlton",1,1,"D",14,7,2,3,12,14,6,2,1,1,0,0,0,0,0,2,21,5,26,8,2,0
"20220917FORMOR",2022-09-17,"England League 1","Forest Green","Morecambe",1,2,"A",9,15,4,8,9,14,9,7,2,1,0,0,0,0,0,3,24,12,23,16,3,0
"20220917OXFMIL",2022-09-17,"England League 1","Oxford","Milton Keynes Dons",1,2,"A",19,6,5,4,11,10,5,2,0,1,0,0,0,0,0,3,25,9,21,7,1,0
"20220917PORSHR",2022-09-17,"England League 1","Port Vale","Shrewsbury",2,1,"H",12,7,3,1,11,12,6,2,2,3,0,0,0,0,0,3,19,4,23,8,5,0
"20220917PORPLY",2022-09-17,"England League 1","Portsmouth","Plymouth",2,2,"D",12,8,6,4,10,8,2,3,4,1,0,1,0,0,0,4,20,10,18,5,5,1
"20220917SHEIPS",2022-09-17,"England League 1","Sheffield Weds","Ipswich",2,2,"D",11,11,2,4,9,20,3,2,2,6,0,0,0,0,0,4,22,6,29,5,8,0
"20220924FOREXE",2022-09-24,"England League 1","Forest Green","Exeter",0,4,"A",8,13,3,6,10,10,3,8,3,1,0,0,0,0,0,4,21,9,20,11,4,0
"20220924BARCHA",2022-09-24,"England League 1","Barnsley","Charlton",3,1,"H",9,12,3,1,12,9,4,8,0,0,0,0,0,0,0,4,21,4,21,12,0,0
"20220924BRIACC",2022-09-24,"England League 1","Bristol Rvs","Accrington",0,1,"A",14,15,3,4,9,15,4,11,2,3,0,0,0,0,0,1,29,7,24,15,5,0
"20220924MORCAM",2022-09-24,"England League 1","Morecambe","Cambridge",1,2,"A",8,20,4,6,18,5,0,13,1,0,0,0,0,0,0,3,28,10,23,13,1,0
"20220924PETPOR",2022-09-24,"England League 1","Peterboro","Port Vale",3,0,"H",23,9,6,1,5,6,5,3,0,3,0,0,0,0,0,3,32,7,11,8,3,0
"20220924SHEWYC",2022-09-24,"England League 1","Sheffield Weds","Wycombe",3,1,"H",10,7,7,4,10,13,12,5,0,2,0,0,0,0,0,4,17,11,23,17,2,0
"20220924SHRBUR",2022-09-24,"England League 1","Shrewsbury","Burton",2,1,"H",6,17,2,7,7,6,3,9,1,1,0,0,0,0,0,3,23,9,13,12,2,0
"20220925PLYIPS",2022-09-25,"England League 1","Plymouth","Ipswich",2,1,"H",12,17,5,7,9,16,5,4,0,4,0,0,0,0,0,3,29,12,25,9,4,0
"20221001ACCMOR",2022-10-01,"England League 1","Accrington","Morecambe",3,1,"H",11,8,5,2,8,12,6,4,2,4,0,1,0,0,0,4,19,7,20,10,6,1
"20221001BOLLIN",2022-10-01,"England League 1","Bolton","Lincoln",2,0,"H",9,7,5,2,9,13,6,5,3,2,0,0,0,0,0,2,16,7,22,11,5,0
"20221001BURFOR",2022-10-01,"England League 1","Burton","Forest Green",3,2,"H",14,8,6,3,10,7,9,4,1,0,1,0,0,0,0,5,22,9,17,13,1,1
"20221001CAMDER",2022-10-01,"England League 1","Cambridge","Derby",0,2,"A",5,13,1,3,8,8,2,2,0,1,0,0,0,0,0,2,18,4,16,4,1,0
"20221001CHAOXF",2022-10-01,"England League 1","Charlton","Oxford",1,1,"D",11,11,4,3,8,16,1,2,3,1,0,0,0,0,0,2,22,7,24,3,4,0
"20221001CHESHR",2022-10-01,"England League 1","Cheltenham","Shrewsbury",2,0,"H",10,4,3,0,17,11,4,2,1,1,0,0,0,0,0,2,14,3,28,6,2,0
"20221001EXEBRI",2022-10-01,"England League 1","Exeter","Bristol Rvs",2,2,"D",10,9,4,4,11,15,6,3,2,2,0,0,0,0,0,4,19,8,26,9,4,0
"20221001FLEBAR",2022-10-01,"England League 1","Fleetwood Town","Barnsley",0,1,"A",4,12,1,4,12,9,5,5,4,1,0,0,0,0,0,1,16,5,21,10,5,0
"20221001IPSPOR",2022-10-01,"England League 1","Ipswich","Portsmouth",3,2,"H",18,7,6,3,13,12,8,4,1,2,0,0,0,0,0,5,25,9,25,12,3,0
"20221001MILPET",2022-10-01,"England League 1","Milton Keynes Dons","Peterboro",2,3,"A",7,20,4,9,15,13,5,9,3,1,0,0,0,0,0,5,27,13,28,14,4,0
"20221001PORSHE",2022-10-01,"England League 1","Port Vale","Sheffield Weds",0,1,"A",12,10,3,3,14,12,7,5,3,1,0,0,0,0,0,1,22,6,26,12,4,0
"20221001WYCPLY",2022-10-01,"England League 1","Wycombe","Plymouth",0,1,"A",18,17,6,3,12,6,12,7,0,1,0,0,0,0,0,1,35,9,18,19,1,0
"20221004BURFLE",2022-10-04,"England League 1","Burton","Fleetwood Town",0,1,"A",14,15,3,4,14,11,8,5,1,2,0,0,0,0,0,1,29,7,25,13,3,0
"20221004CHEBOL",2022-10-04,"England League 1","Cheltenham","Bolton",1,0,"H",14,3,5,0,8,7,10,5,2,2,0,0,0,0,0,1,17,5,15,15,4,0
"20221004IPSCAM",2022-10-04,"England League 1","Ipswich","Cambridge",3,0,"H",12,4,5,0,10,8,4,1,1,0,0,0,0,0,0,3,16,5,18,5,1,0
"20221004PLYSHE",2022-10-04,"England League 1","Plymouth","Sheffield Weds",2,1,"H",24,13,8,6,4,15,7,5,2,1,0,0,0,0,0,3,37,14,19,12,3,0
"20221008BAREXE",2022-10-08,"England League 1","Barnsley","Exeter",0,2,"A",15,9,4,3,5,7,7,4,0,1,0,0,0,0,0,2,24,7,12,11,1,0
"20221008BRICAM",2022-10-08,"England League 1","Bristol Rvs","Cambridge",2,1,"H",15,17,6,5,7,11,7,4,4,2,0,0,0,0,0,3,32,11,18,11,6,0
"20221008DERPOR",2022-10-08,"England League 1","Derby","Port Vale",1,2,"A",13,20,3,3,15,13,7,7,1,3,1,0,0,0,0,3,33,6,28,14,4,1
"20221008FORBOL",2022-10-08,"England League 1","Forest Green","Bolton",1,0,"H",6,10,4,2,13,10,2,10,4,0,0,0,0,0,0,1,16,6,23,12,4,0
"20221008LINCHA",2022-10-08,"England League 1","Lincoln","Charlton",0,0,"D",6,4,1,1,12,10,10,6,1,1,0,0,0,0,0,0,10,2,22,16,2,0
"20221008MORIPS",2022-10-08,"England League 1","Morecambe","Ipswich",1,2,"A",7,17,2,6,22,9,2,4,5,1,0,0,0,0,0,3,24,8,31,6,6,0
"20221008OXFWYC",2022-10-08,"England League 1","Oxford","Wycombe",0,1,"A",29,6,5,2,10,12,11,3,2,3,0,0,0,0,0,1,35,7,22,14,5,0
"20221008PETBUR",2022-10-08,"England League 1","Peterboro","Burton",1,1,"D",25,9,3,4,6,9,8,2,0,1,0,0,0,0,0,2,34,7,15,10,1,0
"20221008PLYACC",2022-10-08,"England League 1","Plymouth","Accrington",3,0,"H",14,11,5,3,15,17,4,5,4,3,1,1,0,0,0,3,25,8,32,9,7,2
"20221008PORFLE",2022-10-08,"England League 1","Portsmouth","Fleetwood Town",1,1,"D",18,5,2,2,15,19,6,5,2,5,0,0,0,0,0,2,23,4,34,11,7,0
"20221008SHECHE",2022-10-08,"England League 1","Sheffield Weds","Cheltenham",3,0,"H",24,6,9,3,8,9,7,2,0,4,0,0,0,0,0,3,30,12,17,9,4,0
"20221008SHRMIL",2022-10-08,"England League 1","Shrewsbury","Milton Keynes Dons",2,1,"H",10,13,5,2,7,12,7,12,1,2,0,1,0,0,0,3,23,7,19,19,3,1
"20221011CHAEXE",2022-10-11,"England League 1","Charlton","Exeter",4,2,"H",15,12,6,4,8,9,4,6,1,0,0,0,0,0,0,6,27,10,17,10,1,0
"20221011MILBRI",2022-10-11,"England League 1","Milton Keynes Dons","Bristol Rvs",0,1,"A",4,13,1,3,16,13,0,6,3,2,0,0,0,0,0,1,17,4,29,6,5,0
"20221011PETFOR",2022-10-11,"England League 1","Peterboro","Forest Green",4,1,"H",21,8,7,2,16,12,7,5,1,1,0,0,0,0,0,5,29,9,28,12,2,0
"20221015ACCDER",2022-10-15,"England League 1","Accrington","Derby",0,3,"A",8,14,1,7,7,14,5,6,1,2,0,0,0,0,0,3,22,8,21,11,3,0
"20221015BOLBAR",2022-10-15,"England League 1","Bolton","Barnsley",0,0,"D",7,6,1,2,9,11,8,2,3,2,0,0,0,0,0,0,13,3,20,10,5,0
"20221015BURMOR",2022-10-15,"England League 1","Burton","Morecambe",1,1,"D",15,6,3,4,6,14,6,2,0,5,0,0,0,0,0,2,21,7,20,8,5,0
"20221015CAMSHE",2022-10-15,"England League 1","Cambridge","Sheffield Weds",0,2,"A",11,15,1,8,9,17,6,6,1,3,0,0,0,0,0,2,26,9,26,12,4,0
"20221015CHEBRI",2022-10-15,"England League 1","Cheltenham","Bristol Rvs",1,4,"A",10,5,4,4,10,6,7,2,0,1,0,0,0,0,0,5,15,8,16,9,1,0
"20221015EXEOXF",2022-10-15,"England League 1","Exeter","Oxford",2,4,"A",10,19,3,9,10,12,5,4,3,1,0,0,0,0,0,6,29,12,22,9,4,0
"20221015FLESHR",2022-10-15,"England League 1","Fleetwood Town","Shrewsbury",0,1,"A",22,10,7,2,17,11,7,2,4,5,0,0,0,0,0,1,32,9,28,9,9,0
"20221015IPSLIN",2022-10-15,"England League 1","Ipswich","Lincoln",0,1,"A",33,3,5,2,2,9,14,4,1,0,0,0,0,0,0,1,36,7,11,18,1,0
"20221015MILPLY",2022-10-15,"England League 1","Milton Keynes Dons","Plymouth",1,4,"A",10,16,3,7,8,8,1,3,2,0,0,0,0,0,0,5,26,10,16,4,2,0
"20221015PORFOR",2022-10-15,"England League 1","Port Vale","Forest Green",2,2,"D",20,9,7,3,8,15,13,2,3,5,0,0,0,0,0,4,29,10,23,15,8,0
"20221015WYCPET",2022-10-15,"England League 1","Wycombe","Peterboro",3,1,"H",15,13,4,7,17,8,4,5,2,0,0,0,0,0,0,4,28,11,25,9,2,0
"20221017CHAPOR",2022-10-17,"England League 1","Charlton","Portsmouth",3,0,"H",11,10,6,3,16,7,8,8,3,1,0,1,0,0,0,3,21,9,23,16,4,1
"20221021IPSDER",2022-10-21,"England League 1","Ipswich","Derby",1,0,"H",16,5,3,0,13,15,11,3,2,2,0,0,0,0,0,1,21,3,28,14,4,0
"20221022LINSHE",2022-10-22,"England League 1","Lincoln","Sheffield Weds",1,1,"D",6,17,3,3,10,11,3,6,2,2,0,0,0,0,0,2,23,6,21,9,4,0
"20221022ACCBOL",2022-10-22,"England League 1","Accrington","Bolton",2,3,"A",13,17,5,7,17,12,4,7,4,1,0,0,1,0,1,5,30,12,29,11,5,0
"20221022BRIPLY",2022-10-22,"England League 1","Bristol Rvs","Plymouth",2,2,"D",17,10,6,3,10,14,8,7,1,4,0,0,0,0,0,4,27,9,24,15,5,0
"20221022BURCHE",2022-10-22,"England League 1","Burton","Cheltenham",1,0,"H",16,4,5,1,8,13,6,1,1,2,0,0,0,0,0,1,20,6,21,7,3,0
"20221022CAMPOR",2022-10-22,"England League 1","Cambridge","Port Vale",0,1,"A",8,10,0,4,12,9,4,6,1,3,0,0,0,0,0,1,18,4,21,10,4,0
"20221022EXEFLE",2022-10-22,"England League 1","Exeter","Fleetwood Town",2,1,"H",8,13,5,3,9,8,3,5,0,1,0,0,0,0,0,3,21,8,17,8,1,0
"20221022FORPOR",2022-10-22,"England League 1","Forest Green","Portsmouth",0,1,"A",9,16,1,5,14,10,3,7,3,2,0,0,0,0,0,1,25,6,24,10,5,0
"20221022MILWYC",2022-10-22,"England League 1","Milton Keynes Dons","Wycombe",0,1,"A",14,11,7,4,8,9,6,2,1,1,0,0,0,0,0,1,25,11,17,8,2,0
"20221022MORBAR",2022-10-22,"England League 1","Morecambe","Barnsley",1,0,"H",5,14,1,3,11,7,3,6,3,2,0,0,1,1,0,1,19,4,18,9,5,0
"20221022OXFPET",2022-10-22,"England League 1","Oxford","Peterboro",1,2,"A",12,8,2,4,20,16,6,4,3,3,1,0,0,0,0,3,20,6,36,10,6,1
"20221022SHRCHA",2022-10-22,"England League 1","Shrewsbury","Charlton",0,1,"A",9,17,2,4,15,8,9,4,1,3,0,0,0,0,0,1,26,6,23,13,4,0
"20221025BARLIN",2022-10-25,"England League 1","Barnsley","Lincoln",0,1,"A",13,7,2,1,9,8,6,2,2,1,0,0,0,0,0,1,20,3,17,8,3,0
"20221025BOLBUR",2022-10-25,"England League 1","Bolton","Burton",2,1,"H",16,13,6,4,10,16,6,8,2,1,0,0,0,0,0,3,29,10,26,14,3,0
"20221025CHAMIL",2022-10-25,"England League 1","Charlton","Milton Keynes Dons",0,2,"A",7,8,1,6,13,10,1,2,0,0,1,0,0,0,0,2,15,7,23,3,0,1
"20221025CHEMOR",2022-10-25,"England League 1","Cheltenham","Morecambe",1,0,"H",17,5,5,1,7,13,3,2,0,3,0,0,0,0,0,1,22,6,20,5,3,0
"20221025DEREXE",2022-10-25,"England League 1","Derby","Exeter",0,0,"D",10,4,3,1,9,11,8,4,2,3,0,0,0,0,0,0,14,4,20,12,5,0
"20221025FLEFOR",2022-10-25,"England League 1","Fleetwood Town","Forest Green",1,1,"D",17,11,4,4,12,9,8,3,2,2,0,0,0,0,0,2,28,8,21,11,4,0
"20221025PETACC",2022-10-25,"England League 1","Peterboro","Accrington",3,1,"H",14,18,6,5,11,19,7,3,2,4,0,0,0,0,0,4,32,11,30,10,6,0
"20221025PLYSHR",2022-10-25,"England League 1","Plymouth","Shrewsbury",2,1,"H",17,14,5,3,9,9,9,5,1,2,0,0,0,0,0,3,31,8,18,14,3,0
"20221025PORIPS",2022-10-25,"England League 1","Port Vale","Ipswich",2,3,"A",10,14,3,7,12,14,4,6,0,0,0,0,0,0,0,5,24,10,26,10,0,0
"20221025POROXF",2022-10-25,"England League 1","Portsmouth","Oxford",1,1,"D",19,10,4,2,9,21,6,5,1,3,0,1,0,0,0,2,29,6,30,11,4,1
"20221025WYCCAM",2022-10-25,"England League 1","Wycombe","Cambridge",2,3,"A",22,10,6,5,12,9,11,2,2,2,0,0,0,0,0,5,32,11,21,13,4,0
"20221026SHEBRI",2022-10-26,"England League 1","Sheffield Weds","Bristol Rvs",1,1,"D",22,10,6,5,10,10,7,1,1,1,0,0,0,0,0,2,32,11,20,8,2,0
"20221029BARFOR",2022-10-29,"England League 1","Barnsley","Forest Green",2,0,"H",18,3,6,0,15,10,9,3,1,0,0,0,0,0,0,2,21,6,25,12,1,0
"20221029BOLOXF",2022-10-29,"England League 1","Bolton","Oxford",1,3,"A",10,12,3,5,13,18,4,4,2,5,0,0,0,0,0,4,22,8,31,8,7,0
"20221029CHAIPS",2022-10-29,"England League 1","Charlton","Ipswich",4,4,"D",9,18,7,5,14,20,1,5,2,5,0,0,0,0,0,8,27,12,34,6,7,0
"20221029CHEMIL",2022-10-29,"England League 1","Cheltenham","Milton Keynes Dons",0,0,"D",14,15,3,8,7,8,3,6,1,3,0,0,0,0,0,0,29,11,15,9,4,0
"20221029DERBRI",2022-10-29,"England League 1","Derby","Bristol Rvs",4,2,"H",16,10,5,6,14,8,7,4,4,1,0,0,0,0,0,6,26,11,22,11,5,0
"20221029FLEACC",2022-10-29,"England League 1","Fleetwood Town","Accrington",3,0,"H",12,15,4,2,10,9,9,5,3,1,0,0,0,0,0,3,27,6,19,14,4,0
"20221029PETCAM",2022-10-29,"England League 1","Peterboro","Cambridge",1,0,"H",19,10,3,4,9,15,6,0,1,3,0,0,0,0,0,1,29,7,24,6,4,0
"20221029PORLIN",2022-10-29,"England League 1","Port Vale","Lincoln",1,0,"H",16,2,5,1,7,8,8,4,3,2,0,0,0,0,0,1,18,6,15,12,5,0
"20221029PORSHR",2022-10-29,"England League 1","Portsmouth","Shrewsbury",1,1,"D",16,4,3,1,14,10,7,1,1,0,0,0,0,0,0,2,20,4,24,8,1,0
"20221029SHEBUR",2022-10-29,"England League 1","Sheffield Weds","Burton",4,2,"H",16,11,7,4,9,7,7,1,0,0,0,0,0,0,0,6,27,11,16,8,0,0
"20221029WYCMOR",2022-10-29,"England League 1","Wycombe","Morecambe",1,1,"D",14,16,4,5,11,7,13,3,2,3,0,0,0,0,0,2,30,9,18,16,5,0
"20221031PLYEXE",2022-10-31,"England League 1","Plymouth","Exeter",4,2,"H",10,10,5,5,4,10,6,7,0,0,0,0,0,0,0,6,20,10,14,13,0,0
"20221101LINACC",2022-11-01,"England League 1","Lincoln","Accrington",1,1,"D",9,10,7,3,9,11,7,8,3,4,0,0,1,0,1,2,19,10,20,15,7,0
"20221101MORDER",2022-11-01,"England League 1","Morecambe","Derby",1,1,"D",10,27,5,11,9,5,3,11,2,2,0,0,0,0,0,2,37,16,14,14,4,0
"20221101OXFFLE",2022-11-01,"England League 1","Oxford","Fleetwood Town",1,1,"D",21,10,6,6,12,9,7,3,3,3,0,0,0,0,0,2,31,12,21,10,6,0
"20221101WYCPOR",2022-11-01,"England League 1","Wycombe","Port Vale",2,2,"D",13,12,5,4,14,13,6,4,2,1,0,0,0,0,0,4,25,9,27,10,3,0
"20221109SHROXF",2022-11-09,"England League 1","Shrewsbury","Oxford",1,1,"D",12,11,5,5,14,12,12,0,3,2,0,0,0,0,0,2,23,10,26,12,5,0
"20221112ACCSHE",2022-11-12,"England League 1","Accrington","Sheffield Weds",0,1,"A",9,18,4,5,9,13,3,8,1,3,0,0,1,1,0,1,27,9,22,11,4,0
"20221112BRIFLE",2022-11-12,"England League 1","Bristol Rvs","Fleetwood Town",2,2,"D",13,13,3,5,15,14,8,2,4,2,0,0,0,0,0,4,26,8,29,10,6,0
"20221112BURCHA",2022-11-12,"England League 1","Burton","Charlton",3,3,"D",25,12,10,4,10,9,12,4,1,0,0,0,0,0,0,6,37,14,19,16,1,0
"20221112CAMBOL",2022-11-12,"England League 1","Cambridge","Bolton",0,0,"D",10,14,5,1,10,15,9,5,2,4,0,1,0,0,0,0,24,6,25,14,6,1
"20221112EXEPET",2022-11-12,"England League 1","Exeter","Peterboro",3,2,"H",6,16,4,7,9,9,4,4,3,0,0,0,0,0,0,5,22,11,18,8,3,0
"20221112FORWYC",2022-11-12,"England League 1","Forest Green","Wycombe",0,2,"A",14,16,1,4,8,21,6,6,4,3,0,0,0,0,0,2,30,5,29,12,7,0
"20221112IPSCHE",2022-11-12,"England League 1","Ipswich","Cheltenham",1,1,"D",29,3,4,1,9,6,15,0,1,3,0,0,0,0,0,2,32,5,15,15,4,0
"20221112LINPLY",2022-11-12,"England League 1","Lincoln","Plymouth",1,1,"D",17,16,8,7,10,15,3,5,0,3,0,0,0,0,0,2,33,15,25,8,3,0
"20221112MILDER",2022-11-12,"England League 1","Milton Keynes Dons","Derby",1,3,"A",13,8,4,3,7,12,6,9,3,3,0,0,0,0,0,4,21,7,19,15,6,0
"20221112MORPOR",2022-11-12,"England League 1","Morecambe","Portsmouth",1,1,"D",15,14,4,5,13,12,5,8,3,3,0,0,0,0,0,2,29,9,25,13,6,0
"20221112OXFPOR",2022-11-12,"England League 1","Oxford","Port Vale",4,0,"H",21,14,8,2,17,10,3,9,1,3,0,0,0,0,0,4,35,10,27,12,4,0
"20221112SHRBAR",2022-11-12,"England League 1","Shrewsbury","Barnsley",0,1,"A",9,14,1,2,6,10,6,3,5,2,0,0,0,0,0,1,23,3,16,9,7,0
"20221118PORDER",2022-11-18,"England League 1","Portsmouth","Derby",0,0,"D",10,13,1,3,16,12,2,5,2,4,0,0,0,0,0,0,23,4,28,7,6,0
"20221119EXEIPS",2022-11-19,"England League 1","Exeter","Ipswich",0,2,"A",7,13,1,6,6,8,6,7,1,2,0,0,0,0,0,2,20,7,14,13,3,0
"20221119BARMIL",2022-11-19,"England League 1","Barnsley","Milton Keynes Dons",3,1,"H",20,2,6,2,10,8,7,2,3,4,0,0,0,0,0,4,22,8,18,9,7,0
"20221119BRIPET",2022-11-19,"England League 1","Bristol Rvs","Peterboro",1,0,"H",19,9,5,1,5,16,9,2,1,0,0,1,1,1,0,1,28,6,21,11,1,1
"20221119BURPLY",2022-11-19,"England League 1","Burton","Plymouth",2,2,"D",14,10,6,4,14,10,9,4,4,1,0,0,0,0,0,4,24,10,24,13,5,0
"20221119CAMACC",2022-11-19,"England League 1","Cambridge","Accrington",0,1,"A",5,12,1,2,16,12,1,7,1,2,0,0,1,1,0,1,17,3,28,8,3,0
"20221119CHEWYC",2022-11-19,"England League 1","Cheltenham","Wycombe",1,0,"H",11,14,4,5,2,11,2,4,0,1,0,0,0,0,0,1,25,9,13,6,1,0
"20221119FLEBOL",2022-11-19,"England League 1","Fleetwood Town","Bolton",1,2,"A",12,18,2,6,15,12,2,6,3,3,0,0,0,0,0,3,30,8,27,8,6,0
"20221119LINMOR",2022-11-19,"England League 1","Lincoln","Morecambe",2,1,"H",13,9,5,2,7,9,5,4,4,1,0,0,0,0,0,3,22,7,16,9,5,0
"20221119OXFFOR",2022-11-19,"England League 1","Oxford","Forest Green",1,1,"D",18,12,9,5,9,12,5,8,1,6,0,0,0,0,0,2,30,14,21,13,7,0
"20221119PORCHA",2022-11-19,"England League 1","Port Vale","Charlton",1,0,"H",13,5,1,1,11,9,2,7,1,3,0,0,0,0,0,1,18,2,20,9,4,0
"20221119SHESHR",2022-11-19,"England League 1","Sheffield Weds","Shrewsbury",1,0,"H",14,9,4,1,9,12,7,1,1,1,0,0,0,0,0,1,23,5,21,8,2,0
"20221202BOLBRI",2022-12-02,"England League 1","Bolton","Bristol Rvs",1,1,"D",19,2,5,1,12,17,11,1,1,3,0,0,0,0,0,2,21,6,29,12,4,0
"20221202CHACHE",2022-12-02,"England League 1","Charlton","Cheltenham",0,1,"A",14,13,4,5,7,8,11,4,0,2,0,0,0,0,0,1,27,9,15,15,2,0
"20221202IPSFLE",2022-12-02,"England League 1","Ipswich","Fleetwood Town",1,1,"D",12,7,6,3,9,10,5,2,1,2,0,1,0,0,0,2,19,9,19,7,3,1
"20221202MOREXE",2022-12-02,"England League 1","Morecambe","Exeter",1,1,"D",7,19,1,7,4,12,6,15,2,0,0,0,0,0,0,2,26,8,16,21,2,0
"20221202PETBAR",2022-12-02,"England League 1","Peterboro","Barnsley",1,2,"A",6,4,1,3,10,11,3,2,0,2,0,0,0,0,0,3,10,4,21,5,2,0
"20221202PLYPOR",2022-12-02,"England League 1","Plymouth","Port Vale",0,2,"A",15,12,6,7,9,10,4,3,1,2,0,0,0,0,0,2,27,13,19,7,3,0
"20221203DERSHE",2022-12-03,"England League 1","Derby","Sheffield Weds",0,0,"D",7,5,3,2,10,5,4,2,2,0,0,0,0,0,0,0,12,5,15,6,2,0
"20221203MILBUR",2022-12-03,"England League 1","Milton Keynes Dons","Burton",1,1,"D",18,8,3,3,7,13,11,2,1,2,0,0,0,0,0,2,26,6,20,13,3,0
"20221203SHRLIN",2022-12-03,"England League 1","Shrewsbury","Lincoln",2,0,"H",10,13,4,3,12,8,5,5,2,3,0,0,0,0,0,2,23,7,20,10,5,0
"20221203FORCAM",2022-12-03,"England League 1","Forest Green","Cambridge",2,1,"H",12,8,4,3,11,12,5,6,3,1,1,0,0,0,0,3,20,7,23,11,4,1
"20221203ACCOXF",2022-12-03,"England League 1","Accrington","Oxford",1,1,"D",12,7,4,1,11,14,5,2,4,2,0,0,1,0,1,2,19,5,25,7,6,0
"20221204WYCPOR",2022-12-04,"England League 1","Wycombe","Portsmouth",2,0,"H",14,10,5,3,12,14,7,10,1,2,0,0,0,0,0,2,24,8,26,17,3,0
"20221210IPSPET",2022-12-10,"England League 1","Ipswich","Peterboro",2,1,"H",11,8,4,3,13,5,4,6,3,0,0,0,0,0,0,3,19,7,18,10,3,0
"20221210SHRBOL",2022-12-10,"England League 1","Shrewsbury","Bolton",3,2,"H",8,9,6,3,14,11,6,2,4,1,0,0,0,0,0,5,17,9,25,8,5,0
"20221210BURDER",2022-12-10,"England League 1","Burton","Derby",1,1,"D",11,14,4,4,11,9,10,3,0,2,0,0,0,0,0,2,25,8,20,13,2,0
"20221210FORCHE",2022-12-10,"England League 1","Forest Green","Cheltenham",1,0,"H",14,6,5,1,13,16,6,3,0,3,0,0,0,0,0,1,20,6,29,9,3,0
"20221210BRIPOR",2022-12-10,"England League 1","Bristol Rvs","Port Vale",1,0,"H",10,7,4,2,10,16,6,4,1,2,0,0,0,0,0,1,17,6,26,10,3,0
"20221210CAMPLY",2022-12-10,"England League 1","Cambridge","Plymouth",0,0,"D",13,14,4,1,7,17,5,7,0,5,0,0,0,0,0,0,27,5,24,12,5,0
"20221210EXESHE",2022-12-10,"England League 1","Exeter","Sheffield Weds",1,1,"D",7,12,5,4,14,8,5,5,4,1,0,0,0,0,0,2,19,9,22,10,5,0
"20221210LINWYC",2022-12-10,"England League 1","Lincoln","Wycombe",0,0,"D",11,5,1,1,10,10,4,8,0,0,0,0,0,0,0,0,16,2,20,12,0,0
"20221210MILFLE",2022-12-10,"England League 1","Milton Keynes Dons","Fleetwood Town",1,2,"A",17,7,6,2,10,15,7,2,1,1,0,0,0,0,0,3,24,8,25,9,2,0
"20221217BARBUR",2022-12-17,"England League 1","Barnsley","Burton",2,0,"H",11,8,4,3,9,9,3,6,1,1,0,0,0,0,0,2,19,7,18,9,2,0
"20221217BOLEXE",2022-12-17,"England League 1","Bolton","Exeter",2,0,"H",11,5,3,2,8,11,4,5,0,1,0,0,0,0,0,2,16,5,19,9,1,0
"20221217CHABRI",2022-12-17,"England League 1","Charlton","Bristol Rvs",1,2,"A",13,11,5,5,11,11,9,3,0,2,0,0,0,0,0,3,24,10,22,12,2,0
"20221217DERFOR",2022-12-17,"England League 1","Derby","Forest Green",4,0,"H",15,3,8,1,11,11,4,2,3,0,0,0,0,0,0,4,18,9,22,6,3,0
"20221217PLYMOR",2022-12-17,"England League 1","Plymouth","Morecambe",2,1,"H",32,8,13,5,6,13,7,2,0,1,0,0,0,0,0,3,40,18,19,9,1,0
"20221217PORMIL",2022-12-17,"England League 1","Portsmouth","Milton Keynes Dons",0,2,"A",14,14,8,4,12,8,6,2,3,1,0,0,1,1,0,2,28,12,20,8,4,0
"20221217SHEOXF",2022-12-17,"England League 1","Sheffield Weds","Oxford",0,0,"D",15,13,2,5,15,10,4,2,3,1,0,0,0,0,0,0,28,7,25,6,4,0
"20221217WYCIPS",2022-12-17,"England League 1","Wycombe","Ipswich",1,0,"H",9,19,3,6,13,10,2,7,4,0,0,0,0,0,0,1,28,9,23,9,4,0
"20221226ACCBAR",2022-12-26,"England League 1","Accrington","Barnsley",1,1,"D",4,20,2,5,11,16,4,16,2,3,0,0,0,0,0,2,24,7,27,20,5,0
"20221226BURLIN",2022-12-26,"England League 1","Burton","Lincoln",3,0,"H",11,8,5,2,13,8,8,1,0,1,0,0,0,0,0,3,19,7,21,9,1,0
"20221226CAMSHR",2022-12-26,"England League 1","Cambridge","Shrewsbury",2,1,"H",9,13,2,5,13,9,4,5,3,2,0,1,0,0,0,3,22,7,22,9,5,1
"20221226CHAPET",2022-12-26,"England League 1","Charlton","Peterboro",1,1,"D",8,19,3,6,14,10,3,10,1,0,0,0,0,0,0,2,27,9,24,13,1,0
"20221226CHEPLY",2022-12-26,"England League 1","Cheltenham","Plymouth",0,1,"A",16,13,6,3,7,10,6,4,1,1,0,0,0,0,0,1,29,9,17,10,2,0
"20221226EXEPOR",2022-12-26,"England League 1","Exeter","Portsmouth",0,0,"D",14,15,3,5,16,13,4,14,3,3,0,0,0,0,0,0,29,8,29,18,6,0
"20221226FLESHE",2022-12-26,"England League 1","Fleetwood Town","Sheffield Weds",1,2,"A",10,19,4,4,8,11,3,8,1,2,1,0,0,0,0,3,29,8,19,11,3,1
"20221226IPSOXF",2022-12-26,"England League 1","Ipswich","Oxford",3,0,"H",18,7,9,2,7,8,13,4,1,2,0,0,0,0,0,3,25,11,15,17,3,0
"20221226MILFOR",2022-12-26,"England League 1","Milton Keynes Dons","Forest Green",1,0,"H",14,14,5,5,15,15,6,7,4,2,0,0,0,0,0,1,28,10,30,13,6,0
"20221226PORMOR",2022-12-26,"England League 1","Port Vale","Morecambe",1,0,"H",8,8,3,1,9,16,5,5,2,3,0,1,0,0,0,1,16,4,25,10,5,1
"20221226WYCBRI",2022-12-26,"England League 1","Wycombe","Bristol Rvs",2,1,"H",15,14,5,5,14,13,3,7,3,2,0,0,0,0,0,3,29,10,27,10,5,0
"20221227BOLDER",2022-12-27,"England League 1","Bolton","Derby",0,0,"D",9,11,2,2,9,8,2,4,2,1,0,0,0,0,0,0,20,4,17,6,3,0
"20221229BARFLE",2022-12-29,"England League 1","Barnsley","Fleetwood Town",2,1,"H",12,3,5,1,16,11,2,3,5,1,0,0,0,0,0,3,15,6,27,5,6,0
"20221229BRIEXE",2022-12-29,"England League 1","Bristol Rvs","Exeter",3,4,"A",12,14,6,8,9,20,3,8,1,6,0,0,0,0,0,7,26,14,29,11,7,0
"20221229FORBUR",2022-12-29,"England League 1","Forest Green","Burton",1,2,"A",8,7,2,3,9,16,6,7,1,3,0,0,0,0,0,3,15,5,25,13,4,0
"20221229MORACC",2022-12-29,"England League 1","Morecambe","Accrington",2,0,"H",9,21,4,8,18,14,3,8,1,2,0,0,0,0,0,2,30,12,32,11,3,0
"20221229OXFCHA",2022-12-29,"England League 1","Oxford","Charlton",3,1,"H",16,10,5,3,16,14,4,3,0,3,0,0,0,0,0,4,26,8,30,7,3,0
"20221229PETMIL",2022-12-29,"England League 1","Peterboro","Milton Keynes Dons",2,0,"H",16,5,6,2,12,11,7,2,3,2,0,0,0,0,0,2,21,8,23,9,5,0
"20221229PLYWYC",2022-12-29,"England League 1","Plymouth","Wycombe",1,0,"H",16,15,3,1,12,11,11,3,1,2,0,0,0,0,0,1,31,4,23,14,3,0
"20221229PORIPS",2022-12-29,"England League 1","Portsmouth","Ipswich",2,2,"D",7,14,2,5,13,13,3,3,1,1,0,0,0,0,0,4,21,7,26,6,2,0
"20221229SHEPOR",2022-12-29,"England League 1","Sheffield Weds","Port Vale",2,0,"H",8,8,2,1,10,11,3,3,1,2,0,0,0,0,0,2,16,3,21,6,3,0
"20221229SHRCHE",2022-12-29,"England League 1","Shrewsbury","Cheltenham",0,1,"A",13,3,1,1,10,12,1,4,1,4,1,1,0,0,0,1,16,2,22,5,5,2
"20221230DERCAM",2022-12-30,"England League 1","Derby","Cambridge",1,0,"H",14,9,6,2,13,11,2,4,2,3,0,0,0,0,0,1,23,8,24,6,5,0
"20221230LINBOL",2022-12-30,"England League 1","Lincoln","Bolton",1,1,"D",5,6,3,1,14,12,2,4,4,1,1,0,1,0,1,2,11,4,26,6,5,1
"20230101BRICHE",2023-01-01,"England League 1","Bristol Rvs","Cheltenham",2,1,"H",10,20,3,4,9,11,5,6,1,1,0,0,0,0,0,3,30,7,20,11,2,0
"20230101FORPOR",2023-01-01,"England League 1","Forest Green","Port Vale",1,3,"A",10,18,1,4,12,14,2,8,3,3,0,0,0,0,0,4,28,5,26,10,6,0
"20230101MORBUR",2023-01-01,"England League 1","Morecambe","Burton",5,0,"H",18,7,11,0,12,8,8,2,1,1,0,0,0,0,0,5,25,11,20,10,2,0
"20230101OXFEXE",2023-01-01,"England League 1","Oxford","Exeter",0,1,"A",20,9,5,4,4,15,11,4,1,4,0,0,0,0,0,1,29,9,19,15,5,0
"20230101PETWYC",2023-01-01,"England League 1","Peterboro","Wycombe",0,3,"A",25,13,7,7,8,2,8,3,0,0,0,0,0,0,0,3,38,14,10,11,0,0
"20230101PLYMIL",2023-01-01,"England League 1","Plymouth","Milton Keynes Dons",3,1,"H",10,10,6,4,10,9,1,3,0,1,0,0,0,0,0,4,20,10,19,4,1,0
"20230101PORCHA",2023-01-01,"England League 1","Portsmouth","Charlton",1,3,"A",11,14,4,4,15,7,7,6,1,2,1,0,0,0,0,4,25,8,22,13,3,1
"20230101SHRFLE",2023-01-01,"England League 1","Shrewsbury","Fleetwood Town",0,3,"A",6,15,0,4,15,11,8,3,1,1,1,0,0,0,0,3,21,4,26,11,2,1
"20230102BARBOL",2023-01-02,"England League 1","Barnsley","Bolton",0,3,"A",9,14,3,3,12,11,3,8,0,2,1,0,0,0,0,3,23,6,23,11,2,1
"20230102DERACC",2023-01-02,"England League 1","Derby","Accrington",4,0,"H",15,5,6,3,14,12,6,5,3,3,1,0,0,0,0,4,20,9,26,11,6,1
"20230102LINIPS",2023-01-02,"England League 1","Lincoln","Ipswich",1,1,"D",2,21,1,8,9,12,3,9,2,1,1,0,0,0,0,2,23,9,21,12,3,1
"20230102SHECAM",2023-01-02,"England League 1","Sheffield Weds","Cambridge",5,0,"H",25,10,8,2,11,5,6,3,0,1,0,0,0,0,0,5,35,10,16,9,1,0
"20230107BOLPLY",2023-01-07,"England League 1","Bolton","Plymouth",0,0,"D",14,6,2,2,9,10,7,4,1,2,0,1,0,0,0,0,20,4,19,11,3,1
"20230107CAMBRI",2023-01-07,"England League 1","Cambridge","Bristol Rvs",1,2,"A",12,4,2,4,10,14,9,3,3,4,0,0,0,0,0,3,16,6,24,12,7,0
"20230107CHALIN",2023-01-07,"England League 1","Charlton","Lincoln",2,1,"H",19,11,7,2,15,11,0,1,3,1,0,0,0,0,0,3,30,9,26,1,4,0
"20230107MORCHE",2023-01-07,"England League 1","Morecambe","Cheltenham",2,1,"H",9,12,5,1,12,13,5,6,2,1,0,0,0,0,0,3,21,6,25,11,3,0
"20230114ACCBRI",2023-01-14,"England League 1","Accrington","Bristol Rvs",2,0,"H",9,8,2,4,11,14,4,2,4,2,0,0,0,0,0,2,17,6,25,6,6,0
"20230114BOLPOR",2023-01-14,"England League 1","Bolton","Portsmouth",3,0,"H",13,13,8,3,8,12,4,3,0,1,0,0,0,0,0,3,26,11,20,7,1,0
"20230114BURSHR",2023-01-14,"England League 1","Burton","Shrewsbury",0,4,"A",9,11,1,7,8,10,9,2,0,3,0,0,0,0,0,4,20,8,18,11,3,0
"20230114CHABAR",2023-01-14,"England League 1","Charlton","Barnsley",2,0,"H",8,23,4,2,17,13,0,11,3,5,0,0,0,0,0,2,31,6,30,11,8,0
"20230114CHEDER",2023-01-14,"England League 1","Cheltenham","Derby",2,3,"A",14,14,5,5,10,6,3,3,2,2,0,0,0,0,0,5,28,10,16,6,4,0
"20230114EXEFOR",2023-01-14,"England League 1","Exeter","Forest Green",1,1,"D",12,6,2,1,11,7,10,3,2,1,0,0,0,0,0,2,18,3,18,13,3,0
"20230114FLEOXF",2023-01-14,"England League 1","Fleetwood Town","Oxford",1,2,"A",19,11,7,2,15,12,10,3,1,3,0,0,0,0,0,3,30,9,27,13,4,0
"20230114IPSPLY",2023-01-14,"England League 1","Ipswich","Plymouth",1,1,"D",12,9,5,5,9,10,4,2,2,1,0,0,0,0,0,2,21,10,19,6,3,0
"20230114MILLIN",2023-01-14,"England League 1","Milton Keynes Dons","Lincoln",0,0,"D",5,6,1,2,12,12,5,5,1,1,0,0,0,0,0,0,11,3,24,10,2,0
"20230114WYCSHE",2023-01-14,"England League 1","Wycombe","Sheffield Weds",0,1,"A",8,12,2,4,9,15,4,3,1,1,0,0,0,0,0,1,20,6,24,7,2,0
"20230116PORPET",2023-01-16,"England League 1","Port Vale","Peterboro",0,2,"A",11,14,4,3,6,11,1,5,0,1,0,0,0,0,0,2,25,7,17,6,1,0
"20230121BARACC",2023-01-21,"England League 1","Barnsley","Accrington",3,1,"H",14,9,5,2,14,13,8,2,1,2,0,0,0,0,0,4,23,7,27,10,3,0
"20230121DERBOL",2023-01-21,"England League 1","Derby","Bolton",2,1,"H",8,6,5,3,8,10,5,4,1,1,0,0,0,0,0,3,14,8,18,9,2,0
"20230121FORMIL",2023-01-21,"England League 1","Forest Green","Milton Keynes Dons",1,2,"A",6,6,2,2,9,9,3,3,2,4,0,0,0,0,0,3,12,4,18,6,6,0
"20230121OXFIPS",2023-01-21,"England League 1","Oxford","Ipswich",2,1,"H",13,17,5,6,9,22,3,5,0,1,0,0,0,0,0,3,30,11,31,8,1,0
"20230121PLYCHE",2023-01-21,"England League 1","Plymouth","Cheltenham",4,2,"H",15,9,6,4,9,12,6,5,0,1,0,0,0,0,0,6,24,10,21,11,1,0
"20230121POREXE",2023-01-21,"England League 1","Portsmouth","Exeter",2,0,"H",14,12,4,3,12,8,7,10,1,2,0,0,0,0,0,2,26,7,20,17,3,0
"20230121SHEFLE",2023-01-21,"England League 1","Sheffield Weds","Fleetwood Town",1,0,"H",14,9,4,2,15,15,4,2,1,2,0,0,0,0,0,1,23,6,30,6,3,0
"20230121SHRCAM",2023-01-21,"England League 1","Shrewsbury","Cambridge",5,1,"H",19,10,8,2,10,11,7,5,0,4,0,0,0,0,0,6,29,10,21,12,4,0
"20230124BOLFOR",2023-01-24,"England League 1","Bolton","Forest Green",1,0,"H",4,12,2,4,6,7,1,1,1,1,1,0,0,0,0,1,16,6,13,2,2,1
"20230124FLEPOR",2023-01-24,"England League 1","Fleetwood Town","Portsmouth",0,2,"A",14,15,3,7,12,13,4,7,2,3,0,1,0,0,0,2,29,10,25,11,5,1
"20230124IPSMOR",2023-01-24,"England League 1","Ipswich","Morecambe",4,0,"H",19,4,9,0,13,11,6,1,1,2,0,0,0,0,0,4,23,9,24,7,3,0
"20230124MILSHR",2023-01-24,"England League 1","Milton Keynes Dons","Shrewsbury",0,1,"A",13,7,1,2,7,13,6,3,1,3,0,0,0,0,0,1,20,3,20,9,4,0
"20230124PORDER",2023-01-24,"England League 1","Port Vale","Derby",1,2,"A",15,16,7,8,7,11,7,9,1,1,0,0,0,0,0,3,31,15,18,16,2,0
"20230124WYCOXF",2023-01-24,"England League 1","Wycombe","Oxford",2,0,"H",11,19,5,2,15,9,2,11,2,1,0,0,0,0,0,2,30,7,24,13,3,0
"20230128CHABOL",2023-01-28,"England League 1","Charlton","Bolton",1,2,"A",12,24,5,8,11,13,6,3,1,3,0,0,0,0,0,3,36,13,24,9,4,0
"20230128BUROXF",2023-01-28,"England League 1","Burton","Oxford",2,0,"H",14,13,5,3,9,13,5,8,0,1,0,0,0,0,0,2,27,8,22,13,1,0
"20230128CHEPOR",2023-01-28,"England League 1","Cheltenham","Port Vale",0,0,"D",12,14,3,4,9,9,4,6,0,0,0,0,0,0,0,0,26,7,18,10,0,0
"20230128LINCAM",2023-01-28,"England League 1","Lincoln","Cambridge",0,0,"D",11,12,2,3,9,10,4,3,3,3,0,0,0,0,0,0,23,5,19,7,6,0
"20230128MILEXE",2023-01-28,"England League 1","Milton Keynes Dons","Exeter",0,2,"A",15,4,2,2,7,16,5,2,4,1,0,0,1,0,1,2,19,4,23,7,5,0
"20230128MORBRI",2023-01-28,"England League 1","Morecambe","Bristol Rvs",5,1,"H",14,18,5,7,9,9,3,8,2,2,0,0,0,0,0,6,32,12,18,11,4,0
"20230128PETPOR",2023-01-28,"England League 1","Peterboro","Portsmouth",2,1,"H",14,8,5,1,14,13,8,2,2,2,0,0,0,0,0,3,22,6,27,10,4,0
"20230128SHRFOR",2023-01-28,"England League 1","Shrewsbury","Forest Green",2,1,"H",11,13,5,2,6,11,7,5,2,2,0,0,0,0,0,3,24,7,17,12,4,0
"20230201OXFBAR",2023-02-01,"England League 1","Oxford","Barnsley",1,2,"A",16,9,2,5,12,11,10,5,0,4,0,0,0,0,0,3,25,7,23,15,4,0
"20230204ACCLIN",2023-02-04,"England League 1","Accrington","Lincoln",0,3,"A",6,21,2,11,12,16,1,0,2,2,1,0,0,0,0,3,27,13,28,1,4,1
"20230204BOLCHE",2023-02-04,"England League 1","Bolton","Cheltenham",1,0,"H",14,10,2,3,7,12,7,6,1,3,0,0,0,0,0,1,24,5,19,13,4,0
"20230204BRIMIL",2023-02-04,"England League 1","Bristol Rvs","Milton Keynes Dons",0,2,"A",6,11,1,4,11,17,3,5,2,5,0,0,0,0,0,2,17,5,28,8,7,0
"20230204CAMIPS",2023-02-04,"England League 1","Cambridge","Ipswich",1,1,"D",6,14,2,4,6,11,4,8,2,2,0,0,0,0,0,2,20,6,17,12,4,0
"20230204DERMOR",2023-02-04,"England League 1","Derby","Morecambe",5,0,"H",26,4,12,0,6,17,8,3,0,4,0,0,0,0,0,5,30,12,23,11,4,0
"20230204EXECHA",2023-02-04,"England League 1","Exeter","Charlton",1,2,"A",13,9,5,4,8,15,14,3,2,2,0,0,0,0,0,3,22,9,23,17,4,0
"20230204FLEBUR",2023-02-04,"England League 1","Fleetwood Town","Burton",2,3,"A",16,16,3,6,9,8,5,3,0,1,0,0,0,0,0,5,32,9,17,8,1,0
"20230204FORPET",2023-02-04,"England League 1","Forest Green","Peterboro",0,2,"A",6,11,2,4,18,13,6,3,4,2,0,0,0,0,0,2,17,6,31,9,6,0
"20230204OXFSHR",2023-02-04,"England League 1","Oxford","Shrewsbury",0,1,"A",16,7,6,4,13,17,8,1,2,3,0,0,0,0,0,1,23,10,30,9,5,0
"20230204PORWYC",2023-02-04,"England League 1","Port Vale","Wycombe",0,3,"A",12,13,0,4,13,13,5,7,1,3,0,0,0,0,0,3,25,4,26,12,4,0
"20230204PORBAR",2023-02-04,"England League 1","Portsmouth","Barnsley",1,1,"D",14,12,3,2,16,16,8,5,0,1,0,0,0,0,0,2,26,5,32,13,1,0
"20230204SHEPLY",2023-02-04,"England League 1","Sheffield Weds","Plymouth",1,0,"H",11,9,4,1,18,9,5,3,3,1,0,0,0,0,0,1,20,5,27,8,4,0
"20230207PORACC",2023-02-07,"England League 1","Port Vale","Accrington",1,1,"D",15,5,6,2,21,7,4,3,4,2,0,1,0,0,0,2,20,8,28,7,6,1
"20230211BARCAM",2023-02-11,"England League 1","Barnsley","Cambridge",2,0,"H",7,9,4,3,16,11,3,5,1,4,1,0,0,0,0,2,16,7,27,8,5,1
"20230211BUREXE",2023-02-11,"England League 1","Burton","Exeter",1,0,"H",9,16,2,3,8,12,3,10,1,1,0,0,0,0,0,1,25,5,20,13,2,0
"20230211CHAFLE",2023-02-11,"England League 1","Charlton","Fleetwood Town",1,2,"A",12,12,3,6,10,15,2,3,2,5,1,0,0,0,0,3,24,9,25,5,7,1
"20230211CHEACC",2023-02-11,"England League 1","Cheltenham","Accrington",0,0,"D",14,9,5,2,15,14,5,2,3,3,0,0,0,0,0,0,23,7,29,7,6,0
"20230211IPSSHE",2023-02-11,"England League 1","Ipswich","Sheffield Weds",2,2,"D",12,8,6,3,12,14,6,2,0,2,0,0,0,0,0,4,20,9,26,8,2,0
"20230211LINBRI",2023-02-11,"England League 1","Lincoln","Bristol Rvs",1,0,"H",20,11,9,4,12,13,5,4,0,3,0,1,0,0,0,1,31,13,25,9,3,1
"20230211MILOXF",2023-02-11,"England League 1","Milton Keynes Dons","Oxford",1,1,"D",9,15,3,5,6,10,1,6,1,2,0,0,0,0,0,2,24,8,16,7,3,0
"20230211MORFOR",2023-02-11,"England League 1","Morecambe","Forest Green",1,1,"D",6,9,4,4,10,12,4,7,0,2,0,0,0,0,0,2,15,8,22,11,2,0
"20230211PETBOL",2023-02-11,"England League 1","Peterboro","Bolton",0,5,"A",16,14,6,7,13,16,8,3,3,3,0,0,0,0,0,5,30,13,29,11,6,0
"20230211PLYPOR",2023-02-11,"England League 1","Plymouth","Portsmouth",3,1,"H",20,23,9,4,15,9,4,7,2,2,0,0,0,0,0,4,43,13,24,11,4,0
"20230211SHRPOR",2023-02-11,"England League 1","Shrewsbury","Port Vale",3,2,"H",10,17,6,6,12,16,7,2,3,4,0,0,0,0,0,5,27,12,28,9,7,0
"20230211WYCDER",2023-02-11,"England League 1","Wycombe","Derby",3,2,"H",14,13,7,6,12,11,5,6,3,2,0,0,0,0,0,5,27,13,23,11,5,0
"20230214ACCWYC",2023-02-14,"England League 1","Accrington","Wycombe",0,2,"A",22,14,5,5,6,13,7,5,2,1,0,0,0,0,0,2,36,10,19,12,3,0
"20230214BOLMIL",2023-02-14,"England League 1","Bolton","Milton Keynes Dons",5,0,"H",18,10,11,2,10,7,5,4,0,0,0,0,0,0,0,5,28,13,17,9,0,0
"20230214BRIIPS",2023-02-14,"England League 1","Bristol Rvs","Ipswich",0,0,"D",9,21,4,7,6,11,6,10,0,1,0,0,0,0,0,0,30,11,17,16,1,0
"20230214CAMCHE",2023-02-14,"England League 1","Cambridge","Cheltenham",1,2,"A",10,12,4,3,8,14,4,2,1,3,0,0,1,0,1,3,22,7,22,6,4,0
"20230214DERLIN",2023-02-14,"England League 1","Derby","Lincoln",1,1,"D",21,9,7,5,8,7,5,2,1,1,0,1,0,0,0,2,30,12,15,7,2,1
"20230214EXESHR",2023-02-14,"England League 1","Exeter","Shrewsbury",0,0,"D",9,10,3,1,7,8,5,3,0,1,0,0,0,0,0,0,19,4,15,8,1,0
"20230214FLEPET",2023-02-14,"England League 1","Fleetwood Town","Peterboro",1,0,"H",5,14,1,3,17,9,1,7,2,2,0,0,0,0,0,1,19,4,26,8,4,0
"20230214FORCHA",2023-02-14,"England League 1","Forest Green","Charlton",0,1,"A",13,7,1,3,10,8,9,3,0,1,0,0,0,0,0,1,20,4,18,12,1,0
"20230214OXFPLY",2023-02-14,"England League 1","Oxford","Plymouth",1,3,"A",9,14,4,6,17,14,6,8,3,5,0,0,1,0,1,4,23,10,31,14,8,0
"20230214PORBAR",2023-02-14,"England League 1","Port Vale","Barnsley",1,3,"A",15,7,2,4,9,9,10,3,0,2,0,0,0,0,0,4,22,6,18,13,2,0
"20230214PORBUR",2023-02-14,"England League 1","Portsmouth","Burton",1,0,"H",16,4,7,2,5,22,4,3,0,4,0,0,1,1,0,1,20,9,27,7,4,0
"20230214SHEMOR",2023-02-14,"England League 1","Sheffield Weds","Morecambe",3,0,"H",17,6,5,2,7,7,3,1,1,2,0,0,0,0,0,3,23,7,14,4,3,0
"20230218ACCSHR",2023-02-18,"England League 1","Accrington","Shrewsbury",1,0,"H",6,12,1,2,11,13,1,7,3,3,0,0,0,0,0,1,18,3,24,8,6,0
"20230218BRIBUR",2023-02-18,"England League 1","Bristol Rvs","Burton",1,2,"A",10,18,2,10,11,16,8,5,0,3,0,0,0,0,0,3,28,12,27,13,3,0
"20230218CAMOXF",2023-02-18,"England League 1","Cambridge","Oxford",1,0,"H",7,10,3,3,14,12,6,8,3,1,0,0,0,0,0,1,17,6,26,14,4,0
"20230218CHEBAR",2023-02-18,"England League 1","Cheltenham","Barnsley",0,4,"A",8,9,1,5,8,11,5,5,0,0,0,0,0,0,0,4,17,6,19,10,0,0
"20230218DERCHA",2023-02-18,"England League 1","Derby","Charlton",2,0,"H",20,8,8,2,11,13,9,2,1,3,0,0,0,0,0,2,28,10,24,11,4,0
"20230218IPSFOR",2023-02-18,"England League 1","Ipswich","Forest Green",4,0,"H",25,4,12,0,11,5,10,3,0,2,0,0,0,0,0,4,29,12,16,13,2,0
"20230218LINPOR",2023-02-18,"England League 1","Lincoln","Portsmouth",0,0,"D",15,14,2,5,13,8,9,4,2,4,0,0,0,0,0,0,29,7,21,13,6,0
"20230218MORPET",2023-02-18,"England League 1","Morecambe","Peterboro",0,3,"A",12,12,1,6,10,13,8,6,1,1,0,0,0,0,0,3,24,7,23,14,2,0
"20230218PLYFLE",2023-02-18,"England League 1","Plymouth","Fleetwood Town",0,0,"D",17,7,2,0,3,16,5,4,1,6,0,0,0,0,0,0,24,2,19,9,7,0
"20230218POREXE",2023-02-18,"England League 1","Port Vale","Exeter",1,0,"H",13,6,5,0,11,8,5,3,3,1,0,1,0,0,0,1,19,5,19,8,4,1
"20230218SHEMIL",2023-02-18,"England League 1","Sheffield Weds","Milton Keynes Dons",5,2,"H",22,6,8,2,8,6,10,2,0,1,0,0,0,0,0,7,28,10,14,12,1,0
"20230218WYCBOL",2023-02-18,"England League 1","Wycombe","Bolton",1,0,"H",19,16,6,3,9,9,7,7,2,2,0,0,0,0,0,1,35,9,18,14,4,0
"20230221FLECAM",2023-02-21,"England League 1","Fleetwood Town","Cambridge",1,0,"H",9,10,1,3,13,6,5,4,3,1,0,0,0,0,0,1,19,4,19,9,4,0
"20230221MORPOR",2023-02-21,"England League 1","Morecambe","Port Vale",1,0,"H",9,13,2,3,13,10,2,3,1,1,0,0,0,0,0,1,22,5,23,5,2,0
"20230225OXFBRI",2023-02-25,"England League 1","Oxford","Bristol Rvs",0,3,"A",14,5,2,4,16,11,6,5,2,2,0,0,0,0,0,3,19,6,27,11,4,0
"20230225BARDER",2023-02-25,"England League 1","Barnsley","Derby",4,1,"H",10,10,5,5,13,7,6,4,3,0,0,0,0,0,0,5,20,10,20,10,3,0
"20230225BOLPOR",2023-02-25,"England League 1","Bolton","Port Vale",2,1,"H",5,12,2,5,13,8,4,10,0,0,0,0,0,0,0,3,17,7,21,14,0,0
"20230225BURACC",2023-02-25,"England League 1","Burton","Accrington",0,0,"D",11,7,2,1,8,7,6,5,1,2,0,0,0,0,0,0,18,3,15,11,3,0
"20230225CHASHE",2023-02-25,"England League 1","Charlton","Sheffield Weds",0,1,"A",7,17,3,4,12,14,1,8,1,3,0,0,0,0,0,1,24,7,26,9,4,0
"20230225EXECAM",2023-02-25,"England League 1","Exeter","Cambridge",2,0,"H",16,5,6,1,13,5,9,1,0,0,0,0,0,0,0,2,21,7,18,10,0,0
"20230225FLEMOR",2023-02-25,"England League 1","Fleetwood Town","Morecambe",1,0,"H",8,8,3,1,9,6,5,7,2,3,0,0,0,0,0,1,16,4,15,12,5,0
"20230225FORLIN",2023-02-25,"England League 1","Forest Green","Lincoln",1,1,"D",9,13,5,3,15,11,2,9,3,2,0,0,0,0,0,2,22,8,26,11,5,0
"20230225MILIPS",2023-02-25,"England League 1","Milton Keynes Dons","Ipswich",0,1,"A",9,21,3,8,7,14,4,7,2,2,0,0,0,0,0,1,30,11,21,11,4,0
"20230225PETPLY",2023-02-25,"England League 1","Peterboro","Plymouth",5,2,"H",19,13,12,7,11,11,4,8,1,2,0,0,0,0,0,7,32,19,22,12,3,0
"20230225PORCHE",2023-02-25,"England League 1","Portsmouth","Cheltenham",4,0,"H",13,9,6,1,13,16,3,3,1,5,0,0,0,0,0,4,22,7,29,6,6,0
"20230225SHRWYC",2023-02-25,"England League 1","Shrewsbury","Wycombe",2,0,"H",8,15,2,4,14,8,7,5,4,0,0,0,0,0,0,2,23,6,22,12,4,0
"20230228DERCHE",2023-02-28,"England League 1","Derby","Cheltenham",2,0,"H",12,5,3,0,12,9,3,2,2,3,0,0,0,0,0,2,17,3,21,5,5,0
"20230228LINMIL",2023-02-28,"England League 1","Lincoln","Milton Keynes Dons",1,1,"D",9,6,2,4,13,7,5,3,1,2,0,0,0,0,0,2,15,6,20,8,3,0
"20230228PETCHA",2023-02-28,"England League 1","Peterboro","Charlton",0,0,"D",7,15,2,2,8,10,5,8,1,2,1,0,0,0,0,0,22,4,18,13,3,1
"20230228PORBOL",2023-02-28,"England League 1","Portsmouth","Bolton",3,1,"H",17,10,5,2,16,19,6,2,2,4,0,0,0,0,0,4,27,7,35,8,6,0
"20230304MORBOL",2023-03-04,"England League 1","Morecambe","Bolton",0,0,"D",11,13,2,4,12,7,2,11,1,0,0,0,0,0,0,0,24,6,19,13,1,0
"20230304ACCFOR",2023-03-04,"England League 1","Accrington","Forest Green",2,1,"H",17,6,4,3,9,16,3,3,1,3,0,1,0,0,0,3,23,7,25,6,4,1
"20230304BRIBAR",2023-03-04,"England League 1","Bristol Rvs","Barnsley",0,0,"D",7,10,2,3,8,14,3,7,3,2,0,0,0,0,0,0,17,5,22,10,5,0
"20230304CAMPOR",2023-03-04,"England League 1","Cambridge","Portsmouth",0,1,"A",17,5,4,3,10,9,7,3,1,1,0,0,0,0,0,1,22,7,19,10,2,0
"20230304CHEFLE",2023-03-04,"England League 1","Cheltenham","Fleetwood Town",1,0,"H",18,10,4,0,4,10,5,5,1,3,0,0,0,0,0,1,28,4,14,10,4,0
"20230304DERSHR",2023-03-04,"England League 1","Derby","Shrewsbury",2,2,"D",18,6,4,5,11,5,3,3,3,2,0,0,0,0,0,4,24,9,16,6,5,0
"20230304IPSBUR",2023-03-04,"England League 1","Ipswich","Burton",4,0,"H",17,14,7,2,5,13,3,8,1,4,0,0,0,0,0,4,31,9,18,11,5,0
"20230304LINOXF",2023-03-04,"England League 1","Lincoln","Oxford",1,0,"H",8,16,4,5,8,11,1,15,0,2,0,0,0,0,0,1,24,9,19,16,2,0
"20230304PLYCHA",2023-03-04,"England League 1","Plymouth","Charlton",2,0,"H",19,8,6,0,11,17,14,3,0,0,0,0,0,0,0,2,27,6,28,17,0,0
"20230304PORMIL",2023-03-04,"England League 1","Port Vale","Milton Keynes Dons",1,0,"H",13,9,2,1,13,14,5,4,3,3,0,0,0,0,0,1,22,3,27,9,6,0
"20230304SHEPET",2023-03-04,"England League 1","Sheffield Weds","Peterboro",1,0,"H",12,3,3,0,18,9,7,0,3,1,0,0,0,0,0,1,15,3,27,7,4,0
"20230304WYCEXE",2023-03-04,"England League 1","Wycombe","Exeter",1,1,"D",9,16,1,4,8,12,2,3,0,3,0,0,0,0,0,2,25,5,20,5,3,0
"20230307BARPOR",2023-03-07,"England League 1","Barnsley","Portsmouth",3,1,"H",18,6,7,3,11,6,4,2,1,0,0,0,0,0,0,4,24,10,17,6,1,0
"20230307CAMMOR",2023-03-07,"England League 1","Cambridge","Morecambe",1,1,"D",24,10,8,4,6,9,9,1,2,0,0,0,0,0,0,2,34,12,15,10,2,0
"20230307CHELIN",2023-03-07,"England League 1","Cheltenham","Lincoln",0,0,"D",5,11,1,0,10,5,6,4,2,1,0,0,0,0,0,0,16,1,15,10,3,0
"20230307IPSACC",2023-03-07,"England League 1","Ipswich","Accrington",3,0,"H",18,5,8,3,9,7,6,3,1,1,0,1,0,0,0,3,23,11,16,9,2,1
"20230307PETSHR",2023-03-07,"England League 1","Peterboro","Shrewsbury",2,1,"H",11,8,4,2,5,14,5,7,3,3,0,0,0,0,0,3,19,6,19,12,6,0
"20230307WYCFLE",2023-03-07,"England League 1","Wycombe","Fleetwood Town",2,0,"H",22,11,5,4,9,12,7,4,0,1,0,0,0,0,0,2,33,9,21,11,1,0
"20230307PLYDER",2023-03-07,"England League 1","Plymouth","Derby",2,1,"H",10,10,5,4,7,15,4,4,2,1,0,0,0,0,0,3,20,9,22,8,3,0
"20230311BARPLY",2023-03-11,"England League 1","Barnsley","Plymouth",3,0,"H",12,8,5,3,6,10,3,2,1,2,0,0,0,0,0,3,20,8,16,5,3,0
"20230311BOLIPS",2023-03-11,"England League 1","Bolton","Ipswich",0,2,"A",6,18,3,6,9,9,6,8,2,5,0,0,0,0,0,2,24,9,18,14,7,0
"20230311BURWYC",2023-03-11,"England League 1","Burton","Wycombe",2,1,"H",10,21,4,4,12,13,4,5,1,2,1,0,0,0,0,3,31,8,25,9,3,1
"20230311CHAACC",2023-03-11,"England League 1","Charlton","Accrington",1,1,"D",10,16,3,8,10,11,3,7,2,3,0,0,0,0,0,2,26,11,21,10,5,0
"20230311EXELIN",2023-03-11,"England League 1","Exeter","Lincoln",2,1,"H",8,7,2,3,14,7,4,7,3,2,1,0,0,0,0,3,15,5,21,11,5,1
"20230311FLEPOR",2023-03-11,"England League 1","Fleetwood Town","Port Vale",1,1,"D",12,17,5,3,9,14,2,8,1,3,0,0,0,0,0,2,29,8,23,10,4,0
"20230311FORBRI",2023-03-11,"England League 1","Forest Green","Bristol Rvs",1,3,"A",4,13,2,6,6,9,7,7,1,3,0,0,0,0,0,4,17,8,15,14,4,0
"20230311MILCAM",2023-03-11,"England League 1","Milton Keynes Dons","Cambridge",1,0,"H",12,6,2,3,9,14,6,3,0,4,0,0,0,0,0,1,18,5,23,9,4,0
"20230311OXFDER",2023-03-11,"England League 1","Oxford","Derby",2,3,"A",13,8,8,4,11,11,11,2,1,1,0,0,0,0,0,5,21,12,22,13,2,0
"20230311PETCHE",2023-03-11,"England League 1","Peterboro","Cheltenham",0,3,"A",14,10,1,6,8,9,3,3,3,2,0,0,0,0,0,3,24,7,17,6,5,0
"20230311PORSHE",2023-03-11,"England League 1","Portsmouth","Sheffield Weds",0,1,"A",12,6,2,2,6,20,9,5,2,2,0,1,0,0,0,1,18,4,26,14,4,1
"20230311SHRMOR",2023-03-11,"England League 1","Shrewsbury","Morecambe",3,1,"H",21,10,8,2,8,12,8,3,3,0,0,0,0,0,0,4,31,10,20,11,3,0
"20230314ACCPOR",2023-03-14,"England League 1","Accrington","Portsmouth",1,3,"A",20,10,4,7,12,18,7,4,3,2,1,1,0,0,0,4,30,11,30,11,5,2
"20230314BRIWYC",2023-03-14,"England League 1","Bristol Rvs","Wycombe",0,2,"A",21,15,6,8,18,8,6,3,1,2,0,0,0,0,0,2,36,14,26,9,3,0
"20230314BURPET",2023-03-14,"England League 1","Burton","Peterboro",2,5,"A",17,13,11,8,7,11,4,4,1,0,0,0,0,0,0,7,30,19,18,8,1,0
"20230314MORCHA",2023-03-14,"England League 1","Morecambe","Charlton",1,4,"A",11,20,2,10,9,12,5,4,1,2,0,0,0,0,0,5,31,12,21,9,3,0
"20230317SHEBOL",2023-03-17,"England League 1","Sheffield Weds","Bolton",1,1,"D",13,4,7,1,12,10,4,5,1,1,0,0,0,0,0,2,17,8,22,9,2,0
"20230318LINPET",2023-03-18,"England League 1","Lincoln","Peterboro",0,3,"A",9,8,1,4,13,12,2,1,2,2,0,0,0,0,0,3,17,5,25,3,4,0
"20230318ACCMIL",2023-03-18,"England League 1","Accrington","Milton Keynes Dons",0,1,"A",10,11,2,4,15,12,9,6,3,2,0,0,1,1,0,1,21,6,27,15,5,0
"20230318BRIPOR",2023-03-18,"England League 1","Bristol Rvs","Portsmouth",0,2,"A",17,7,7,3,10,13,4,3,2,2,1,0,0,0,0,2,24,10,23,7,4,1
"20230318CAMCHA",2023-03-18,"England League 1","Cambridge","Charlton",1,2,"A",10,9,4,4,8,7,8,4,2,0,0,0,0,0,0,3,19,8,15,12,2,0
"20230318CHEEXE",2023-03-18,"England League 1","Cheltenham","Exeter",3,1,"H",10,12,6,5,12,8,1,6,5,2,0,0,0,0,0,4,22,11,20,7,7,0
"20230318DERFLE",2023-03-18,"England League 1","Derby","Fleetwood Town",0,2,"A",15,8,2,3,13,11,3,8,2,3,0,0,0,0,0,2,23,5,24,11,5,0
"20230318IPSSHR",2023-03-18,"England League 1","Ipswich","Shrewsbury",2,0,"H",22,6,4,3,11,12,5,4,1,5,0,0,0,0,0,2,28,7,23,9,6,0
"20230318MOROXF",2023-03-18,"England League 1","Morecambe","Oxford",1,1,"D",5,9,2,4,13,14,1,1,3,1,0,0,0,0,0,2,14,6,27,2,4,0
"20230318PLYFOR",2023-03-18,"England League 1","Plymouth","Forest Green",2,0,"H",8,5,2,1,8,3,6,2,0,1,0,0,0,0,0,2,13,3,11,8,1,0
"20230318PORBUR",2023-03-18,"England League 1","Port Vale","Burton",2,3,"A",10,14,5,4,9,12,3,3,2,3,0,0,1,0,1,5,24,9,21,6,5,0
"20230318WYCBAR",2023-03-18,"England League 1","Wycombe","Barnsley",0,1,"A",10,7,1,2,11,15,12,1,1,4,0,0,1,1,0,1,17,3,26,13,5,0
"20230321ACCPLY",2023-03-21,"England League 1","Accrington","Plymouth",0,2,"A",10,12,3,6,18,13,5,4,3,0,1,0,0,0,0,2,22,9,31,9,3,1
"20230321BARSHE",2023-03-21,"England League 1","Barnsley","Sheffield Weds",4,2,"H",12,18,6,6,11,14,1,6,5,3,0,0,0,0,0,6,30,12,25,7,8,0
"20230325CHAWYC",2023-03-25,"England League 1","Charlton","Wycombe",1,1,"D",10,13,5,4,12,11,7,6,5,3,0,0,0,0,0,2,23,9,23,13,8,0
"20230325EXEACC",2023-03-25,"England League 1","Exeter","Accrington",5,0,"H",18,4,11,0,11,10,4,0,1,1,0,0,0,0,0,5,22,11,21,4,2,0
"20230325FLELIN",2023-03-25,"England League 1","Fleetwood Town","Lincoln",2,1,"H",13,16,7,6,14,8,8,4,2,0,0,0,0,0,0,3,29,13,22,12,2,0
"20230325MILMOR",2023-03-25,"England League 1","Milton Keynes Dons","Morecambe",1,0,"H",15,10,6,1,7,15,3,7,1,3,0,0,0,0,0,1,25,7,22,10,4,0
"20230325PETDER",2023-03-25,"England League 1","Peterboro","Derby",2,0,"H",9,13,6,5,9,13,3,8,3,1,0,0,0,0,0,2,22,11,22,11,4,0
"20230325PORPOR",2023-03-25,"England League 1","Portsmouth","Port Vale",2,2,"D",8,5,4,3,11,20,11,5,0,5,0,0,0,0,0,4,13,7,31,16,5,0
"20230326FORSHE",2023-03-26,"England League 1","Forest Green","Sheffield Weds",1,0,"H",6,7,2,3,5,12,2,6,1,1,0,0,0,0,0,1,13,5,17,8,2,0
"20230328EXEBAR",2023-03-28,"England League 1","Exeter","Barnsley",3,1,"H",9,16,6,4,11,9,4,4,3,2,0,0,0,0,0,4,25,10,20,8,5,0
"20230329CHESHE",2023-03-29,"England League 1","Cheltenham","Sheffield Weds",2,2,"D",15,21,8,5,6,12,2,11,2,1,0,0,0,0,0,4,36,13,18,13,3,0
"20230401BARMOR",2023-04-01,"England League 1","Barnsley","Morecambe",5,0,"H",17,9,10,2,12,11,5,6,1,0,0,0,0,0,0,5,26,12,23,11,1,0
"20230401CHASHR",2023-04-01,"England League 1","Charlton","Shrewsbury",6,0,"H",17,11,11,1,10,13,5,5,2,3,0,1,0,0,0,6,28,12,23,10,5,1
"20230401CHEBUR",2023-04-01,"England League 1","Cheltenham","Burton",0,0,"D",20,6,4,3,8,7,7,3,3,0,0,0,0,0,0,0,26,7,15,10,3,0
"20230401DERIPS",2023-04-01,"England League 1","Derby","Ipswich",0,2,"A",6,13,2,6,8,8,4,4,4,3,0,0,0,0,0,2,19,8,16,8,7,0
"20230401FLEEXE",2023-04-01,"England League 1","Fleetwood Town","Exeter",2,2,"D",14,11,3,4,12,7,5,5,1,0,0,0,0,0,0,4,25,7,19,10,1,0
"20230401PETOXF",2023-04-01,"England League 1","Peterboro","Oxford",0,0,"D",10,3,3,1,11,11,7,1,0,1,0,0,0,0,0,0,13,4,22,8,1,0
"20230401PORCAM",2023-04-01,"England League 1","Port Vale","Cambridge",0,2,"A",11,16,4,6,12,11,2,0,3,0,0,0,0,0,0,2,27,10,23,2,3,0
"20230401PORFOR",2023-04-01,"England League 1","Portsmouth","Forest Green",1,0,"H",11,5,3,2,9,11,5,0,3,2,0,0,0,0,0,1,16,5,20,5,5,0
"20230401SHELIN",2023-04-01,"England League 1","Sheffield Weds","Lincoln",1,1,"D",21,5,5,3,12,13,6,4,0,0,0,0,0,0,0,2,26,8,25,10,0,0
"20230401WYCMIL",2023-04-01,"England League 1","Wycombe","Milton Keynes Dons",2,2,"D",11,10,2,4,12,16,6,5,0,3,0,0,0,0,0,4,21,6,28,11,3,0
"20230407ACCPOR",2023-04-07,"England League 1","Accrington","Port Vale",3,0,"H",17,9,3,2,13,13,5,7,1,1,0,1,0,0,0,3,26,5,26,12,2,1
"20230407BRICHA",2023-04-07,"England League 1","Bristol Rvs","Charlton",1,0,"H",10,6,3,1,5,10,5,8,0,0,0,0,0,0,0,1,16,4,15,13,0,0
"20230407BURBAR",2023-04-07,"England League 1","Burton","Barnsley",2,1,"H",7,20,2,9,9,18,2,12,6,2,0,0,0,0,0,3,27,11,27,14,8,0
"20230407CAMFLE",2023-04-07,"England League 1","Cambridge","Fleetwood Town",2,1,"H",13,10,7,7,9,17,2,3,4,4,0,0,1,0,1,3,23,14,26,5,8,0
"20230407EXEBOL",2023-04-07,"England League 1","Exeter","Bolton",0,1,"A",11,6,3,2,9,18,8,3,0,3,0,0,0,0,0,1,17,5,27,11,3,0
"20230407FORDER",2023-04-07,"England League 1","Forest Green","Derby",0,2,"A",3,14,1,7,8,14,1,6,1,1,0,0,0,0,0,2,17,8,22,7,2,0
"20230407IPSWYC",2023-04-07,"England League 1","Ipswich","Wycombe",4,0,"H",14,6,6,0,8,9,7,1,0,2,0,0,0,0,0,4,20,6,17,8,2,0
"20230407LINCHE",2023-04-07,"England League 1","Lincoln","Cheltenham",2,0,"H",14,14,7,3,12,11,3,5,0,1,0,0,0,0,0,2,28,10,23,8,1,0
"20230407MILPOR",2023-04-07,"England League 1","Milton Keynes Dons","Portsmouth",1,1,"D",15,5,3,2,11,17,11,2,0,4,0,1,0,0,0,2,20,5,28,13,4,1
"20230407MORPLY",2023-04-07,"England League 1","Morecambe","Plymouth",1,3,"A",6,11,3,6,16,9,8,9,2,2,0,0,0,0,0,4,17,9,25,17,4,0
"20230407OXFSHE",2023-04-07,"England League 1","Oxford","Sheffield Weds",1,1,"D",14,11,7,8,7,14,5,6,2,2,0,0,0,0,0,2,25,15,21,11,4,0
"20230407SHRPET",2023-04-07,"England League 1","Shrewsbury","Peterboro",0,3,"A",4,18,3,7,18,10,2,1,2,1,0,0,0,0,0,3,22,10,28,3,3,0
"20230410BARSHR",2023-04-10,"England League 1","Barnsley","Shrewsbury",2,1,"H",14,6,7,4,8,11,9,3,2,5,0,0,0,0,0,3,20,11,19,12,7,0
"20230410BOLCAM",2023-04-10,"England League 1","Bolton","Cambridge",1,1,"D",8,10,3,2,13,7,2,2,3,1,0,0,0,0,0,2,18,5,20,4,4,0
"20230410CHABUR",2023-04-10,"England League 1","Charlton","Burton",3,2,"H",13,14,7,4,11,5,3,7,1,1,1,0,0,0,0,5,27,11,16,10,2,1
"20230410CHEIPS",2023-04-10,"England League 1","Cheltenham","Ipswich",1,1,"D",7,23,3,9,7,8,5,4,1,1,0,0,0,0,0,2,30,12,15,9,2,0
"20230410DERMIL",2023-04-10,"England League 1","Derby","Milton Keynes Dons",1,1,"D",28,3,7,2,8,8,10,2,2,2,0,0,0,0,0,2,31,9,16,12,4,0
"20230410FLEBRI",2023-04-10,"England League 1","Fleetwood Town","Bristol Rvs",1,2,"A",9,13,1,6,13,11,5,5,3,1,0,0,0,0,0,3,22,7,24,10,4,0
"20230410PETEXE",2023-04-10,"England League 1","Peterboro","Exeter",3,1,"H",15,14,3,1,12,13,9,2,1,2,0,0,2,1,1,4,29,4,25,11,3,0
"20230410PLYLIN",2023-04-10,"England League 1","Plymouth","Lincoln",0,2,"A",14,17,2,5,13,13,8,6,1,3,0,0,0,0,0,2,31,7,26,14,4,0
"20230410POROXF",2023-04-10,"England League 1","Port Vale","Oxford",0,0,"D",11,10,5,4,18,8,13,7,5,2,1,0,0,0,0,0,21,9,26,20,7,1
"20230410PORMOR",2023-04-10,"England League 1","Portsmouth","Morecambe",0,0,"D",15,10,5,3,7,10,4,7,2,2,0,0,0,0,0,0,25,8,17,11,4,0
"20230410SHEACC",2023-04-10,"England League 1","Sheffield Weds","Accrington",3,0,"H",17,11,6,2,11,10,7,2,0,2,0,0,0,0,0,3,28,8,21,9,2,0
"20230410WYCFOR",2023-04-10,"England League 1","Wycombe","Forest Green",2,0,"H",5,3,2,2,12,12,8,3,0,2,0,0,0,0,0,2,8,4,24,11,2,0
"20230415EXEPLY",2023-04-15,"England League 1","Exeter","Plymouth",0,1,"A",9,9,2,2,15,7,4,7,2,3,0,0,0,0,0,1,18,4,22,11,5,0
"20230415CAMPET",2023-04-15,"England League 1","Cambridge","Peterboro",2,0,"H",12,9,4,2,9,15,5,3,1,2,0,0,1,1,0,2,21,6,24,8,3,0
"20230415ACCFLE",2023-04-15,"England League 1","Accrington","Fleetwood Town",2,5,"A",15,2,3,6,14,15,5,6,2,4,1,0,0,0,0,7,17,9,29,11,6,1
"20230415BRIDER",2023-04-15,"England League 1","Bristol Rvs","Derby",1,1,"D",15,10,2,5,7,15,7,5,0,6,0,0,0,0,0,2,25,7,22,12,6,0
"20230415BURSHE",2023-04-15,"England League 1","Burton","Sheffield Weds",3,2,"H",7,16,3,3,10,9,2,7,1,1,0,0,0,0,0,5,23,6,19,9,2,0
"20230415FORBAR",2023-04-15,"England League 1","Forest Green","Barnsley",1,5,"A",9,14,2,8,8,9,5,5,0,1,0,0,0,0,0,6,23,10,17,10,1,0
"20230415IPSCHA",2023-04-15,"England League 1","Ipswich","Charlton",6,0,"H",26,5,7,2,9,10,6,0,1,2,0,1,0,0,0,6,31,9,19,6,3,1
"20230415LINPOR",2023-04-15,"England League 1","Lincoln","Port Vale",3,2,"H",10,12,4,4,9,13,4,3,5,4,1,2,0,0,0,5,22,8,22,7,9,3
"20230415MILCHE",2023-04-15,"England League 1","Milton Keynes Dons","Cheltenham",2,2,"D",14,13,5,5,8,17,6,4,1,2,0,0,0,0,0,4,27,10,25,10,3,0
"20230415MORWYC",2023-04-15,"England League 1","Morecambe","Wycombe",1,0,"H",10,20,2,4,6,13,4,11,3,2,0,0,0,0,0,1,30,6,19,15,5,0
"20230415OXFBOL",2023-04-15,"England League 1","Oxford","Bolton",0,1,"A",24,4,7,2,13,13,7,0,2,5,0,0,0,0,0,1,28,9,26,7,7,0
"20230415SHRPOR",2023-04-15,"England League 1","Shrewsbury","Portsmouth",1,1,"D",9,13,4,2,13,12,3,6,3,3,1,0,0,0,0,2,22,6,25,9,6,1
"20230418ACCPET",2023-04-18,"England League 1","Accrington","Peterboro",1,2,"A",15,12,7,6,12,12,2,5,1,3,0,0,0,0,0,3,27,13,24,7,4,0
"20230418BRISHE",2023-04-18,"England League 1","Bristol Rvs","Sheffield Weds",1,2,"A",7,9,4,3,7,14,6,4,0,3,0,0,0,0,0,3,16,7,21,10,3,0
"20230418BURBOL",2023-04-18,"England League 1","Burton","Bolton",1,1,"D",14,22,8,7,7,8,3,8,1,1,0,0,0,0,0,2,36,15,15,11,2,0
"20230418CAMWYC",2023-04-18,"England League 1","Cambridge","Wycombe",1,2,"A",14,13,8,7,8,13,6,7,0,1,0,0,0,0,0,3,27,15,21,13,1,0
"20230418EXEDER",2023-04-18,"England League 1","Exeter","Derby",1,2,"A",13,15,4,5,6,8,9,3,0,1,0,0,0,0,0,3,28,9,14,12,1,0
"20230418FORFLE",2023-04-18,"England League 1","Forest Green","Fleetwood Town",0,0,"D",3,15,1,4,12,12,4,3,1,3,0,0,0,0,0,0,18,5,24,7,4,0
"20230418IPSPOR",2023-04-18,"England League 1","Ipswich","Port Vale",2,1,"H",16,6,2,2,5,10,10,3,1,3,0,0,0,0,0,3,22,4,15,13,4,0
"20230418LINBAR",2023-04-18,"England League 1","Lincoln","Barnsley",0,0,"D",9,15,1,1,9,11,4,3,0,3,0,0,0,0,0,0,24,2,20,7,3,0
"20230418MILCHA",2023-04-18,"England League 1","Milton Keynes Dons","Charlton",0,1,"A",11,10,2,3,6,9,12,7,0,3,0,0,0,0,0,1,21,5,15,19,3,0
"20230418OXFPOR",2023-04-18,"England League 1","Oxford","Portsmouth",1,1,"D",21,6,4,4,14,13,10,4,1,6,0,0,0,0,0,2,27,8,27,14,7,0
"20230418SHRPLY",2023-04-18,"England League 1","Shrewsbury","Plymouth",1,2,"A",5,14,3,5,10,7,2,8,1,3,0,0,0,0,0,3,19,8,17,10,4,0
"20230422BAROXF",2023-04-22,"England League 1","Barnsley","Oxford",2,0,"H",12,6,6,3,16,15,3,4,1,4,0,0,0,0,0,2,18,9,31,7,5,0
"20230422BOLSHR",2023-04-22,"England League 1","Bolton","Shrewsbury",1,0,"H",14,6,6,0,7,5,9,2,1,2,0,0,0,0,0,1,20,6,12,11,3,0
"20230422CHAMOR",2023-04-22,"England League 1","Charlton","Morecambe",2,3,"A",19,12,6,4,9,8,8,1,1,0,0,0,0,0,0,5,31,10,17,9,1,0
"20230422CHEFOR",2023-04-22,"England League 1","Cheltenham","Forest Green",3,1,"H",13,6,7,3,13,11,4,1,4,2,0,0,0,0,0,4,19,10,24,5,6,0
"20230422DERBUR",2023-04-22,"England League 1","Derby","Burton",1,0,"H",23,6,10,2,11,9,8,5,1,1,0,0,0,0,0,1,29,12,20,13,2,0
"20230422FLEMIL",2023-04-22,"England League 1","Fleetwood Town","Milton Keynes Dons",1,0,"H",19,17,5,3,12,11,6,6,2,4,0,0,0,0,0,1,36,8,23,12,6,0
"20230422PETIPS",2023-04-22,"England League 1","Peterboro","Ipswich",0,3,"A",11,15,4,7,8,11,3,6,1,3,0,0,0,0,0,3,26,11,19,9,4,0
"20230422PLYCAM",2023-04-22,"England League 1","Plymouth","Cambridge",3,1,"H",13,8,4,4,8,8,5,4,1,3,0,0,0,0,0,4,21,8,16,9,4,0
"20230422PORBRI",2023-04-22,"England League 1","Port Vale","Bristol Rvs",2,0,"H",11,9,5,0,17,9,5,6,2,2,0,0,0,0,0,2,20,5,26,11,4,0
"20230422PORACC",2023-04-22,"England League 1","Portsmouth","Accrington",1,0,"H",12,18,2,6,6,15,5,7,0,2,0,0,0,0,0,1,30,8,21,12,2,0
"20230422SHEEXE",2023-04-22,"England League 1","Sheffield Weds","Exeter",2,1,"H",17,7,4,3,8,13,4,1,3,1,0,0,0,0,0,3,24,7,21,5,4,0
"20230422WYCLIN",2023-04-22,"England League 1","Wycombe","Lincoln",0,2,"A",15,14,6,4,9,13,7,3,0,3,0,0,0,0,0,2,29,10,22,10,3,0
"20230425BARIPS",2023-04-25,"England League 1","Barnsley","Ipswich",0,3,"A",10,10,3,5,18,17,2,3,3,3,0,0,1,0,1,3,20,8,35,5,6,0
"20230425BOLACC",2023-04-25,"England League 1","Bolton","Accrington",0,1,"A",11,12,6,2,10,14,10,4,0,0,0,0,0,0,0,1,23,8,24,14,0,0
"20230425LINBUR",2023-04-25,"England League 1","Lincoln","Burton",0,1,"A",13,10,1,3,4,11,3,4,0,0,0,0,0,0,0,1,23,4,15,7,0,0
"20230425OXFCHE",2023-04-25,"England League 1","Oxford","Cheltenham",4,0,"H",13,10,7,4,12,12,4,2,0,3,0,0,0,0,0,4,23,11,24,6,3,0
"20230425PLYBRI",2023-04-25,"England League 1","Plymouth","Bristol Rvs",2,0,"H",25,3,7,1,10,17,10,2,1,1,0,1,0,0,0,2,28,8,27,12,2,1
"20230429ACCCAM",2023-04-29,"England League 1","Accrington","Cambridge",1,2,"A",15,15,6,6,18,11,6,4,2,2,0,0,0,0,0,3,30,12,29,10,4,0
"20230429BOLFLE",2023-04-29,"England League 1","Bolton","Fleetwood Town",2,0,"H",11,14,3,5,13,12,8,4,2,3,0,1,0,0,0,2,25,8,25,12,5,1
"20230429CHAPOR",2023-04-29,"England League 1","Charlton","Port Vale",3,2,"H",10,12,4,4,15,11,4,8,4,1,0,0,0,0,0,5,22,8,26,12,5,0
"20230429DERPOR",2023-04-29,"England League 1","Derby","Portsmouth",1,1,"D",15,8,5,6,12,15,10,3,0,2,0,0,0,0,0,2,23,11,27,13,2,0
"20230429FOROXF",2023-04-29,"England League 1","Forest Green","Oxford",0,3,"A",2,15,1,6,5,8,1,5,0,0,0,0,0,0,0,3,17,7,13,6,0,0
"20230429IPSEXE",2023-04-29,"England League 1","Ipswich","Exeter",6,0,"H",14,5,6,1,10,9,4,2,2,1,0,0,0,0,0,6,19,7,19,6,3,0
"20230429MILBAR",2023-04-29,"England League 1","Milton Keynes Dons","Barnsley",4,4,"D",17,17,8,9,9,7,7,3,2,2,0,0,0,0,0,8,34,17,16,10,4,0
"20230429MORLIN",2023-04-29,"England League 1","Morecambe","Lincoln",3,2,"H",11,12,5,5,13,13,3,6,3,3,0,0,0,0,0,5,23,10,26,9,6,0
"20230429PETBRI",2023-04-29,"England League 1","Peterboro","Bristol Rvs",0,0,"D",23,6,5,2,8,10,12,2,3,5,0,0,0,0,0,0,29,7,18,14,8,0
"20230429PLYBUR",2023-04-29,"England League 1","Plymouth","Burton",1,0,"H",22,7,4,1,8,14,6,4,0,3,0,0,0,0,0,1,29,5,22,10,3,0
"20230429SHRSHE",2023-04-29,"England League 1","Shrewsbury","Sheffield Weds",0,3,"A",13,20,3,6,14,7,5,6,3,2,0,0,0,0,0,3,33,9,21,11,5,0
"20230429WYCCHE",2023-04-29,"England League 1","Wycombe","Cheltenham",0,3,"A",14,18,2,7,10,14,8,1,1,3,0,0,0,0,0,3,32,9,24,9,4,0
"20230502SHRBRI",2023-05-02,"England League 1","Shrewsbury","Bristol Rvs",2,1,"H",6,21,2,4,14,10,3,7,4,2,0,0,0,0,0,3,27,6,24,10,6,0
"20230503BURCAM",2023-05-03,"England League 1","Burton","Cambridge",1,0,"H",9,10,2,1,10,5,4,8,2,1,0,0,0,0,0,1,19,3,15,12,3,0
"20230507BARPET",2023-05-07,"England League 1","Barnsley","Peterboro",0,2,"A",14,10,2,5,10,15,10,3,0,1,0,0,0,0,0,2,24,7,25,13,1,0
"20230507BRIBOL",2023-05-07,"England League 1","Bristol Rvs","Bolton",2,3,"A",12,14,6,5,13,14,5,8,1,3,0,0,0,0,0,5,26,11,27,13,4,0
"20230507BURMIL",2023-05-07,"England League 1","Burton","Milton Keynes Dons",0,0,"D",5,31,2,6,13,10,3,12,1,1,0,0,0,0,0,0,36,8,23,15,2,0
"20230507CAMFOR",2023-05-07,"England League 1","Cambridge","Forest Green",2,0,"H",12,5,3,0,8,13,7,2,0,2,0,0,0,0,0,2,17,3,21,9,2,0
"20230507CHECHA",2023-05-07,"England League 1","Cheltenham","Charlton",2,2,"D",20,16,7,6,7,8,5,3,0,0,0,0,0,0,0,4,36,13,15,8,0,0
"20230507EXEMOR",2023-05-07,"England League 1","Exeter","Morecambe",3,2,"H",15,14,3,6,12,10,7,1,4,3,0,0,0,0,0,5,29,9,22,8,7,0
"20230507FLEIPS",2023-05-07,"England League 1","Fleetwood Town","Ipswich",2,2,"D",8,21,4,2,5,14,4,8,0,3,0,1,0,0,0,4,29,6,19,12,3,1
"20230507LINSHR",2023-05-07,"England League 1","Lincoln","Shrewsbury",1,0,"H",13,13,4,3,6,11,1,4,2,1,0,1,0,0,0,1,26,7,17,5,3,1
"20230507OXFACC",2023-05-07,"England League 1","Oxford","Accrington",1,2,"A",25,9,6,4,14,11,8,3,1,2,0,0,0,0,0,3,34,10,25,11,3,0
"20230507PORPLY",2023-05-07,"England League 1","Port Vale","Plymouth",1,3,"A",9,11,2,4,11,10,4,1,0,1,0,0,0,0,0,4,20,6,21,5,1,0
"20230507PORWYC",2023-05-07,"England League 1","Portsmouth","Wycombe",2,2,"D",21,8,9,5,5,16,10,1,1,1,0,0,0,0,0,4,29,14,21,11,2,0
"20230507SHEDER",2023-05-07,"England League 1","Sheffield Weds","Derby",1,0,"H",18,10,4,6,10,8,2,6,3,2,0,1,0,0,0,1,28,10,18,8,5,1
"20230805BARPOR",2023-08-05,"England League 1","Barnsley","Port Vale",7,0,"H",12,13,8,4,15,14,3,6,6,2,0,0,0,0,0,7,25,12,29,9,8,0
"20230805BLABUR",2023-08-05,"England League 1","Blackpool","Burton",2,0,"H",15,9,4,3,10,12,7,4,4,1,0,0,0,0,0,2,24,7,22,11,5,0
"20230805BOLLIN",2023-08-05,"England League 1","Bolton","Lincoln",3,0,"H",16,6,4,0,19,16,10,1,3,3,0,0,1,1,0,3,22,4,35,11,6,0
"20230805CAMOXF",2023-08-05,"England League 1","Cambridge","Oxford",2,0,"H",10,10,6,3,9,10,2,10,4,1,0,0,0,0,0,2,20,9,19,12,5,0
"20230805CARFLE",2023-08-05,"England League 1","Carlisle","Fleetwood Town",1,1,"D",15,13,6,5,8,18,5,2,2,3,0,0,0,0,0,2,28,11,26,7,5,0
"20230805CHALEY",2023-08-05,"England League 1","Charlton","Leyton Orient",1,0,"H",13,8,5,3,9,14,2,3,3,2,0,0,0,0,0,1,21,8,23,5,5,0
"20230805DERWIG",2023-08-05,"England League 1","Derby","Wigan",1,2,"A",21,7,5,3,11,6,11,4,2,2,0,0,0,0,0,3,28,8,17,15,4,0
"20230805NORSTE",2023-08-05,"England League 1","Northampton","Stevenage",0,1,"A",8,14,0,5,13,12,7,4,2,3,0,0,0,0,0,1,22,5,25,11,5,0
"20230805PORBRI",2023-08-05,"England League 1","Portsmouth","Bristol Rvs",1,1,"D",21,10,5,6,14,13,11,3,4,3,0,0,0,0,0,2,31,11,27,14,7,0
"20230805REAPET",2023-08-05,"England League 1","Reading","Peterboro",0,1,"A",15,13,4,6,12,9,6,6,6,4,0,0,0,0,0,1,28,10,21,12,10,0
"20230805SHRCHE",2023-08-05,"England League 1","Shrewsbury","Cheltenham",1,0,"H",12,16,3,4,10,7,5,4,3,2,0,0,0,0,0,1,28,7,17,9,5,0
"20230805WYCEXE",2023-08-05,"England League 1","Wycombe","Exeter",0,3,"A",10,11,1,7,11,12,4,5,2,2,0,0,0,0,0,3,21,8,23,9,4,0
"20230812BRIBAR",2023-08-12,"England League 1","Bristol Rvs","Barnsley",1,1,"D",15,9,4,3,13,10,7,2,0,3,0,0,0,0,0,2,24,7,23,9,3,0
"20230812BURDER",2023-08-12,"England League 1","Burton","Derby",0,3,"A",14,8,2,5,12,7,6,2,1,3,0,0,0,0,0,3,22,7,19,8,4,0
"20230812CHEBOL",2023-08-12,"England League 1","Cheltenham","Bolton",0,3,"A",5,16,2,7,7,9,3,9,2,1,0,0,0,0,0,3,21,9,16,12,3,0
"20230812EXEBLA",2023-08-12,"England League 1","Exeter","Blackpool",0,0,"D",11,4,1,3,6,7,6,7,2,1,0,0,0,0,0,0,15,4,13,13,3,0
"20230812FLECAM",2023-08-12,"England League 1","Fleetwood Town","Cambridge",0,2,"A",13,16,2,7,16,14,9,6,3,3,0,0,0,0,0,2,29,9,30,15,6,0
"20230812LEYPOR",2023-08-12,"England League 1","Leyton Orient","Portsmouth",0,4,"A",11,10,3,4,10,8,3,3,2,2,0,0,1,1,0,4,21,7,18,6,4,0
"20230812LINWYC",2023-08-12,"England League 1","Lincoln","Wycombe",3,0,"H",14,7,8,4,11,12,3,6,2,2,0,0,0,0,0,3,21,12,23,9,4,0
"20230812OXFCAR",2023-08-12,"England League 1","Oxford","Carlisle",1,0,"H",14,8,3,0,9,17,5,4,0,4,0,0,0,0,0,1,22,3,26,9,4,0
"20230812PETCHA",2023-08-12,"England League 1","Peterboro","Charlton",1,0,"H",14,12,3,2,15,12,7,5,5,5,0,0,0,0,0,1,26,5,27,12,10,0
"20230812PORREA",2023-08-12,"England League 1","Port Vale","Reading",1,0,"H",17,9,3,1,7,11,5,2,0,2,0,0,0,0,0,1,26,4,18,7,2,0
"20230812STESHR",2023-08-12,"England League 1","Stevenage","Shrewsbury",2,0,"H",14,2,6,1,7,12,13,3,0,3,0,0,0,0,0,2,16,7,19,16,3,0
"20230812WIGNOR",2023-08-12,"England League 1","Wigan","Northampton",2,1,"H",24,17,5,3,10,14,8,5,4,4,0,0,0,0,0,3,41,8,24,13,8,0
"20230815BARPET",2023-08-15,"England League 1","Barnsley","Peterboro",1,3,"A",13,18,7,9,7,7,10,5,0,1,0,0,0,0,0,4,31,16,14,15,1,0
"20230815BLAPOR",2023-08-15,"England League 1","Blackpool","Port Vale",0,0,"D",14,8,4,1,5,9,4,2,1,1,0,0,0,0,0,0,22,5,14,6,2,0
"20230815BOLFLE",2023-08-15,"England League 1","Bolton","Fleetwood Town",3,1,"H",8,10,5,7,11,12,5,12,2,4,1,0,0,0,0,4,18,12,23,17,6,1
"20230815CAMSTE",2023-08-15,"England League 1","Cambridge","Stevenage",1,2,"A",11,11,3,6,11,17,6,3,0,3,0,0,0,0,0,3,22,9,28,9,3,0
"20230815CARWIG",2023-08-15,"England League 1","Carlisle","Wigan",1,1,"D",11,14,2,4,15,6,3,5,4,2,0,0,0,0,0,2,25,6,21,8,6,0
"20230815CHABRI",2023-08-15,"England League 1","Charlton","Bristol Rvs",1,2,"A",18,14,5,7,12,6,7,5,1,2,0,0,0,0,0,3,32,12,18,12,3,0
"20230815DEROXF",2023-08-15,"England League 1","Derby","Oxford",1,2,"A",11,14,4,4,17,13,15,4,5,2,0,0,0,0,0,3,25,8,30,19,7,0
"20230815NORLIN",2023-08-15,"England League 1","Northampton","Lincoln",2,2,"D",19,6,9,3,9,7,3,1,1,0,0,0,0,0,0,4,25,12,16,4,1,0
"20230815SHRBUR",2023-08-15,"England League 1","Shrewsbury","Burton",2,1,"H",9,12,3,4,7,14,4,3,1,4,0,0,0,0,0,3,21,7,21,7,5,0
"20230815WYCLEY",2023-08-15,"England League 1","Wycombe","Leyton Orient",3,2,"H",15,15,6,6,4,8,3,7,1,3,0,1,0,0,0,5,30,12,12,10,4,1
"20230815POREXE",2023-08-15,"England League 1","Portsmouth","Exeter",1,0,"H",13,9,7,5,14,11,8,6,5,1,0,0,0,0,0,1,22,12,25,14,6,0
"20230815REACHE",2023-08-15,"England League 1","Reading","Cheltenham",1,0,"H",11,10,4,3,11,7,7,7,2,2,0,0,0,0,0,1,21,7,18,14,4,0
"20230819BOLWIG",2023-08-19,"England League 1","Bolton","Wigan",0,4,"A",20,11,4,5,18,11,4,2,2,3,0,0,0,0,0,4,31,9,29,6,5,0
"20230819BAROXF",2023-08-19,"England League 1","Barnsley","Oxford",1,3,"A",14,14,6,8,10,5,9,8,3,2,0,0,0,0,0,4,28,14,15,17,5,0
"20230819BLALEY",2023-08-19,"England League 1","Blackpool","Leyton Orient",0,0,"D",15,9,5,2,8,8,8,1,0,4,0,0,0,0,0,0,24,7,16,9,4,0
"20230819CAMBRI",2023-08-19,"England League 1","Cambridge","Bristol Rvs",2,0,"H",12,7,4,5,16,10,6,4,1,3,0,0,0,0,0,2,19,9,26,10,4,0
"20230819CAREXE",2023-08-19,"England League 1","Carlisle","Exeter",0,2,"A",13,11,6,3,5,10,11,3,0,1,0,0,0,0,0,2,24,9,15,14,1,0
"20230819CHAPOR",2023-08-19,"England League 1","Charlton","Port Vale",2,3,"A",17,15,7,5,15,13,9,4,4,3,0,0,0,0,0,5,32,12,28,13,7,0
"20230819DERFLE",2023-08-19,"England League 1","Derby","Fleetwood Town",1,0,"H",14,8,3,2,11,13,7,9,3,3,0,0,0,0,0,1,22,5,24,16,6,0
"20230819NORPET",2023-08-19,"England League 1","Northampton","Peterboro",1,0,"H",9,17,2,1,7,9,4,5,1,2,0,0,0,0,0,1,26,3,16,9,3,0
"20230819PORCHE",2023-08-19,"England League 1","Portsmouth","Cheltenham",0,0,"D",15,12,5,1,9,14,5,5,0,3,0,0,0,0,0,0,27,6,23,10,3,0
"20230819REASTE",2023-08-19,"England League 1","Reading","Stevenage",2,0,"H",20,6,7,4,12,8,7,0,0,3,0,1,0,0,0,2,26,11,20,7,3,1
"20230819SHRLIN",2023-08-19,"England League 1","Shrewsbury","Lincoln",0,1,"A",11,7,2,3,9,13,6,1,2,4,0,0,0,0,0,1,18,5,22,7,6,0
"20230819WYCBUR",2023-08-19,"England League 1","Wycombe","Burton",0,0,"D",14,7,8,3,10,10,6,2,2,2,0,0,0,0,0,0,21,11,20,8,4,0
"20230826BRIWYC",2023-08-26,"England League 1","Bristol Rvs","Wycombe",1,2,"A",12,12,1,5,12,6,7,3,3,0,0,0,0,0,0,3,24,6,18,10,3,0
"20230826BURBOL",2023-08-26,"England League 1","Burton","Bolton",1,1,"D",13,17,3,6,13,12,4,8,6,2,0,0,0,0,0,2,30,9,25,12,8,0
"20230826CHENOR",2023-08-26,"England League 1","Cheltenham","Northampton",0,1,"A",8,15,2,2,8,8,1,8,1,2,0,0,0,0,0,1,23,4,16,9,3,0
"20230826EXEREA",2023-08-26,"England League 1","Exeter","Reading",2,1,"H",20,12,4,3,10,9,7,7,3,4,0,0,0,0,0,3,32,7,19,14,7,0
"20230826FLESHR",2023-08-26,"England League 1","Fleetwood Town","Shrewsbury",0,1,"A",9,5,1,2,14,12,9,1,1,3,2,0,0,0,0,1,14,3,26,10,4,2
"20230826LEYCAM",2023-08-26,"England League 1","Leyton Orient","Cambridge",2,0,"H",16,10,3,3,15,14,5,7,4,4,0,0,0,0,0,2,26,6,29,12,8,0
"20230826LINBLA",2023-08-26,"England League 1","Lincoln","Blackpool",3,0,"H",11,14,5,3,13,13,1,2,1,0,0,1,0,0,0,3,25,8,26,3,1,1
"20230826OXFCHA",2023-08-26,"England League 1","Oxford","Charlton",2,1,"H",16,9,5,3,11,16,7,1,3,6,0,0,0,0,0,3,25,8,27,8,9,0
"20230826PETDER",2023-08-26,"England League 1","Peterboro","Derby",2,4,"A",16,14,6,5,6,12,8,9,2,1,0,0,0,0,0,6,30,11,18,17,3,0
"20230826PORCAR",2023-08-26,"England League 1","Port Vale","Carlisle",1,0,"H",17,10,5,2,6,9,8,8,0,0,0,0,0,0,0,1,27,7,15,16,0,0
"20230826STEPOR",2023-08-26,"England League 1","Stevenage","Portsmouth",0,0,"D",12,13,3,2,12,13,4,7,4,3,1,1,0,0,0,0,25,5,25,11,7,2
"20230826WIGBAR",2023-08-26,"England League 1","Wigan","Barnsley",0,2,"A",9,19,1,8,7,14,4,5,1,3,1,0,0,0,0,2,28,9,21,9,4,1
"20230902BLAWIG",2023-09-02,"England League 1","Blackpool","Wigan",2,1,"H",14,6,7,3,14,7,4,3,3,3,0,0,0,0,0,3,20,10,21,7,6,0
"20230902BOLDER",2023-09-02,"England League 1","Bolton","Derby",2,1,"H",17,10,4,1,11,9,7,6,3,2,0,1,0,0,0,3,27,5,20,13,5,1
"20230902BRILIN",2023-09-02,"England League 1","Bristol Rvs","Lincoln",1,1,"D",11,12,3,5,9,8,7,5,2,3,0,0,0,0,0,2,23,8,17,12,5,0
"20230902BUREXE",2023-09-02,"England League 1","Burton","Exeter",0,1,"A",9,16,5,4,14,8,3,5,2,1,1,0,0,0,0,1,25,9,22,8,3,1
"20230902CARSHR",2023-09-02,"England League 1","Carlisle","Shrewsbury",2,0,"H",11,9,2,2,11,8,8,6,2,4,0,0,0,0,0,2,20,4,19,14,6,0
"20230902CHAFLE",2023-09-02,"England League 1","Charlton","Fleetwood Town",2,1,"H",17,11,4,3,12,12,13,4,4,3,0,0,0,0,0,3,28,7,24,17,7,0
"20230902CHEBAR",2023-09-02,"England League 1","Cheltenham","Barnsley",0,2,"A",17,19,5,5,9,11,7,4,3,3,0,0,0,0,0,2,36,10,20,11,6,0
"20230902LEYSTE",2023-09-02,"England League 1","Leyton Orient","Stevenage",0,3,"A",8,10,2,4,13,9,9,6,2,1,0,0,0,0,0,3,18,6,22,15,3,0
"20230902NORWYC",2023-09-02,"England League 1","Northampton","Wycombe",0,1,"A",20,7,6,1,12,9,5,3,0,2,0,0,0,0,0,1,27,7,21,8,2,0
"20230902OXFPOR",2023-09-02,"England League 1","Oxford","Port Vale",1,2,"A",13,8,6,5,8,14,5,3,1,2,2,0,1,1,0,3,21,11,22,8,3,2
"20230902PORPET",2023-09-02,"England League 1","Portsmouth","Peterboro",3,1,"H",18,16,7,4,10,12,10,9,1,3,1,0,0,0,0,4,34,11,22,19,4,1
"20230904CAMREA",2023-09-04,"England League 1","Cambridge","Reading",1,0,"H",17,13,3,4,8,15,9,5,1,4,0,0,0,0,0,1,30,7,23,14,5,0
"20230909EXELEY",2023-09-09,"England League 1","Exeter","Leyton Orient",1,2,"A",5,19,2,7,12,10,4,10,3,3,0,0,0,0,0,3,24,9,22,14,6,0
"20230909STECAR",2023-09-09,"England League 1","Stevenage","Carlisle",2,2,"D",16,4,8,2,13,10,11,2,2,2,0,0,0,0,0,4,20,10,23,13,4,0
"20230916BARBUR",2023-09-16,"England League 1","Barnsley","Burton",2,0,"H",8,8,3,1,5,10,0,2,0,0,0,0,0,0,0,2,16,4,15,2,0,0
"20230916DERPOR",2023-09-16,"England League 1","Derby","Portsmouth",1,1,"D",8,14,1,5,16,9,4,8,2,3,0,0,0,0,0,2,22,6,25,12,5,0
"20230916EXECHE",2023-09-16,"England League 1","Exeter","Cheltenham",1,0,"H",20,9,7,2,11,9,8,2,3,2,0,0,0,0,0,1,29,9,20,10,5,0
"20230916FLEOXF",2023-09-16,"England League 1","Fleetwood Town","Oxford",0,3,"A",11,10,0,5,12,7,9,4,2,0,0,0,0,0,0,3,21,5,19,13,2,0
"20230916LINCAR",2023-09-16,"England League 1","Lincoln","Carlisle",1,1,"D",12,14,4,6,9,13,2,1,1,5,0,0,0,0,0,2,26,10,22,3,6,0
"20230916PETLEY",2023-09-16,"England League 1","Peterboro","Leyton Orient",1,1,"D",7,6,5,2,8,17,6,3,2,3,0,0,0,0,0,2,13,7,25,9,5,0
"20230916PORNOR",2023-09-16,"England League 1","Port Vale","Northampton",1,0,"H",13,5,4,1,7,6,5,3,1,0,0,0,0,0,0,1,18,5,13,8,1,0
"20230916REABOL",2023-09-16,"England League 1","Reading","Bolton",2,1,"H",18,10,7,5,17,15,6,4,3,4,0,1,0,0,0,3,28,12,32,10,7,1
"20230916SHRBRI",2023-09-16,"England League 1","Shrewsbury","Bristol Rvs",0,2,"A",12,9,4,4,14,10,5,6,2,3,0,0,0,0,0,2,21,8,24,11,5,0
"20230916STECHA",2023-09-16,"England League 1","Stevenage","Charlton",1,1,"D",9,12,3,1,10,16,5,4,3,3,0,0,0,0,0,2,21,4,26,9,6,0
"20230916WIGCAM",2023-09-16,"England League 1","Wigan","Cambridge",2,1,"H",6,18,3,3,13,10,3,2,2,0,0,0,0,0,0,3,24,6,23,5,2,0
"20230916WYCBLA",2023-09-16,"England League 1","Wycombe","Blackpool",2,0,"H",10,11,4,2,14,11,0,5,3,1,0,0,0,0,0,2,21,6,25,5,4,0
"20230919BARPOR",2023-09-19,"England League 1","Barnsley","Portsmouth",2,3,"A",15,16,3,6,13,8,3,5,0,1,0,0,0,0,0,5,31,9,21,8,1,0
"20230919PETCHE",2023-09-19,"England League 1","Peterboro","Cheltenham",3,0,"H",24,2,5,0,7,6,15,1,0,0,0,2,0,0,0,3,26,5,13,16,0,2
"20230919PORBUR",2023-09-19,"England League 1","Port Vale","Burton",2,3,"A",19,8,9,3,11,12,7,1,2,3,0,0,1,1,0,5,27,12,23,8,5,0
"20230923BLAREA",2023-09-23,"England League 1","Blackpool","Reading",4,1,"H",17,5,6,4,7,12,10,3,0,1,0,0,0,0,0,5,22,10,19,13,1,0
"20230923BOLPET",2023-09-23,"England League 1","Bolton","Peterboro",1,1,"D",7,25,3,6,11,14,8,10,4,2,1,0,0,0,0,2,32,9,25,18,6,1
"20230923BRIWIG",2023-09-23,"England League 1","Bristol Rvs","Wigan",4,1,"H",15,9,6,3,12,15,3,5,3,2,0,0,0,0,0,5,24,9,27,8,5,0
"20230923BURFLE",2023-09-23,"England League 1","Burton","Fleetwood Town",1,1,"D",13,13,2,4,9,9,4,5,2,0,0,0,0,0,0,2,26,6,18,9,2,0
"20230923CAMPOR",2023-09-23,"England League 1","Cambridge","Port Vale",1,1,"D",12,8,5,2,9,14,7,7,0,4,0,0,1,0,1,2,20,7,23,14,4,0
"20230923CARDER",2023-09-23,"England League 1","Carlisle","Derby",0,2,"A",9,9,4,2,8,13,8,2,1,1,0,0,0,0,0,2,18,6,21,10,2,0
"20230923CHAWYC",2023-09-23,"England League 1","Charlton","Wycombe",3,1,"H",9,12,6,1,15,10,7,6,3,2,0,0,0,0,0,4,21,7,25,13,5,0
"20230923CHESTE",2023-09-23,"England League 1","Cheltenham","Stevenage",0,3,"A",9,21,2,9,4,14,5,4,1,1,0,0,0,0,0,3,30,11,18,9,2,0
"20230923LEYSHR",2023-09-23,"England League 1","Leyton Orient","Shrewsbury",1,0,"H",9,12,1,5,12,9,7,7,4,1,0,0,0,0,0,1,21,6,21,14,5,0
"20230923NORBAR",2023-09-23,"England League 1","Northampton","Barnsley",1,2,"A",12,9,5,4,9,13,10,2,0,4,0,0,0,0,0,3,21,9,22,12,4,0
"20230923OXFEXE",2023-09-23,"England League 1","Oxford","Exeter",3,0,"H",9,14,4,5,11,13,3,4,1,1,0,0,0,0,0,3,23,9,24,7,2,0
"20230923PORLIN",2023-09-23,"England League 1","Portsmouth","Lincoln",2,1,"H",11,10,3,4,7,11,3,1,3,2,0,0,0,0,0,3,21,7,18,4,5,0
"20230930BARBLA",2023-09-30,"England League 1","Barnsley","Blackpool",0,1,"A",13,6,0,3,10,13,5,2,1,7,0,0,0,0,0,1,19,3,23,7,8,0
"20230930DERCAM",2023-09-30,"England League 1","Derby","Cambridge",0,0,"D",12,4,2,1,11,12,9,3,2,2,0,0,0,0,0,0,16,3,23,12,4,0
"20230930EXENOR",2023-09-30,"England League 1","Exeter","Northampton",0,2,"A",10,11,2,7,11,14,6,2,1,5,0,0,0,0,0,2,21,9,25,8,6,0
"20230930FLELEY",2023-09-30,"England League 1","Fleetwood Town","Leyton Orient",1,0,"H",14,15,3,5,10,10,6,6,1,3,1,1,0,0,0,1,29,8,20,12,4,2
"20230930LINCHE",2023-09-30,"England League 1","Lincoln","Cheltenham",2,0,"H",9,10,3,1,14,10,2,5,4,1,0,0,0,0,0,2,19,4,24,7,5,0
"20230930PETBRI",2023-09-30,"England League 1","Peterboro","Bristol Rvs",2,0,"H",15,16,7,2,9,14,9,9,5,2,0,0,0,0,0,2,31,9,23,18,7,0
"20230930PORBOL",2023-09-30,"England League 1","Port Vale","Bolton",0,1,"A",15,13,6,5,6,14,8,5,2,3,0,0,0,0,0,1,28,11,20,13,5,0
"20230930REABUR",2023-09-30,"England League 1","Reading","Burton",0,0,"D",20,3,7,1,7,11,5,2,1,4,0,0,0,0,0,0,23,8,18,7,5,0
"20230930SHRCHA",2023-09-30,"England League 1","Shrewsbury","Charlton",0,0,"D",15,14,8,6,6,9,7,7,1,4,0,0,0,0,0,0,29,14,15,14,5,0
"20230930STEOXF",2023-09-30,"England League 1","Stevenage","Oxford",1,3,"A",11,15,3,4,10,9,9,8,1,2,0,0,0,0,0,4,26,7,19,17,3,0
"20230930WIGPOR",2023-09-30,"England League 1","Wigan","Portsmouth",1,2,"A",7,16,1,5,17,16,1,9,3,2,1,0,1,1,0,3,23,6,33,10,5,1
"20230930WYCCAR",2023-09-30,"England League 1","Wycombe","Carlisle",2,0,"H",19,12,6,1,12,10,8,2,2,1,0,1,0,0,0,2,31,7,22,10,3,1
"20231003BLADER",2023-10-03,"England League 1","Blackpool","Derby",1,3,"A",10,9,4,5,6,11,9,3,1,1,0,0,0,0,0,4,19,9,17,12,2,0
"20231003BOLSTE",2023-10-03,"England League 1","Bolton","Stevenage",3,2,"H",9,11,4,3,13,13,4,5,3,2,0,0,0,0,0,5,20,7,26,9,5,0
"20231003BRIPOR",2023-10-03,"England League 1","Bristol Rvs","Port Vale",3,0,"H",10,6,7,2,11,13,8,3,1,1,0,1,0,0,0,3,16,9,24,11,2,1
"20231003BURWIG",2023-10-03,"England League 1","Burton","Wigan",2,1,"H",15,12,5,1,14,16,3,4,2,3,1,0,0,0,0,3,27,6,30,7,5,1
"20231003CAMBAR",2023-10-03,"England League 1","Cambridge","Barnsley",0,4,"A",17,12,8,7,7,12,6,6,2,2,0,0,0,0,0,4,29,15,19,12,4,0
"20231003CARPET",2023-10-03,"England League 1","Carlisle","Peterboro",1,1,"D",8,15,1,6,8,14,3,8,2,0,0,0,0,0,0,2,23,7,22,11,2,0
"20231003CHAEXE",2023-10-03,"England League 1","Charlton","Exeter",4,1,"H",21,12,10,3,12,10,9,5,1,0,0,1,0,0,0,5,33,13,22,14,1,1
"20231003CHEFLE",2023-10-03,"England League 1","Cheltenham","Fleetwood Town",0,2,"A",7,20,2,5,16,11,0,3,2,5,1,0,0,0,0,2,27,7,27,3,7,1
"20231003NORREA",2023-10-03,"England League 1","Northampton","Reading",3,1,"H",12,7,5,4,5,14,4,1,1,3,0,0,0,0,0,4,19,9,19,5,4,0
"20231003OXFSHR",2023-10-03,"England League 1","Oxford","Shrewsbury",3,0,"H",14,4,5,1,12,12,4,4,3,0,0,1,0,0,0,3,18,6,24,8,3,1
"20231003PORWYC",2023-10-03,"England League 1","Portsmouth","Wycombe",2,1,"H",11,8,3,1,8,13,14,2,2,4,0,0,0,0,0,3,19,4,21,16,6,0
"20231007OXFBRI",2023-10-07,"England League 1","Oxford","Bristol Rvs",2,1,"H",17,15,6,7,12,11,8,3,2,2,2,1,0,0,0,3,32,13,23,11,4,3
"20231007BOLCAR",2023-10-07,"England League 1","Bolton","Carlisle",1,3,"A",12,15,3,9,11,9,7,7,2,3,0,0,0,0,0,4,27,12,20,14,5,0
"20231007CHABLA",2023-10-07,"England League 1","Charlton","Blackpool",2,2,"D",18,9,5,4,5,6,5,3,2,3,0,0,0,0,0,4,27,9,11,8,5,0
"20231007CHEDER",2023-10-07,"England League 1","Cheltenham","Derby",1,1,"D",6,17,2,8,17,8,1,8,1,0,0,0,0,0,0,2,23,10,25,9,1,0
"20231007EXEBAR",2023-10-07,"England League 1","Exeter","Barnsley",0,1,"A",13,13,1,3,6,14,6,6,2,2,0,0,0,0,0,1,26,4,20,12,4,0
"20231007FLEWYC",2023-10-07,"England League 1","Fleetwood Town","Wycombe",1,4,"A",9,17,4,12,14,5,5,3,2,2,1,0,0,0,0,5,26,16,19,8,4,1
"20231007LEYREA",2023-10-07,"England League 1","Leyton Orient","Reading",2,1,"H",17,11,4,5,6,8,11,7,3,2,0,0,0,0,0,3,28,9,14,18,5,0
"20231007PETLIN",2023-10-07,"England League 1","Peterboro","Lincoln",2,0,"H",13,12,5,0,10,8,6,4,1,2,0,0,0,0,0,2,25,5,18,10,3,0
"20231007PORPOR",2023-10-07,"England League 1","Portsmouth","Port Vale",2,0,"H",13,14,4,3,8,14,6,6,1,3,0,0,0,0,0,2,27,7,22,12,4,0
"20231007SHRNOR",2023-10-07,"England League 1","Shrewsbury","Northampton",1,0,"H",13,17,2,2,9,13,3,10,1,3,0,0,0,0,0,1,30,4,22,13,4,0
"20231007STEWIG",2023-10-07,"England League 1","Stevenage","Wigan",1,0,"H",13,10,5,2,18,18,8,3,3,9,1,1,0,0,0,1,23,7,36,11,12,2
"20231009BURCAM",2023-10-09,"England League 1","Burton","Cambridge",2,1,"H",11,10,3,2,12,5,7,7,2,0,0,0,0,0,0,3,21,5,17,14,2,0
"20231014BLASTE",2023-10-14,"England League 1","Blackpool","Stevenage",3,0,"H",14,7,3,3,9,7,6,7,1,3,0,0,0,0,0,3,21,6,16,13,4,0
"20231014CAMSHR",2023-10-14,"England League 1","Cambridge","Shrewsbury",1,1,"D",10,15,1,2,11,10,4,5,2,1,0,0,0,0,0,2,25,3,21,9,3,0
"20231014CARLEY",2023-10-14,"England League 1","Carlisle","Leyton Orient",0,1,"A",10,12,1,5,6,18,9,3,0,3,0,0,0,0,0,1,22,6,24,12,3,0
"20231014LINBUR",2023-10-14,"England League 1","Lincoln","Burton",0,1,"A",10,6,3,1,8,9,4,4,1,4,1,0,0,0,0,1,16,4,17,8,5,1
"20231021BOLNOR",2023-10-21,"England League 1","Bolton","Northampton",2,1,"H",16,9,6,4,14,11,6,2,0,1,0,0,0,0,0,3,25,10,25,8,1,0
"20231021BURBRI",2023-10-21,"England League 1","Burton","Bristol Rvs",4,1,"H",10,13,4,4,15,8,4,5,3,1,0,1,0,0,0,5,23,8,23,9,4,1
"20231021CHAREA",2023-10-21,"England League 1","Charlton","Reading",4,0,"H",15,15,8,5,7,10,6,11,0,0,0,0,0,0,0,4,30,13,17,17,0,0
"20231021CHECAM",2023-10-21,"England League 1","Cheltenham","Cambridge",1,0,"H",20,12,7,2,14,13,4,3,4,1,0,0,0,0,0,1,32,9,27,7,5,0
"20231021EXEWIG",2023-10-21,"England League 1","Exeter","Wigan",0,2,"A",30,5,4,1,10,16,17,1,4,3,0,0,0,0,0,2,35,5,26,18,7,0
"20231021FLELIN",2023-10-21,"England League 1","Fleetwood Town","Lincoln",0,1,"A",13,11,4,3,14,13,8,5,3,4,1,0,1,0,1,1,24,7,27,13,7,1
"20231021LEYBAR",2023-10-21,"England League 1","Leyton Orient","Barnsley",1,1,"D",13,6,4,2,6,7,5,4,0,0,0,1,0,0,0,2,19,6,13,9,0,1
"20231021OXFBLA",2023-10-21,"England League 1","Oxford","Blackpool",1,1,"D",4,9,2,3,8,15,2,1,0,5,0,0,0,0,0,2,13,5,23,3,5,0
"20231021PETWYC",2023-10-21,"England League 1","Peterboro","Wycombe",2,2,"D",9,13,6,8,6,6,9,8,1,0,0,0,0,0,0,4,22,14,12,17,1,0
"20231021PORCAR",2023-10-21,"England League 1","Portsmouth","Carlisle",1,0,"H",18,14,8,3,8,16,6,3,1,3,0,0,0,0,0,1,32,11,24,9,4,0
"20231021SHRDER",2023-10-21,"England League 1","Shrewsbury","Derby",1,0,"H",16,11,7,6,9,12,9,8,1,2,0,0,0,0,0,1,27,13,21,17,3,0
"20231021STEPOR",2023-10-21,"England League 1","Stevenage","Port Vale",0,0,"D",12,8,2,3,10,8,6,7,3,3,0,0,0,0,0,0,20,5,18,13,6,0
"20231024BARSHR",2023-10-24,"England League 1","Barnsley","Shrewsbury",3,0,"H",11,13,3,2,8,9,3,7,1,2,0,0,0,0,0,3,24,5,17,10,3,0
"20231024BLACHE",2023-10-24,"England League 1","Blackpool","Cheltenham",3,2,"H",15,8,6,3,16,16,2,4,0,2,0,0,0,0,0,5,23,9,32,6,2,0
"20231024BRISTE",2023-10-24,"England League 1","Bristol Rvs","Stevenage",1,1,"D",18,11,2,4,16,22,4,4,6,4,0,0,0,0,0,2,29,6,38,8,10,0
"20231024CAMPOR",2023-10-24,"England League 1","Cambridge","Portsmouth",0,0,"D",6,16,1,3,11,10,4,7,1,4,0,0,0,0,0,0,22,4,21,11,5,0
"20231024CARBUR",2023-10-24,"England League 1","Carlisle","Burton",2,1,"H",16,5,7,2,7,10,7,2,1,3,0,0,1,0,1,3,21,9,17,9,4,0
"20231024DEREXE",2023-10-24,"England League 1","Derby","Exeter",2,0,"H",26,3,8,0,9,11,4,3,2,1,0,0,0,0,0,2,29,8,20,7,3,0
"20231024LINCHA",2023-10-24,"England League 1","Lincoln","Charlton",3,1,"H",23,13,9,4,8,6,6,5,0,0,0,0,0,0,0,4,36,13,14,11,0,0
"20231024NORLEY",2023-10-24,"England League 1","Northampton","Leyton Orient",2,2,"D",7,19,4,7,6,10,5,6,1,3,1,0,0,0,0,4,26,11,16,11,4,1
"20231024PORPET",2023-10-24,"England League 1","Port Vale","Peterboro",0,1,"A",16,10,5,5,7,10,6,5,1,5,0,0,0,0,0,1,26,10,17,11,6,0
"20231024WIGOXF",2023-10-24,"England League 1","Wigan","Oxford",2,0,"H",10,11,6,6,12,9,6,9,3,2,0,0,0,0,0,2,21,12,21,15,5,0
"20231024WYCBOL",2023-10-24,"England League 1","Wycombe","Bolton",2,4,"A",12,8,6,4,9,13,1,3,3,1,0,0,0,0,0,6,20,10,22,4,4,0
"20231024REAFLE",2023-10-24,"England League 1","Reading","Fleetwood Town",1,2,"A",18,15,6,6,12,3,9,11,1,2,0,0,0,0,0,3,33,12,15,20,3,0
"20231028BARFLE",2023-10-28,"England League 1","Barnsley","Fleetwood Town",2,2,"D",25,7,8,4,11,13,7,3,2,2,0,0,0,0,0,4,32,12,24,10,4,0
"20231028BLAPET",2023-10-28,"England League 1","Blackpool","Peterboro",2,4,"A",11,12,5,5,12,12,2,6,2,3,1,0,0,0,0,6,23,10,24,8,5,1
"20231028BRINOR",2023-10-28,"England League 1","Bristol Rvs","Northampton",2,1,"H",12,12,6,5,10,11,2,4,3,1,0,0,0,0,0,3,24,11,21,6,4,0
"20231028BURLEY",2023-10-28,"England League 1","Burton","Leyton Orient",0,0,"D",15,12,3,4,5,10,3,4,1,1,0,0,0,0,0,0,27,7,15,7,2,0
"20231028CAMCAR",2023-10-28,"England League 1","Cambridge","Carlisle",1,0,"H",14,8,3,0,7,13,7,6,2,0,0,2,0,0,0,1,22,3,20,13,2,2
"20231028CHABOL",2023-10-28,"England League 1","Charlton","Bolton",0,2,"A",12,12,1,5,8,10,9,3,1,1,0,0,0,0,0,2,24,6,18,12,2,0
"20231028EXELIN",2023-10-28,"England League 1","Exeter","Lincoln",1,1,"D",16,12,5,3,10,12,7,9,4,4,0,0,2,0,2,2,28,8,22,16,8,0
"20231028OXFWYC",2023-10-28,"England League 1","Oxford","Wycombe",2,2,"D",18,7,5,4,10,11,7,5,3,5,0,0,1,1,0,4,25,9,21,12,8,0
"20231028PORCHE",2023-10-28,"England League 1","Port Vale","Cheltenham",1,2,"A",16,9,5,3,12,19,11,7,2,4,0,0,0,0,0,3,25,8,31,18,6,0
"20231028REAPOR",2023-10-28,"England League 1","Reading","Portsmouth",2,3,"A",13,18,5,9,14,8,6,9,4,2,1,0,0,0,0,5,31,14,22,15,6,1
"20231028STEDER",2023-10-28,"England League 1","Stevenage","Derby",3,1,"H",11,13,6,3,11,14,3,7,2,2,0,0,0,0,0,4,24,9,25,10,4,0
"20231028WIGSHR",2023-10-28,"England League 1","Wigan","Shrewsbury",2,0,"H",20,6,7,0,9,7,3,1,1,1,0,1,0,0,0,2,26,7,16,4,2,1
"20231031DERNOR",2023-10-31,"England League 1","Derby","Northampton",4,0,"H",16,3,5,1,5,9,8,2,1,2,0,0,0,0,0,4,19,6,14,10,3,0
"20231031LINOXF",2023-10-31,"England League 1","Lincoln","Oxford",0,2,"A",8,19,3,9,6,8,6,9,0,2,0,0,0,0,0,2,27,12,14,15,2,0
"20231031WIGCHA",2023-10-31,"England League 1","Wigan","Charlton",2,3,"A",13,17,4,7,10,9,3,4,2,1,0,0,0,0,0,5,30,11,19,7,3,0
"20231031WYCCAM",2023-10-31,"England League 1","Wycombe","Cambridge",0,0,"D",12,8,4,1,12,12,8,1,2,3,0,0,0,0,0,0,20,5,24,9,5,0
"20231101FLEBLA",2023-11-01,"England League 1","Fleetwood Town","Blackpool",3,3,"D",14,30,8,7,15,7,2,8,2,3,0,0,0,0,0,6,44,15,22,10,5,0
"20231107SHRBOL",2023-11-07,"England League 1","Shrewsbury","Bolton",0,2,"A",5,10,2,2,10,13,5,1,0,0,0,0,0,0,0,2,15,4,23,6,0,0
"20231107WIGPET",2023-11-07,"England League 1","Wigan","Peterboro",2,1,"H",12,22,3,7,15,10,2,6,3,2,0,0,0,0,0,3,34,10,25,8,5,0
"20231107REABRI",2023-11-07,"England League 1","Reading","Bristol Rvs",1,1,"D",6,11,5,5,16,9,0,4,3,1,0,0,0,0,0,2,17,10,25,4,4,0
"20231111PETCAM",2023-11-11,"England League 1","Peterboro","Cambridge",5,0,"H",13,7,7,3,9,7,4,5,0,0,0,0,0,0,0,5,20,10,16,9,0,0
"20231111BOLBLA",2023-11-11,"England League 1","Bolton","Blackpool",1,0,"H",15,11,5,0,14,11,6,4,5,1,0,0,0,0,0,1,26,5,25,10,6,0
"20231111CARBRI",2023-11-11,"England League 1","Carlisle","Bristol Rvs",0,1,"A",16,6,5,2,11,15,10,0,4,3,0,1,0,0,0,1,22,7,26,10,7,1
"20231111CHEWIG",2023-11-11,"England League 1","Cheltenham","Wigan",1,1,"D",18,4,6,1,15,12,6,1,2,3,0,0,0,0,0,2,22,7,27,7,5,0
"20231111DERBAR",2023-11-11,"England League 1","Derby","Barnsley",3,0,"H",14,9,6,1,13,14,7,8,2,1,0,0,0,0,0,3,23,7,27,15,3,0
"20231111FLEEXE",2023-11-11,"England League 1","Fleetwood Town","Exeter",3,0,"H",20,11,12,7,8,19,9,5,2,2,0,0,0,0,0,3,31,19,27,14,4,0
"20231111LEYOXF",2023-11-11,"England League 1","Leyton Orient","Oxford",2,3,"A",10,13,1,7,7,8,4,4,2,2,0,0,0,0,0,5,23,8,15,8,4,0
"20231111LINPOR",2023-11-11,"England League 1","Lincoln","Port Vale",1,1,"D",15,6,3,4,5,5,9,1,0,1,1,1,0,0,0,2,21,7,10,10,1,2
"20231111NORBUR",2023-11-11,"England League 1","Northampton","Burton",2,0,"H",19,10,6,3,7,13,5,7,0,2,0,0,0,0,0,2,29,9,20,12,2,0
"20231111PORCHA",2023-11-11,"England League 1","Portsmouth","Charlton",2,2,"D",21,13,9,7,10,15,10,3,0,4,0,0,0,0,0,4,34,16,25,13,4,0
"20231111SHRREA",2023-11-11,"England League 1","Shrewsbury","Reading",3,2,"H",17,12,4,3,6,6,11,5,2,2,0,0,1,1,0,5,29,7,12,16,4,0
"20231111WYCSTE",2023-11-11,"England League 1","Wycombe","Stevenage",0,1,"A",4,8,0,2,15,16,2,7,3,2,0,0,0,0,0,1,12,2,31,9,5,0
"20231118BLASHR",2023-11-18,"England League 1","Blackpool","Shrewsbury",4,0,"H",9,8,7,2,12,11,5,4,0,1,0,0,0,0,0,4,17,9,23,9,1,0
"20231118STELIN",2023-11-18,"England League 1","Stevenage","Lincoln",1,0,"H",15,4,5,2,11,12,6,4,1,1,0,0,0,0,0,1,19,7,23,10,2,0
"20231121LEYLIN",2023-11-21,"England League 1","Leyton Orient","Lincoln",0,1,"A",17,11,6,5,13,7,3,4,2,0,0,0,0,0,0,1,28,11,20,7,2,0
"20231125BOLEXE",2023-11-25,"England League 1","Bolton","Exeter",7,0,"H",24,1,10,0,4,9,5,0,0,1,0,0,0,0,0,7,25,10,13,5,1,0
"20231125CARCHA",2023-11-25,"England League 1","Carlisle","Charlton",1,1,"D",14,22,5,8,8,4,4,8,0,0,0,0,0,0,0,2,36,13,12,12,0,0
"20231125CHEOXF",2023-11-25,"England League 1","Cheltenham","Oxford",2,0,"H",17,20,4,6,13,14,8,10,3,2,1,1,0,0,0,2,37,10,27,18,5,2
"20231125DERBRI",2023-11-25,"England League 1","Derby","Bristol Rvs",2,1,"H",10,13,6,3,5,12,8,1,0,0,0,0,0,0,0,3,23,9,17,9,0,0
"20231125FLESTE",2023-11-25,"England League 1","Fleetwood Town","Stevenage",0,3,"A",31,8,7,3,11,13,10,6,0,0,0,0,0,0,0,3,39,10,24,16,0,0
"20231125LEYWIG",2023-11-25,"England League 1","Leyton Orient","Wigan",1,1,"D",16,5,7,2,16,9,3,3,5,1,0,0,0,0,0,2,21,9,25,6,6,0
"20231125LINBAR",2023-11-25,"England League 1","Lincoln","Barnsley",2,2,"D",10,13,4,4,9,9,3,6,1,1,0,0,0,0,0,4,23,8,18,9,2,0
"20231125NORCAM",2023-11-25,"England League 1","Northampton","Cambridge",2,1,"H",13,12,5,5,11,12,6,1,1,2,0,1,1,0,1,3,25,10,23,7,3,1
"20231125PETBUR",2023-11-25,"England League 1","Peterboro","Burton",4,0,"H",25,10,8,2,6,9,4,2,1,3,0,0,0,0,0,4,35,10,15,6,4,0
"20231125PORBLA",2023-11-25,"England League 1","Portsmouth","Blackpool",0,4,"A",14,17,5,5,11,12,7,5,3,3,1,0,0,0,0,4,31,10,23,12,6,1
"20231125SHRPOR",2023-11-25,"England League 1","Shrewsbury","Port Vale",2,1,"H",10,22,4,5,14,11,2,14,4,1,0,0,0,0,0,3,32,9,25,16,5,0
"20231125WYCREA",2023-11-25,"England League 1","Wycombe","Reading",1,2,"A",8,13,1,6,9,16,4,7,2,0,0,0,0,0,0,3,21,7,25,11,2,0
"20231128BARWYC",2023-11-28,"England League 1","Barnsley","Wycombe",1,0,"H",15,10,2,2,6,6,9,2,0,3,0,1,0,0,0,1,25,4,12,11,3,1
"20231128BLANOR",2023-11-28,"England League 1","Blackpool","Northampton",1,2,"A",18,10,5,4,9,12,4,2,0,4,0,0,0,0,0,3,28,9,21,6,4,0
"20231128BRILEY",2023-11-28,"England League 1","Bristol Rvs","Leyton Orient",1,1,"D",10,10,4,3,9,9,4,11,1,3,0,0,0,0,0,2,20,7,18,15,4,0
"20231128BURPOR",2023-11-28,"England League 1","Burton","Portsmouth",0,2,"A",20,13,5,3,12,9,6,4,1,0,1,0,0,0,0,2,33,8,21,10,1,1
"20231128CAMLIN",2023-11-28,"England League 1","Cambridge","Lincoln",0,3,"A",5,14,2,7,13,18,2,4,2,2,0,0,0,0,0,3,19,9,31,6,4,0
"20231128CHACHE",2023-11-28,"England League 1","Charlton","Cheltenham",2,1,"H",19,11,7,1,10,18,9,4,1,5,0,0,0,0,0,3,30,8,28,13,6,0
"20231128EXESHR",2023-11-28,"England League 1","Exeter","Shrewsbury",0,0,"D",13,11,5,4,12,11,7,5,2,1,0,0,0,0,0,0,24,9,23,12,3,0
"20231128OXFBOL",2023-11-28,"England League 1","Oxford","Bolton",0,0,"D",7,10,5,3,9,13,5,4,2,2,0,0,0,0,0,0,17,8,22,9,4,0
"20231128PORDER",2023-11-28,"England League 1","Port Vale","Derby",0,1,"A",8,11,3,7,12,9,9,6,2,0,0,0,0,0,0,1,19,10,21,15,2,0
"20231128STEPET",2023-11-28,"England League 1","Stevenage","Peterboro",2,2,"D",11,22,5,6,16,13,5,9,2,0,0,0,0,0,0,4,33,11,29,14,2,0
"20231128WIGFLE",2023-11-28,"England League 1","Wigan","Fleetwood Town",3,0,"H",13,7,7,3,9,9,8,5,1,3,0,1,0,0,0,3,20,10,18,13,4,1
"20231128REACAR",2023-11-28,"England League 1","Reading","Carlisle",5,1,"H",16,15,6,6,13,7,2,5,1,1,0,0,0,0,0,6,31,12,20,7,2,0
"20231202NORPOR",2023-12-02,"England League 1","Northampton","Portsmouth",0,3,"A",8,17,3,5,7,8,0,8,1,1,0,0,0,0,0,3,25,8,15,8,2,0
"20231209BLACAR",2023-12-09,"England League 1","Blackpool","Carlisle",3,0,"H",13,8,6,4,6,14,9,4,0,3,0,0,0,0,0,3,21,10,20,13,3,0
"20231209BRICHE",2023-12-09,"England League 1","Bristol Rvs","Cheltenham",1,1,"D",15,8,5,1,11,15,4,6,1,2,0,0,1,1,0,2,23,6,26,10,3,0
"20231209BURSTE",2023-12-09,"England League 1","Burton","Stevenage",1,2,"A",8,14,5,4,17,7,3,5,3,2,0,0,0,0,0,3,22,9,24,8,5,0
"20231209CHACAM",2023-12-09,"England League 1","Charlton","Cambridge",2,2,"D",10,16,3,6,13,10,6,10,0,0,0,0,0,0,0,4,26,9,23,16,0,0
"20231209EXEPOR",2023-12-09,"England League 1","Exeter","Port Vale",0,1,"A",12,12,5,3,10,9,12,6,1,2,1,0,0,0,0,1,24,8,19,18,3,1
"20231209LEYDER",2023-12-09,"England League 1","Leyton Orient","Derby",0,3,"A",8,13,2,9,8,15,8,4,1,1,1,0,1,0,1,3,21,11,23,12,2,1
"20231209NORFLE",2023-12-09,"England League 1","Northampton","Fleetwood Town",3,0,"H",23,10,9,4,8,5,2,6,1,1,0,0,0,0,0,3,33,13,13,8,2,0
"20231209PETOXF",2023-12-09,"England League 1","Peterboro","Oxford",3,0,"H",16,8,9,2,10,6,5,4,1,1,0,0,1,0,1,3,24,11,16,9,2,0
"20231209REABAR",2023-12-09,"England League 1","Reading","Barnsley",1,3,"A",13,21,6,4,12,15,3,6,2,5,0,0,0,0,0,4,34,10,27,9,7,0
"20231209WIGLIN",2023-12-09,"England League 1","Wigan","Lincoln",0,0,"D",3,8,0,1,15,13,6,5,4,4,0,0,1,1,0,0,11,1,28,11,8,0
"20231209WYCSHR",2023-12-09,"England League 1","Wycombe","Shrewsbury",0,1,"A",16,6,5,1,9,6,7,4,0,0,0,0,0,0,0,1,22,6,15,11,0,0
"20231211PORBOL",2023-12-11,"England League 1","Portsmouth","Bolton",2,0,"H",12,10,6,2,17,13,6,1,3,4,0,0,0,0,0,2,22,8,30,7,7,0
"20231212REAOXF",2023-12-12,"England League 1","Reading","Oxford",1,1,"D",7,9,4,1,14,7,4,7,2,1,0,0,0,0,0,2,16,5,21,11,3,0
"20231216BARCHA",2023-12-16,"England League 1","Barnsley","Charlton",1,1,"D",18,15,5,3,12,3,7,5,4,4,0,0,0,0,0,2,33,8,15,12,8,0
"20231216BOLBRI",2023-12-16,"England League 1","Bolton","Bristol Rvs",1,2,"A",9,15,3,8,7,13,6,7,4,3,1,0,0,0,0,3,24,11,20,13,7,1
"20231216CAMBLA",2023-12-16,"England League 1","Cambridge","Blackpool",2,1,"H",8,13,4,5,13,14,3,5,4,3,1,0,0,0,0,3,21,9,27,8,7,1
"20231216CARNOR",2023-12-16,"England League 1","Carlisle","Northampton",2,2,"D",18,9,3,4,6,9,10,2,0,2,0,0,0,0,0,4,27,7,15,12,2,0
"20231216CHELEY",2023-12-16,"England League 1","Cheltenham","Leyton Orient",1,2,"A",9,13,3,3,12,17,3,7,2,4,1,0,0,0,0,3,22,6,29,10,6,1
"20231216DERWYC",2023-12-16,"England League 1","Derby","Wycombe",1,1,"D",8,9,2,1,8,8,5,2,5,3,0,0,0,0,0,2,17,3,16,7,8,0
"20231216FLEPET",2023-12-16,"England League 1","Fleetwood Town","Peterboro",0,1,"A",12,24,3,7,7,11,4,12,2,0,0,0,0,0,0,1,36,10,18,16,2,0
"20231216LINREA",2023-12-16,"England League 1","Lincoln","Reading",1,1,"D",4,14,0,6,14,14,1,5,3,3,0,0,0,0,0,2,18,6,28,6,6,0
"20231216OXFBUR",2023-12-16,"England League 1","Oxford","Burton",3,0,"H",28,7,14,1,6,13,5,0,0,1,0,0,0,0,0,3,35,15,19,5,1,0
"20231216PORWIG",2023-12-16,"England League 1","Port Vale","Wigan",3,2,"H",21,7,8,2,6,10,6,3,4,5,0,0,0,0,0,5,28,10,16,9,9,0
"20231216SHRPOR",2023-12-16,"England League 1","Shrewsbury","Portsmouth",0,3,"A",9,13,5,6,14,12,0,5,0,2,0,0,0,0,0,3,22,11,26,5,2,0
"20231216STEEXE",2023-12-16,"England League 1","Stevenage","Exeter",1,1,"D",11,7,3,3,10,13,12,3,1,4,0,1,0,0,0,2,18,6,23,15,5,1
"20231221DERLIN",2023-12-21,"England League 1","Derby","Lincoln",3,1,"H",10,6,5,2,13,6,4,3,2,3,0,0,0,0,0,4,16,7,19,7,5,0
"20231222CAMEXE",2023-12-22,"England League 1","Cambridge","Exeter",2,0,"H",18,9,4,4,5,13,5,6,0,2,0,0,0,0,0,2,27,8,18,11,2,0
"20231223BARSTE",2023-12-23,"England League 1","Barnsley","Stevenage",2,1,"H",9,14,5,4,12,11,1,4,3,1,0,0,0,0,0,3,23,9,23,5,4,0
"20231223BLABRI",2023-12-23,"England League 1","Blackpool","Bristol Rvs",3,1,"H",10,10,6,7,4,15,4,5,2,0,0,0,0,0,0,4,20,13,19,9,2,0
"20231223BOLLEY",2023-12-23,"England League 1","Bolton","Leyton Orient",3,2,"H",10,16,5,4,11,17,2,6,0,4,0,0,0,0,0,5,26,9,28,8,4,0
"20231223CARCHE",2023-12-23,"England League 1","Carlisle","Cheltenham",0,1,"A",10,8,2,2,10,15,6,4,2,3,0,0,0,0,0,1,18,4,25,10,5,0
"20231223CHABUR",2023-12-23,"England League 1","Charlton","Burton",1,1,"D",15,8,2,3,7,15,5,5,2,2,0,0,0,0,0,2,23,5,22,10,4,0
"20231223NOROXF",2023-12-23,"England League 1","Northampton","Oxford",2,1,"H",12,9,5,3,15,11,5,1,2,1,0,0,0,0,0,3,21,8,26,6,3,0
"20231223PORFLE",2023-12-23,"England League 1","Portsmouth","Fleetwood Town",1,1,"D",14,14,1,4,13,17,7,3,3,1,0,0,0,0,0,2,28,5,30,10,4,0
"20231223REAWIG",2023-12-23,"England League 1","Reading","Wigan",2,0,"H",10,14,3,2,17,12,4,2,1,5,0,0,0,0,0,2,24,5,29,6,6,0
"20231223SHRPET",2023-12-23,"England League 1","Shrewsbury","Peterboro",1,2,"A",7,17,1,4,8,8,4,9,3,1,0,0,0,0,0,3,24,5,16,13,4,0
"20231223WYCPOR",2023-12-23,"England League 1","Wycombe","Port Vale",1,1,"D",19,8,6,2,11,6,7,3,6,1,0,0,0,0,0,2,27,8,17,10,7,0
"20231226LEYCHA",2023-12-26,"England League 1","Leyton Orient","Charlton",1,0,"H",8,10,4,5,12,5,7,5,5,1,0,0,0,0,0,1,18,9,17,12,6,0
"20231226BRIPOR",2023-12-26,"England League 1","Bristol Rvs","Portsmouth",2,1,"H",12,11,3,6,13,16,3,3,4,6,0,0,3,3,0,3,23,9,29,6,10,0
"20231226BURBLA",2023-12-26,"England League 1","Burton","Blackpool",1,0,"H",8,10,2,0,14,13,3,8,2,1,0,0,0,0,0,1,18,2,27,11,3,0
"20231226CHESHR",2023-12-26,"England League 1","Cheltenham","Shrewsbury",2,0,"H",14,16,5,0,14,15,5,3,2,5,0,0,1,0,1,2,30,5,29,8,7,0
"20231226EXEWYC",2023-12-26,"England League 1","Exeter","Wycombe",1,0,"H",14,11,5,4,12,8,8,9,3,2,0,0,0,0,0,1,25,9,20,17,5,0
"20231226FLECAR",2023-12-26,"England League 1","Fleetwood Town","Carlisle",1,1,"D",11,9,2,3,11,7,5,4,1,0,0,0,0,0,0,2,20,5,18,9,1,0
"20231226LINBOL",2023-12-26,"England League 1","Lincoln","Bolton",0,1,"A",4,21,1,4,12,7,0,14,3,1,1,0,0,0,0,1,25,5,19,14,4,1
"20231226OXFCAM",2023-12-26,"England League 1","Oxford","Cambridge",2,1,"H",16,15,9,2,9,15,4,6,2,4,0,0,0,0,0,3,31,11,24,10,6,0
"20231226PETREA",2023-12-26,"England League 1","Peterboro","Reading",2,2,"D",20,6,5,2,7,17,16,2,1,3,0,0,0,0,0,4,26,7,24,18,4,0
"20231226PORBAR",2023-12-26,"England League 1","Port Vale","Barnsley",2,3,"A",22,11,7,7,7,7,10,3,3,1,0,0,0,0,0,5,33,14,14,13,4,0
"20231226STENOR",2023-12-26,"England League 1","Stevenage","Northampton",3,0,"H",11,2,7,0,12,15,6,1,0,1,0,0,0,0,0,3,13,7,27,7,1,0
"20231226WIGDER",2023-12-26,"England League 1","Wigan","Derby",0,1,"A",10,12,0,4,11,13,6,5,4,3,0,0,0,0,0,1,22,4,24,11,7,0
"20231229WIGCAR",2023-12-29,"England League 1","Wigan","Carlisle",2,0,"H",19,12,3,2,11,11,6,5,4,6,0,0,0,0,0,2,31,5,22,11,10,0
"20231229BRICHA",2023-12-29,"England League 1","Bristol Rvs","Charlton",2,1,"H",15,11,5,4,10,16,7,4,0,3,0,0,0,0,0,3,26,9,26,11,3,0
"20231229BURSHR",2023-12-29,"England League 1","Burton","Shrewsbury",1,0,"H",5,12,4,1,15,15,4,7,2,1,0,0,0,0,0,1,17,5,30,11,3,0
"20231229CHEREA",2023-12-29,"England League 1","Cheltenham","Reading",2,2,"D",20,13,8,5,10,13,7,5,2,4,0,0,0,0,0,4,33,13,23,12,6,0
"20231229EXEPOR",2023-12-29,"England League 1","Exeter","Portsmouth",0,0,"D",15,10,2,2,13,13,3,6,1,2,0,0,0,0,0,0,25,4,26,9,3,0
"20231229FLEBOL",2023-12-29,"England League 1","Fleetwood Town","Bolton",0,2,"A",4,18,1,6,14,7,3,6,2,1,0,0,0,0,0,2,22,7,21,9,3,0
"20231229LEYWYC",2023-12-29,"England League 1","Leyton Orient","Wycombe",0,0,"D",11,5,3,0,7,8,10,6,1,0,0,0,0,0,0,0,16,3,15,16,1,0
"20231229LINNOR",2023-12-29,"England League 1","Lincoln","Northampton",1,2,"A",13,8,5,4,8,11,8,4,1,5,1,0,0,0,0,3,21,9,19,12,6,1
"20231229OXFDER",2023-12-29,"England League 1","Oxford","Derby",2,3,"A",9,20,6,5,4,17,2,19,1,4,0,0,0,0,0,5,29,11,21,21,5,0
"20231229PETBAR",2023-12-29,"England League 1","Peterboro","Barnsley",2,2,"D",15,20,5,5,5,13,3,6,0,1,0,0,0,0,0,4,35,10,18,9,1,0
"20231229PORBLA",2023-12-29,"England League 1","Port Vale","Blackpool",3,0,"H",15,14,8,3,10,17,3,10,1,2,0,0,0,0,0,3,29,11,27,13,3,0
"20240101BARWIG",2024-01-01,"England League 1","Barnsley","Wigan",1,1,"D",12,13,4,1,6,15,3,7,3,2,0,0,0,0,0,2,25,5,21,10,5,0
"20240101BLALIN",2024-01-01,"England League 1","Blackpool","Lincoln",2,0,"H",13,8,5,1,18,13,8,2,3,1,0,0,0,0,0,2,21,6,31,10,4,0
"20240101BOLBUR",2024-01-01,"England League 1","Bolton","Burton",1,0,"H",21,7,4,1,6,13,11,3,1,2,0,0,0,0,0,1,28,5,19,14,3,0
"20240101CAMLEY",2024-01-01,"England League 1","Cambridge","Leyton Orient",0,2,"A",9,9,2,3,5,11,4,5,1,5,0,0,0,0,0,2,18,5,16,9,6,0
"20240101CARPOR",2024-01-01,"England League 1","Carlisle","Port Vale",2,1,"H",15,10,4,4,10,16,6,1,3,2,0,0,0,0,0,3,25,8,26,7,5,0
"20240101CHAOXF",2024-01-01,"England League 1","Charlton","Oxford",1,2,"A",11,12,3,4,11,10,9,3,2,2,0,0,1,0,1,3,23,7,21,12,4,0
"20240101DERPET",2024-01-01,"England League 1","Derby","Peterboro",2,3,"A",13,20,5,6,9,4,1,11,1,1,0,0,0,0,0,5,33,11,13,12,2,0
"20240101NORCHE",2024-01-01,"England League 1","Northampton","Cheltenham",1,0,"H",9,14,3,3,9,11,7,2,2,3,0,0,0,0,0,1,23,6,20,9,5,0
"20240101PORSTE",2024-01-01,"England League 1","Portsmouth","Stevenage",2,1,"H",12,9,6,5,14,20,1,5,3,5,0,1,0,0,0,3,21,11,34,6,8,1
"20240101REAEXE",2024-01-01,"England League 1","Reading","Exeter",3,2,"H",14,8,2,2,7,9,0,4,2,0,0,0,0,0,0,5,22,4,16,4,2,0
"20240101SHRFLE",2024-01-01,"England League 1","Shrewsbury","Fleetwood Town",3,1,"H",16,17,6,6,18,10,4,8,4,2,0,0,0,0,0,4,33,12,28,12,6,0
"20240101WYCBRI",2024-01-01,"England League 1","Wycombe","Bristol Rvs",3,2,"H",24,19,8,7,12,5,6,6,6,2,1,0,0,0,0,5,43,15,17,12,8,1
"20240106FLEDER",2024-01-06,"England League 1","Fleetwood Town","Derby",1,3,"A",13,11,1,6,11,9,3,11,1,1,0,0,0,0,0,4,24,7,20,14,2,0
"20240106BURWYC",2024-01-06,"England League 1","Burton","Wycombe",1,1,"D",10,21,2,4,11,9,2,10,2,2,0,0,0,0,0,2,31,6,20,12,4,0
"20240106CHEPOR",2024-01-06,"England League 1","Cheltenham","Portsmouth",2,1,"H",11,17,3,6,17,9,3,9,4,5,0,0,0,0,0,3,28,9,26,12,9,0
"20240106EXECAR",2024-01-06,"England League 1","Exeter","Carlisle",2,1,"H",16,11,6,3,10,6,7,3,4,1,0,0,0,0,0,3,27,9,16,10,5,0
"20240106PORCHA",2024-01-06,"England League 1","Port Vale","Charlton",3,3,"D",29,7,12,4,8,12,12,4,1,4,0,0,0,0,0,6,36,16,20,16,5,0
"20240113BARBRI",2024-01-13,"England League 1","Barnsley","Bristol Rvs",2,1,"H",14,15,5,7,10,10,6,3,3,1,0,0,0,0,0,3,29,12,20,9,4,0
"20240113BLAEXE",2024-01-13,"England League 1","Blackpool","Exeter",2,0,"H",14,10,5,4,6,11,9,4,4,5,0,0,0,0,0,2,24,9,17,13,9,0
"20240113CAMFLE",2024-01-13,"England League 1","Cambridge","Fleetwood Town",2,1,"H",13,15,3,8,8,15,5,2,0,2,0,0,0,0,0,3,28,11,23,7,2,0
"20240113CAROXF",2024-01-13,"England League 1","Carlisle","Oxford",1,3,"A",16,11,7,7,7,4,3,3,4,2,0,0,0,0,0,4,27,14,11,6,6,0
"20240113CHAPET",2024-01-13,"England League 1","Charlton","Peterboro",1,2,"A",13,17,5,6,11,7,1,6,1,1,0,0,0,0,0,3,30,11,18,7,2,0
"20240113NORWIG",2024-01-13,"England League 1","Northampton","Wigan",1,1,"D",7,11,2,2,17,10,1,9,3,6,0,0,0,0,0,2,18,4,27,10,9,0
"20240113PORLEY",2024-01-13,"England League 1","Portsmouth","Leyton Orient",0,3,"A",14,14,4,6,7,12,5,8,1,4,0,0,0,0,0,3,28,10,19,13,5,0
"20240113SHRSTE",2024-01-13,"England League 1","Shrewsbury","Stevenage",0,1,"A",6,12,3,2,16,8,3,2,1,2,0,0,0,0,0,1,18,5,24,5,3,0
"20240113WYCLIN",2024-01-13,"England League 1","Wycombe","Lincoln",1,1,"D",12,17,2,3,10,6,7,7,1,1,0,0,0,0,0,2,29,5,16,14,2,0
"20240115DERBUR",2024-01-15,"England League 1","Derby","Burton",3,2,"H",19,6,7,2,10,12,4,3,0,1,0,0,0,0,0,5,25,9,22,7,1,0
"20240116BARCAR",2024-01-16,"England League 1","Barnsley","Carlisle",2,1,"H",10,10,4,2,5,8,7,0,0,1,0,0,0,0,0,3,20,6,13,7,1,0
"20240120BRIBLA",2024-01-20,"England League 1","Bristol Rvs","Blackpool",1,2,"A",10,9,4,5,11,15,6,5,5,3,0,0,0,0,0,3,19,9,26,11,8,0
"20240120BURCHA",2024-01-20,"England League 1","Burton","Charlton",2,0,"H",7,14,4,4,13,7,3,5,2,2,0,0,0,0,0,2,21,8,20,8,4,0
"20240120EXECAM",2024-01-20,"England League 1","Exeter","Cambridge",0,0,"D",10,6,4,0,13,13,11,4,2,4,0,0,0,0,0,0,16,4,26,15,6,0
"20240120FLEPOR",2024-01-20,"England League 1","Fleetwood Town","Portsmouth",0,1,"A",9,9,3,3,10,13,2,10,4,4,0,0,0,0,0,1,18,6,23,12,8,0
"20240120LEYBOL",2024-01-20,"England League 1","Leyton Orient","Bolton",1,0,"H",11,4,5,1,13,10,3,3,1,2,0,0,0,0,0,1,15,6,23,6,3,0
"20240120LINDER",2024-01-20,"England League 1","Lincoln","Derby",0,0,"D",10,19,4,3,7,8,5,12,2,2,0,0,1,1,0,0,29,7,15,17,4,0
"20240120PETSHR",2024-01-20,"England League 1","Peterboro","Shrewsbury",2,1,"H",20,14,8,4,5,14,4,4,2,3,0,0,0,0,0,3,34,12,19,8,5,0
"20240120WIGREA",2024-01-20,"England League 1","Wigan","Reading",1,0,"H",8,11,7,6,10,17,1,3,2,1,0,0,0,0,0,1,19,13,27,4,3,0
"20240123BOLCHE",2024-01-23,"England League 1","Bolton","Cheltenham",1,0,"H",7,17,3,6,8,9,4,7,1,2,0,0,0,0,0,1,24,9,17,11,3,0
"20240123BRIEXE",2024-01-23,"England League 1","Bristol Rvs","Exeter",0,1,"A",15,10,0,4,12,14,10,7,1,2,0,0,0,0,0,1,25,4,26,17,3,0
"20240123CHANOR",2024-01-23,"England League 1","Charlton","Northampton",2,3,"A",16,13,5,5,8,10,2,5,3,2,1,0,0,0,0,5,29,10,18,7,5,1
"20240123OXFBAR",2024-01-23,"England League 1","Oxford","Barnsley",0,1,"A",17,9,4,1,12,14,2,4,3,4,0,0,5,2,3,1,26,5,26,6,7,0
"20240123WIGWYC",2024-01-23,"England League 1","Wigan","Wycombe",1,0,"H",9,11,3,2,10,15,7,3,3,1,0,0,0,0,0,1,20,5,25,10,4,0
"20240123READER",2024-01-23,"England League 1","Reading","Derby",1,0,"H",12,11,2,0,14,2,6,6,1,0,0,0,0,0,0,1,23,2,16,12,1,0
"20240127BAREXE",2024-01-27,"England League 1","Barnsley","Exeter",1,2,"A",16,9,6,6,7,11,7,10,1,3,0,0,0,0,0,3,25,12,18,17,4,0
"20240127BLACHA",2024-01-27,"England League 1","Blackpool","Charlton",1,1,"D",16,13,3,3,7,16,9,2,1,5,0,0,0,0,0,2,29,6,23,11,6,0
"20240127BRIOXF",2024-01-27,"England League 1","Bristol Rvs","Oxford",3,1,"H",9,10,6,5,11,4,5,5,1,1,0,0,0,0,0,4,19,11,15,10,2,0
"20240127CAMBUR",2024-01-27,"England League 1","Cambridge","Burton",0,0,"D",20,6,4,3,14,15,4,0,4,5,0,1,0,0,0,0,26,7,29,4,9,1
"20240127CARBOL",2024-01-27,"England League 1","Carlisle","Bolton",1,4,"A",10,17,2,8,6,9,5,5,1,2,0,0,0,0,0,5,27,10,15,10,3,0
"20240127DERCHE",2024-01-27,"England League 1","Derby","Cheltenham",2,1,"H",12,8,2,3,12,11,11,1,1,2,0,0,0,0,0,3,20,5,23,12,3,0
"20240127LINPET",2024-01-27,"England League 1","Lincoln","Peterboro",0,0,"D",12,7,3,3,11,14,3,6,1,1,0,0,0,0,0,0,19,6,25,9,2,0
"20240127NORSHR",2024-01-27,"England League 1","Northampton","Shrewsbury",0,2,"A",7,18,2,9,8,13,7,5,0,3,0,0,0,0,0,2,25,11,21,12,3,0
"20240127PORPOR",2024-01-27,"England League 1","Port Vale","Portsmouth",0,1,"A",7,20,0,6,14,8,3,10,4,2,0,0,0,0,0,1,27,6,22,13,6,0
"20240127REALEY",2024-01-27,"England League 1","Reading","Leyton Orient",1,1,"D",14,11,4,5,7,14,5,5,2,1,0,0,0,0,0,2,25,9,21,10,3,0
"20240127WIGSTE",2024-01-27,"England League 1","Wigan","Stevenage",2,3,"A",10,16,2,3,19,17,4,2,4,4,0,0,0,0,0,5,26,5,36,6,8,0
"20240127WYCFLE",2024-01-27,"England League 1","Wycombe","Fleetwood Town",2,2,"D",26,7,7,5,15,22,11,7,1,3,0,1,0,0,0,4,33,12,37,18,4,1
"20240130OXFPOR",2024-01-30,"England League 1","Oxford","Portsmouth",2,2,"D",13,17,4,6,8,11,6,3,0,2,0,0,0,0,0,4,30,10,19,9,2,0
"20240203OXFREA",2024-02-03,"England League 1","Oxford","Reading",1,1,"D",8,7,4,1,12,13,5,2,1,3,0,0,0,0,0,2,15,5,25,7,4,0
"20240203BOLBAR",2024-02-03,"England League 1","Bolton","Barnsley",1,1,"D",14,10,4,4,12,11,12,3,2,4,0,0,0,0,0,2,24,8,23,15,6,0
"20240203BURLIN",2024-02-03,"England League 1","Burton","Lincoln",0,1,"A",13,11,5,4,17,8,5,5,8,2,0,1,0,0,0,1,24,9,25,10,10,1
"20240203CHADER",2024-02-03,"England League 1","Charlton","Derby",0,1,"A",11,10,3,3,15,12,6,3,2,5,0,0,0,0,0,1,21,6,27,9,7,0
"20240203CHEWYC",2024-02-03,"England League 1","Cheltenham","Wycombe",1,3,"A",13,11,3,4,7,12,8,6,1,2,0,0,0,0,0,4,24,7,19,14,3,0
"20240203EXEBRI",2024-02-03,"England League 1","Exeter","Bristol Rvs",0,1,"A",11,6,6,2,12,12,6,2,1,3,0,0,0,0,0,1,17,8,24,8,4,0
"20240203FLEPOR",2024-02-03,"England League 1","Fleetwood Town","Port Vale",3,0,"H",12,10,8,1,12,8,4,8,3,1,0,0,0,0,0,3,22,9,20,12,4,0
"20240203LEYCAR",2024-02-03,"England League 1","Leyton Orient","Carlisle",3,2,"H",17,3,8,2,15,9,6,2,4,0,0,0,0,0,0,5,20,10,24,8,4,0
"20240203PETWIG",2024-02-03,"England League 1","Peterboro","Wigan",2,3,"A",25,10,7,5,11,13,5,1,2,5,0,1,0,0,0,5,35,12,24,6,7,1
"20240203PORNOR",2024-02-03,"England League 1","Portsmouth","Northampton",4,1,"H",10,11,7,5,13,12,6,1,1,1,1,0,0,0,0,5,21,12,25,7,2,1
"20240203SHRCAM",2024-02-03,"England League 1","Shrewsbury","Cambridge",1,2,"A",9,8,4,3,20,11,5,2,1,2,1,0,0,0,0,3,17,7,31,7,3,1
"20240203STEBLA",2024-02-03,"England League 1","Stevenage","Blackpool",1,0,"H",12,11,4,4,12,14,4,9,2,3,0,0,0,0,0,1,23,8,26,13,5,0
"20240206BRIFLE",2024-02-06,"England League 1","Bristol Rvs","Fleetwood Town",0,2,"A",13,7,6,3,11,15,11,4,3,3,1,0,0,0,0,2,20,9,26,15,6,1
"20240206EXEPET",2024-02-06,"England League 1","Exeter","Peterboro",2,1,"H",6,12,2,6,11,12,4,5,1,1,0,1,0,0,0,3,18,8,23,9,2,1
"20240206PORLEY",2024-02-06,"England League 1","Port Vale","Leyton Orient",0,1,"A",7,17,3,8,3,6,4,2,0,2,0,0,0,0,0,1,24,11,9,6,2,0
"20240206STEREA",2024-02-06,"England League 1","Stevenage","Reading",0,1,"A",14,7,2,1,4,13,9,3,0,4,0,0,0,0,0,1,21,3,17,12,4,0
"20240210BARLEY",2024-02-10,"England League 1","Barnsley","Leyton Orient",2,1,"H",23,7,11,5,6,15,9,1,2,3,1,0,1,0,1,3,30,16,21,10,5,1
"20240210BLAOXF",2024-02-10,"England League 1","Blackpool","Oxford",1,1,"D",16,8,6,2,9,9,6,5,3,1,0,0,1,0,1,2,24,8,18,11,4,0
"20240210BRIBUR",2024-02-10,"England League 1","Bristol Rvs","Burton",1,2,"A",7,13,3,7,12,14,5,1,0,4,0,0,0,0,0,3,20,10,26,6,4,0
"20240210CAMCHE",2024-02-10,"England League 1","Cambridge","Cheltenham",0,1,"A",10,13,5,2,10,19,2,5,3,3,0,0,0,0,0,1,23,7,29,7,6,0
"20240210CARPOR",2024-02-10,"England League 1","Carlisle","Portsmouth",0,1,"A",7,11,1,1,8,10,3,3,1,0,0,0,0,0,0,1,18,2,18,6,1,0
"20240210DERSHR",2024-02-10,"England League 1","Derby","Shrewsbury",1,1,"D",8,7,3,3,7,15,4,2,2,3,0,0,0,0,0,2,15,6,22,6,5,0
"20240210LINFLE",2024-02-10,"England League 1","Lincoln","Fleetwood Town",2,1,"H",20,3,4,2,11,15,6,0,3,1,0,1,0,0,0,3,23,6,26,6,4,1
"20240210NORBOL",2024-02-10,"England League 1","Northampton","Bolton",1,1,"D",14,8,5,4,10,15,4,7,0,3,0,1,0,0,0,2,22,9,25,11,3,1
"20240210PORSTE",2024-02-10,"England League 1","Port Vale","Stevenage",2,2,"D",12,11,4,4,14,13,4,1,3,4,0,0,0,0,0,4,23,8,27,5,7,0
"20240210REACHA",2024-02-10,"England League 1","Reading","Charlton",2,0,"H",11,10,6,1,12,8,11,5,1,1,0,0,0,0,0,2,21,7,20,16,2,0
"20240210WIGEXE",2024-02-10,"England League 1","Wigan","Exeter",1,2,"A",13,8,6,4,13,14,11,6,2,2,0,0,0,0,0,3,21,10,27,17,4,0
"20240210WYCPET",2024-02-10,"England League 1","Wycombe","Peterboro",5,2,"H",15,11,7,3,8,6,3,11,2,1,0,0,0,0,0,7,26,10,14,14,3,0
"20240213BOLWYC",2024-02-13,"England League 1","Bolton","Wycombe",2,1,"H",8,11,4,3,11,16,6,2,1,1,0,0,0,0,0,3,19,7,27,8,2,0
"20240213CHALIN",2024-02-13,"England League 1","Charlton","Lincoln",1,1,"D",9,5,5,1,12,15,5,6,3,4,0,0,0,0,0,2,14,6,27,11,7,0
"20240213CHEBLA",2024-02-13,"England League 1","Cheltenham","Blackpool",2,0,"H",17,3,8,1,16,13,7,3,4,3,0,0,0,0,0,2,20,9,29,10,7,0
"20240213EXEDER",2024-02-13,"England League 1","Exeter","Derby",0,3,"A",13,9,2,6,9,13,3,1,2,3,0,0,0,0,0,3,22,8,22,4,5,0
"20240213FLEREA",2024-02-13,"England League 1","Fleetwood Town","Reading",1,1,"D",13,7,5,4,8,9,5,2,0,3,0,0,0,0,0,2,20,9,17,7,3,0
"20240213LEYNOR",2024-02-13,"England League 1","Leyton Orient","Northampton",4,3,"H",19,9,8,3,12,10,8,2,2,2,0,0,0,0,0,7,28,11,22,10,4,0
"20240213OXFWIG",2024-02-13,"England League 1","Oxford","Wigan",4,2,"H",14,11,5,5,21,8,2,5,3,4,0,0,0,0,0,6,25,10,29,7,7,0
"20240213PORCAM",2024-02-13,"England League 1","Portsmouth","Cambridge",3,1,"H",9,10,4,2,13,15,5,8,2,5,0,0,2,0,2,4,19,6,28,13,7,0
"20240213SHRBAR",2024-02-13,"England League 1","Shrewsbury","Barnsley",1,1,"D",15,21,4,4,14,6,5,8,3,2,0,0,0,0,0,2,36,8,20,13,5,0
"20240213STEBRI",2024-02-13,"England League 1","Stevenage","Bristol Rvs",2,3,"A",20,6,6,4,7,16,6,1,0,1,0,1,0,0,0,5,26,10,23,7,1,1
"20240217BOLCHA",2024-02-17,"England League 1","Bolton","Charlton",3,3,"D",15,6,4,4,7,19,7,6,2,6,0,0,0,0,0,6,21,8,26,13,8,0
"20240217CARCAM",2024-02-17,"England League 1","Carlisle","Cambridge",0,4,"A",14,12,2,5,7,9,5,6,2,1,0,0,0,0,0,4,26,7,16,11,3,0
"20240217CHEPOR",2024-02-17,"England League 1","Cheltenham","Port Vale",3,2,"H",16,6,7,4,10,19,7,2,1,3,0,0,0,0,0,5,22,11,29,9,4,0
"20240217DERSTE",2024-02-17,"England League 1","Derby","Stevenage",1,0,"H",5,4,2,2,13,16,2,4,0,2,0,0,0,0,0,1,9,4,29,6,2,0
"20240217FLEBAR",2024-02-17,"England League 1","Fleetwood Town","Barnsley",1,2,"A",18,15,5,6,10,9,7,3,0,4,0,0,0,0,0,3,33,11,19,10,4,0
"20240217LEYBUR",2024-02-17,"England League 1","Leyton Orient","Burton",1,2,"A",10,8,5,3,10,8,4,6,1,1,0,0,0,0,0,3,18,8,18,10,2,0
"20240217LINEXE",2024-02-17,"England League 1","Lincoln","Exeter",1,0,"H",13,6,5,2,5,12,7,5,1,3,0,0,0,0,0,1,19,7,17,12,4,0
"20240217NORBRI",2024-02-17,"England League 1","Northampton","Bristol Rvs",3,1,"H",7,13,4,4,14,6,3,5,2,1,0,0,0,0,0,4,20,8,20,8,3,0
"20240217PETBLA",2024-02-17,"England League 1","Peterboro","Blackpool",1,2,"A",14,17,4,8,12,11,7,1,1,4,0,0,0,0,0,3,31,12,23,8,5,0
"20240217PORREA",2024-02-17,"England League 1","Portsmouth","Reading",4,1,"H",10,16,6,8,11,15,3,6,4,3,0,0,0,0,0,5,26,14,26,9,7,0
"20240217SHRWIG",2024-02-17,"England League 1","Shrewsbury","Wigan",0,1,"A",15,7,4,3,24,11,14,5,4,3,0,0,2,2,0,1,22,7,35,19,7,0
"20240217WYCOXF",2024-02-17,"England League 1","Wycombe","Oxford",0,0,"D",10,9,4,2,10,13,8,3,0,3,0,0,0,0,0,0,19,6,23,11,3,0
"20240220CAMBOL",2024-02-20,"England League 1","Cambridge","Bolton",1,2,"A",6,12,2,5,12,11,3,4,2,2,1,0,0,0,0,3,18,7,23,7,4,1
"20240220OXFNOR",2024-02-20,"England League 1","Oxford","Northampton",2,2,"D",18,6,6,2,5,11,7,0,1,4,0,0,0,0,0,4,24,8,16,7,5,0
"20240220REAPOR",2024-02-20,"England League 1","Reading","Port Vale",2,0,"H",20,10,6,2,12,11,4,3,0,0,0,0,0,0,0,2,30,8,23,7,0,0
"20240223WIGCHE",2024-02-23,"England League 1","Wigan","Cheltenham",1,1,"D",9,6,2,2,11,11,6,1,1,0,0,0,0,0,0,2,15,4,22,7,1,0
"20240224CAMPET",2024-02-24,"England League 1","Cambridge","Peterboro",0,1,"A",8,13,4,3,15,12,2,5,4,2,0,0,1,1,0,1,21,7,27,7,6,0
"20240224BARDER",2024-02-24,"England League 1","Barnsley","Derby",2,1,"H",7,12,5,5,11,6,3,10,4,1,0,0,0,0,0,3,19,10,17,13,5,0
"20240224BLABOL",2024-02-24,"England League 1","Blackpool","Bolton",4,1,"H",15,14,8,3,8,13,4,7,1,2,0,1,0,0,0,5,29,11,21,11,3,1
"20240224BRICAR",2024-02-24,"England League 1","Bristol Rvs","Carlisle",2,1,"H",11,13,4,3,9,13,3,7,3,2,0,0,1,0,1,3,24,7,22,10,5,0
"20240224BURNOR",2024-02-24,"England League 1","Burton","Northampton",0,2,"A",16,10,4,4,16,6,6,1,0,2,0,0,0,0,0,2,26,8,22,7,2,0
"20240224CHAPOR",2024-02-24,"England League 1","Charlton","Portsmouth",0,0,"D",5,14,2,3,11,8,4,5,2,0,0,0,0,0,0,0,19,5,19,9,2,0
"20240224EXEFLE",2024-02-24,"England League 1","Exeter","Fleetwood Town",1,1,"D",6,15,2,3,10,7,7,9,4,1,0,0,0,0,0,2,21,5,17,16,5,0
"20240224OXFLEY",2024-02-24,"England League 1","Oxford","Leyton Orient",1,2,"A",12,12,6,7,7,19,5,5,2,6,0,0,0,0,0,3,24,13,26,10,8,0
"20240224PORLIN",2024-02-24,"England League 1","Port Vale","Lincoln",0,2,"A",10,5,4,4,9,7,2,5,4,1,0,0,0,0,0,2,15,8,16,7,5,0
"20240224REASHR",2024-02-24,"England League 1","Reading","Shrewsbury",2,3,"A",14,9,3,5,14,15,7,4,4,5,0,0,0,0,0,5,23,8,29,11,9,0
"20240224STEWYC",2024-02-24,"England League 1","Stevenage","Wycombe",1,0,"H",11,6,4,1,9,15,8,2,1,1,0,1,0,0,0,1,17,5,24,10,2,1
"20240227BURCAR",2024-02-27,"England League 1","Burton","Carlisle",0,1,"A",15,6,4,3,13,11,2,3,0,2,0,0,0,0,0,1,21,7,24,5,2,0
"20240227DERCHA",2024-02-27,"England League 1","Derby","Charlton",1,2,"A",12,7,5,3,11,15,4,5,2,2,0,0,0,0,0,3,19,8,26,9,4,0
"20240227LEYBLA",2024-02-27,"England League 1","Leyton Orient","Blackpool",1,0,"H",12,6,3,0,13,9,2,2,1,2,0,0,0,0,0,1,18,3,22,4,3,0
"20240227LINSHR",2024-02-27,"England League 1","Lincoln","Shrewsbury",3,0,"H",23,6,8,1,10,11,6,5,0,2,0,0,0,0,0,3,29,9,21,11,2,0
"20240227PORFLE",2024-02-27,"England League 1","Port Vale","Fleetwood Town",2,2,"D",7,20,2,6,8,4,3,16,0,2,0,0,0,0,0,4,27,8,12,19,2,0
"20240227STECAM",2024-02-27,"England League 1","Stevenage","Cambridge",1,0,"H",15,7,5,1,10,9,2,2,2,1,0,0,0,0,0,1,22,6,19,4,3,0
"20240227WIGBOL",2024-02-27,"England League 1","Wigan","Bolton",1,0,"H",4,10,2,3,17,15,0,9,3,3,0,0,0,0,0,1,14,5,32,9,6,0
"20240227WYCCHE",2024-02-27,"England League 1","Wycombe","Cheltenham",2,0,"H",25,7,7,0,8,14,7,6,0,1,0,0,0,0,0,2,32,7,22,13,1,0
"20240302BOLCAM",2024-03-02,"England League 1","Bolton","Cambridge",2,0,"H",24,5,11,1,12,10,10,1,4,2,0,0,0,0,0,2,29,12,22,11,6,0
"20240302CARREA",2024-03-02,"England League 1","Carlisle","Reading",1,3,"A",13,11,1,8,6,16,3,5,0,0,0,0,0,0,0,4,24,9,22,8,0,0
"20240302CHEBUR",2024-03-02,"England League 1","Cheltenham","Burton",0,0,"D",8,16,0,2,11,14,1,2,1,4,0,0,0,0,0,0,24,2,25,3,5,0
"20240302DERPOR",2024-03-02,"England League 1","Derby","Port Vale",3,0,"H",20,3,6,0,14,9,7,4,0,2,0,0,0,0,0,3,23,6,23,11,2,0
"20240302FLEWIG",2024-03-02,"England League 1","Fleetwood Town","Wigan",4,2,"H",12,8,6,3,16,9,5,4,0,1,0,0,0,0,0,6,20,9,25,9,1,0
"20240302LEYBRI",2024-03-02,"England League 1","Leyton Orient","Bristol Rvs",0,1,"A",17,3,4,1,12,9,18,2,1,3,0,1,0,0,0,1,20,5,21,20,4,1
"20240302LINSTE",2024-03-02,"England League 1","Lincoln","Stevenage",0,0,"D",13,10,1,2,15,16,5,3,2,3,0,0,0,0,0,0,23,3,31,8,5,0
"20240302NORCHA",2024-03-02,"England League 1","Northampton","Charlton",1,1,"D",10,14,1,4,6,15,3,6,2,2,0,0,0,0,0,2,24,5,21,9,4,0
"20240302PETEXE",2024-03-02,"England League 1","Peterboro","Exeter",2,1,"H",18,11,7,1,5,12,9,6,0,5,0,0,0,0,0,3,29,8,17,15,5,0
"20240302POROXF",2024-03-02,"England League 1","Portsmouth","Oxford",2,1,"H",11,18,5,4,19,16,5,7,4,3,0,0,0,0,0,3,29,9,35,12,7,0
"20240302SHRBLA",2024-03-02,"England League 1","Shrewsbury","Blackpool",0,2,"A",8,12,1,6,14,7,4,6,2,1,0,0,0,0,0,2,20,7,21,10,3,0
"20240302WYCBAR",2024-03-02,"England League 1","Wycombe","Barnsley",2,4,"A",10,15,4,7,10,5,3,6,3,3,1,0,1,1,0,6,25,11,15,9,6,1
"20240305BARBOL",2024-03-05,"England League 1","Barnsley","Bolton",2,2,"D",9,20,6,8,14,10,3,6,2,3,0,0,0,0,0,4,29,14,24,9,5,0
"20240305CHECHA",2024-03-05,"England League 1","Cheltenham","Charlton",1,3,"A",19,16,5,5,2,7,2,9,0,2,0,0,1,1,0,4,35,10,9,11,2,0
"20240305PETNOR",2024-03-05,"England League 1","Peterboro","Northampton",5,1,"H",16,5,6,1,3,11,4,2,1,1,0,0,0,0,0,6,21,7,14,6,2,0
"20240309BARLIN",2024-03-09,"England League 1","Barnsley","Lincoln",1,5,"A",13,17,4,10,10,17,7,2,3,2,0,0,0,0,0,6,30,14,27,9,5,0
"20240309BLAPOR",2024-03-09,"England League 1","Blackpool","Portsmouth",0,0,"D",5,11,0,5,10,14,1,6,1,4,1,0,0,0,0,0,16,5,24,7,5,1
"20240309BRIDER",2024-03-09,"England League 1","Bristol Rvs","Derby",0,3,"A",6,15,3,5,12,9,6,4,2,2,0,0,0,0,0,3,21,8,21,10,4,0
"20240309BURPET",2024-03-09,"England League 1","Burton","Peterboro",1,3,"A",12,14,2,7,11,5,3,3,2,1,0,0,0,0,0,4,26,9,16,6,3,0
"20240309CAMNOR",2024-03-09,"England League 1","Cambridge","Northampton",1,1,"D",4,8,1,4,14,9,0,8,1,0,0,0,0,0,0,2,12,5,23,8,1,0
"20240309CHACAR",2024-03-09,"England League 1","Charlton","Carlisle",3,2,"H",17,6,8,2,8,4,6,2,2,1,0,0,0,0,0,5,23,10,12,8,3,0
"20240309EXEBOL",2024-03-09,"England League 1","Exeter","Bolton",2,2,"D",11,13,7,5,14,9,4,9,2,0,0,0,1,1,0,4,24,12,23,13,2,0
"20240309OXFCHE",2024-03-09,"England League 1","Oxford","Cheltenham",2,1,"H",17,10,8,3,6,16,4,3,1,3,0,0,0,0,0,3,27,11,22,7,4,0
"20240309PORSHR",2024-03-09,"England League 1","Port Vale","Shrewsbury",1,2,"A",16,8,3,2,12,14,8,7,3,2,0,0,0,0,0,3,24,5,26,15,5,0
"20240309REAWYC",2024-03-09,"England League 1","Reading","Wycombe",1,2,"A",15,10,5,3,12,11,9,5,2,2,0,0,1,0,1,3,25,8,23,14,4,0
"20240309STEFLE",2024-03-09,"England League 1","Stevenage","Fleetwood Town",0,0,"D",12,4,3,1,15,14,7,1,1,2,0,1,0,0,0,0,16,4,29,8,3,1
"20240309WIGLEY",2024-03-09,"England League 1","Wigan","Leyton Orient",1,0,"H",10,10,3,1,7,12,6,2,1,1,0,1,0,0,0,1,20,4,19,8,2,1
"20240312CARBAR",2024-03-12,"England League 1","Carlisle","Barnsley",2,3,"A",7,24,5,6,5,9,6,9,0,3,0,0,0,0,0,5,31,11,14,15,3,0
"20240312DERREA",2024-03-12,"England League 1","Derby","Reading",2,1,"H",18,5,7,1,11,17,7,2,3,4,0,1,0,0,0,3,23,8,28,9,7,1
"20240312FLEBRI",2024-03-12,"England League 1","Fleetwood Town","Bristol Rvs",0,0,"D",14,14,2,6,9,13,4,9,2,2,0,0,0,0,0,0,28,8,22,13,4,0
"20240312LEYPOR",2024-03-12,"England League 1","Leyton Orient","Port Vale",0,0,"D",7,10,2,2,9,4,9,2,0,1,0,0,0,0,0,0,17,4,13,11,1,0
"20240312LINCAM",2024-03-12,"England League 1","Lincoln","Cambridge",6,0,"H",18,13,9,4,11,8,10,5,2,2,0,0,0,0,0,6,31,13,19,15,4,0
"20240312NORBLA",2024-03-12,"England League 1","Northampton","Blackpool",0,1,"A",8,11,2,5,13,9,9,2,1,0,0,0,0,0,0,1,19,7,22,11,1,0
"20240312PORBUR",2024-03-12,"England League 1","Portsmouth","Burton",2,1,"H",13,8,3,1,11,17,5,3,0,5,0,0,0,0,0,3,21,4,28,8,5,0
"20240312SHREXE",2024-03-12,"England League 1","Shrewsbury","Exeter",0,3,"A",6,13,1,6,4,14,0,5,3,3,1,0,0,0,0,3,19,7,18,5,6,1
"20240312WYCWIG",2024-03-12,"England League 1","Wycombe","Wigan",1,0,"H",5,15,1,5,4,10,1,11,2,1,0,0,0,0,0,1,20,6,14,12,3,0
"20240312BOLOXF",2024-03-12,"England League 1","Bolton","Oxford",5,0,"H",20,4,8,0,9,17,6,1,0,3,0,0,0,0,0,5,24,8,26,7,3,0
"20240313PETSTE",2024-03-13,"England League 1","Peterboro","Stevenage",3,1,"H",6,11,4,3,8,12,1,6,1,0,0,0,0,0,0,4,17,7,20,7,1,0
"20240316BARCHE",2024-03-16,"England League 1","Barnsley","Cheltenham",0,0,"D",18,7,4,2,8,10,10,5,1,1,0,0,0,0,0,0,25,6,18,15,2,0
"20240316DERBOL",2024-03-16,"England League 1","Derby","Bolton",1,0,"H",10,6,3,3,9,13,6,6,1,1,0,0,0,0,0,1,16,6,22,12,2,0
"20240316EXEBUR",2024-03-16,"England League 1","Exeter","Burton",1,0,"H",9,15,2,2,15,13,2,5,4,3,1,0,0,0,0,1,24,4,28,7,7,1
"20240316FLECHA",2024-03-16,"England League 1","Fleetwood Town","Charlton",1,1,"D",17,13,7,7,13,7,10,6,3,1,0,0,0,0,0,2,30,14,20,16,4,0
"20240316LINBRI",2024-03-16,"England League 1","Lincoln","Bristol Rvs",5,0,"H",18,16,7,6,11,13,8,4,2,1,1,0,1,0,1,5,34,13,24,12,3,1
"20240316PETPOR",2024-03-16,"England League 1","Peterboro","Portsmouth",0,1,"A",15,16,1,4,14,10,8,5,1,2,0,0,0,0,0,1,31,5,24,13,3,0
"20240316POROXF",2024-03-16,"England League 1","Port Vale","Oxford",0,2,"A",8,14,0,6,14,12,3,7,2,0,0,0,0,0,0,2,22,6,26,10,2,0
"20240316REACAM",2024-03-16,"England League 1","Reading","Cambridge",4,0,"H",16,8,8,2,9,10,7,4,0,1,0,0,0,0,0,4,24,10,19,11,1,0
"20240316SHRCAR",2024-03-16,"England League 1","Shrewsbury","Carlisle",1,0,"H",16,9,6,3,8,5,7,3,1,2,0,0,0,0,0,1,25,9,13,10,3,0
"20240316STELEY",2024-03-16,"England League 1","Stevenage","Leyton Orient",0,1,"A",9,6,2,2,8,19,5,2,1,2,0,0,0,0,0,1,15,4,27,7,3,0
"20240316WIGBLA",2024-03-16,"England League 1","Wigan","Blackpool",1,0,"H",4,11,1,3,14,8,2,3,3,2,0,0,0,0,0,1,15,4,22,5,5,0
"20240316WYCNOR",2024-03-16,"England League 1","Wycombe","Northampton",2,0,"H",15,6,8,4,10,8,6,1,1,3,0,0,0,0,0,2,21,12,18,7,4,0
"20240323BURPOR",2024-03-23,"England League 1","Burton","Port Vale",0,1,"A",12,16,2,5,12,11,6,6,2,0,0,0,0,0,0,1,28,7,23,12,2,0
"20240323CARSTE",2024-03-23,"England League 1","Carlisle","Stevenage",2,2,"D",8,16,4,3,13,7,1,14,4,2,0,0,0,0,0,4,24,7,20,15,6,0
"20240323NORDER",2024-03-23,"England League 1","Northampton","Derby",1,0,"H",10,14,3,4,10,8,3,7,2,2,0,1,0,0,0,1,24,7,18,10,4,1
"20240329BARCAM",2024-03-29,"England League 1","Barnsley","Cambridge",0,2,"A",17,7,3,4,8,9,0,3,2,2,0,0,0,0,0,2,24,7,17,3,4,0
"20240329DERBLA",2024-03-29,"England League 1","Derby","Blackpool",1,0,"H",9,12,3,1,15,11,9,2,1,3,0,0,0,0,0,1,21,4,26,11,4,0
"20240329EXECHA",2024-03-29,"England League 1","Exeter","Charlton",1,1,"D",9,17,2,6,7,9,11,2,1,1,0,0,0,0,0,2,26,8,16,13,2,0
"20240329FLECHE",2024-03-29,"England League 1","Fleetwood Town","Cheltenham",1,2,"A",15,13,4,3,13,9,3,3,1,2,0,0,0,0,0,3,28,7,22,6,3,0
"20240329LINLEY",2024-03-29,"England League 1","Lincoln","Leyton Orient",1,0,"H",5,14,2,5,7,17,2,5,1,3,0,0,0,0,0,1,19,7,24,7,4,0
"20240329PETCAR",2024-03-29,"England League 1","Peterboro","Carlisle",1,3,"A",23,12,2,5,3,9,4,3,0,2,0,0,0,0,0,4,35,7,12,7,2,0
"20240329PORBRI",2024-03-29,"England League 1","Port Vale","Bristol Rvs",2,0,"H",19,2,11,0,6,8,7,6,0,2,0,0,0,0,0,2,21,11,14,13,2,0
"20240329REANOR",2024-03-29,"England League 1","Reading","Northampton",1,0,"H",13,19,2,8,11,8,5,3,1,1,0,0,0,0,0,1,32,10,19,8,2,0
"20240329SHROXF",2024-03-29,"England League 1","Shrewsbury","Oxford",1,1,"D",15,20,3,4,9,4,11,6,4,0,0,0,0,0,0,2,35,7,13,17,4,0
"20240329STEBOL",2024-03-29,"England League 1","Stevenage","Bolton",0,0,"D",14,10,3,4,13,11,8,4,0,2,0,0,0,0,0,0,24,7,24,12,2,0
"20240329WIGBUR",2024-03-29,"England League 1","Wigan","Burton",1,1,"D",13,15,5,4,15,16,6,6,1,3,0,0,0,0,0,2,28,9,31,12,4,0
"20240329WYCPOR",2024-03-29,"England League 1","Wycombe","Portsmouth",1,3,"A",9,16,2,11,16,8,4,3,2,3,0,0,0,0,0,4,25,13,24,7,5,0
"20240401BLAWYC",2024-04-01,"England League 1","Blackpool","Wycombe",0,0,"D",12,8,5,1,14,16,4,1,2,1,0,0,0,0,0,0,20,6,30,5,3,0
"20240401BOLREA",2024-04-01,"England League 1","Bolton","Reading",5,2,"H",18,18,8,7,9,5,13,3,2,0,0,0,0,0,0,7,36,15,14,16,2,0
"20240401BRISHR",2024-04-01,"England League 1","Bristol Rvs","Shrewsbury",0,0,"D",13,10,4,1,14,15,5,4,1,3,0,0,0,0,0,0,23,5,29,9,4,0
"20240401BURBAR",2024-04-01,"England League 1","Burton","Barnsley",1,3,"A",12,14,2,3,10,7,5,3,0,0,0,0,0,0,0,4,26,5,17,8,0,0
"20240401CAMWIG",2024-04-01,"England League 1","Cambridge","Wigan",3,1,"H",8,12,3,3,10,14,0,4,2,2,0,0,0,0,0,4,20,6,24,4,4,0
"20240401CARLIN",2024-04-01,"England League 1","Carlisle","Lincoln",1,3,"A",19,11,7,5,14,12,10,3,2,0,0,0,0,0,0,4,30,12,26,13,2,0
"20240401CHASTE",2024-04-01,"England League 1","Charlton","Stevenage",0,0,"D",10,14,3,3,12,9,1,2,1,2,0,0,0,0,0,0,24,6,21,3,3,0
"20240401CHEEXE",2024-04-01,"England League 1","Cheltenham","Exeter",1,2,"A",14,14,2,4,19,12,6,5,5,1,0,0,0,0,0,3,28,6,31,11,6,0
"20240401LEYPET",2024-04-01,"England League 1","Leyton Orient","Peterboro",1,2,"A",11,19,3,7,18,8,7,2,1,0,0,0,1,1,0,3,30,10,26,9,1,0
"20240401NORPOR",2024-04-01,"England League 1","Northampton","Port Vale",2,0,"H",8,13,3,4,9,9,2,2,2,2,0,0,0,0,0,2,21,7,18,4,4,0
"20240401OXFFLE",2024-04-01,"England League 1","Oxford","Fleetwood Town",4,0,"H",23,12,13,4,10,9,7,3,0,2,0,0,0,0,0,4,35,17,19,10,2,0
"20240402PORDER",2024-04-02,"England League 1","Portsmouth","Derby",2,2,"D",10,12,4,4,13,11,6,0,2,1,0,0,0,0,0,4,22,8,24,6,3,0
"20240406BLACAM",2024-04-06,"England League 1","Blackpool","Cambridge",1,0,"H",11,3,3,1,12,11,7,3,0,2,0,0,0,0,0,1,14,4,23,10,2,0
"20240406BRIBOL",2024-04-06,"England League 1","Bristol Rvs","Bolton",0,2,"A",13,9,6,4,15,11,5,5,6,2,0,0,0,0,0,2,22,10,26,10,8,0
"20240406BUROXF",2024-04-06,"England League 1","Burton","Oxford",0,4,"A",9,18,2,8,16,7,6,2,2,0,0,0,0,0,0,4,27,10,23,8,2,0
"20240406CHABAR",2024-04-06,"England League 1","Charlton","Barnsley",2,1,"H",15,13,4,3,13,7,7,5,4,4,0,0,0,0,0,3,28,7,20,12,8,0
"20240406EXESTE",2024-04-06,"England League 1","Exeter","Stevenage",1,0,"H",8,12,4,3,14,17,2,7,3,4,0,0,0,0,0,1,20,7,31,9,7,0
"20240406LEYCHE",2024-04-06,"England League 1","Leyton Orient","Cheltenham",3,1,"H",16,12,5,4,10,9,6,5,3,1,0,0,0,0,0,4,28,9,19,11,4,0
"20240406NORCAR",2024-04-06,"England League 1","Northampton","Carlisle",2,0,"H",9,8,4,2,9,9,5,7,0,0,0,0,0,0,0,2,17,6,18,12,0,0
"20240406PORSHR",2024-04-06,"England League 1","Portsmouth","Shrewsbury",3,1,"H",7,12,4,3,15,13,5,2,2,3,0,0,0,0,0,4,19,7,28,7,5,0
"20240406REALIN",2024-04-06,"England League 1","Reading","Lincoln",1,1,"D",11,4,3,3,12,13,3,2,2,0,0,0,0,0,0,2,15,6,25,5,2,0
"20240406WIGPOR",2024-04-06,"England League 1","Wigan","Port Vale",0,0,"D",13,13,2,4,7,10,4,6,2,1,0,0,0,0,0,0,26,6,17,10,3,0
"20240409BLAFLE",2024-04-09,"England League 1","Blackpool","Fleetwood Town",1,0,"H",21,15,9,3,5,13,5,6,2,3,0,0,0,0,0,1,36,12,18,11,5,0
"20240409BRIREA",2024-04-09,"England League 1","Bristol Rvs","Reading",0,2,"A",8,17,3,7,13,14,1,7,2,0,0,0,0,0,0,2,25,10,27,8,2,0
"20240409CHAWIG",2024-04-09,"England League 1","Charlton","Wigan",2,2,"D",20,10,7,3,17,13,4,1,2,1,0,0,0,0,0,4,30,10,30,5,3,0
"20240409CHECAR",2024-04-09,"England League 1","Cheltenham","Carlisle",0,1,"A",5,13,0,4,14,11,2,3,0,3,0,0,0,0,0,1,18,4,25,5,3,0
"20240409LEYEXE",2024-04-09,"England League 1","Leyton Orient","Exeter",2,2,"D",3,16,2,5,8,7,3,11,0,0,0,0,0,0,0,4,19,7,15,14,0,0
"20240409STEBAR",2024-04-09,"England League 1","Stevenage","Barnsley",2,1,"H",18,10,8,2,11,11,10,7,2,2,0,0,0,0,0,3,28,10,22,17,4,0
"20240410PETPOR",2024-04-10,"England League 1","Peterboro","Port Vale",3,0,"H",16,3,7,1,8,12,13,1,1,3,0,0,0,0,0,3,19,8,20,14,4,0
"20240410WYCDER",2024-04-10,"England League 1","Wycombe","Derby",0,0,"D",10,7,3,0,14,10,6,7,1,1,0,0,0,0,0,0,17,3,24,13,2,0
"20240413BARREA",2024-04-13,"England League 1","Barnsley","Reading",2,2,"D",23,22,9,5,8,9,5,7,1,0,0,0,0,0,0,4,45,14,17,12,1,0
"20240413BOLPOR",2024-04-13,"England League 1","Bolton","Portsmouth",1,1,"D",19,5,5,1,14,19,6,0,3,1,0,0,0,0,0,2,24,6,33,6,4,0
"20240413CAMCHA",2024-04-13,"England League 1","Cambridge","Charlton",1,1,"D",8,21,4,5,7,14,0,9,0,2,0,0,0,0,0,2,29,9,21,9,2,0
"20240413CARBLA",2024-04-13,"England League 1","Carlisle","Blackpool",0,1,"A",5,14,1,2,9,8,3,12,1,0,0,0,0,0,0,1,19,3,17,15,1,0
"20240413CHEBRI",2024-04-13,"England League 1","Cheltenham","Bristol Rvs",1,3,"A",9,9,4,5,19,11,2,2,3,1,0,0,0,0,0,4,18,9,30,4,4,0
"20240413DERLEY",2024-04-13,"England League 1","Derby","Leyton Orient",3,0,"H",13,6,3,0,8,13,11,4,1,1,0,0,0,0,0,3,19,3,21,15,2,0
"20240413FLENOR",2024-04-13,"England League 1","Fleetwood Town","Northampton",2,0,"H",14,8,7,1,15,8,6,2,3,2,0,0,0,0,0,2,22,8,23,8,5,0
"20240413LINWIG",2024-04-13,"England League 1","Lincoln","Wigan",1,2,"A",14,12,3,5,12,14,2,6,6,5,0,0,0,0,0,3,26,8,26,8,11,0
"20240413OXFPET",2024-04-13,"England League 1","Oxford","Peterboro",5,0,"H",15,15,6,1,5,5,3,6,0,0,0,0,0,0,0,5,30,7,10,9,0,0
"20240413POREXE",2024-04-13,"England League 1","Port Vale","Exeter",2,4,"A",8,13,3,6,11,13,4,10,1,4,0,0,0,0,0,6,21,9,24,14,5,0
"20240413SHRWYC",2024-04-13,"England League 1","Shrewsbury","Wycombe",0,2,"A",5,8,1,3,13,6,4,4,1,0,1,0,0,0,0,2,13,4,19,8,1,1
"20240413STEBUR",2024-04-13,"England League 1","Stevenage","Burton",1,2,"A",13,7,6,4,9,15,7,4,2,3,1,0,0,0,0,3,20,10,24,11,5,1
"20240416BOLSHR",2024-04-16,"England League 1","Bolton","Shrewsbury",2,2,"D",25,8,13,3,4,9,12,5,0,2,0,0,0,0,0,4,33,16,13,17,2,0
"20240416BRICAM",2024-04-16,"England League 1","Bristol Rvs","Cambridge",1,0,"H",15,12,5,2,8,8,4,6,0,0,0,0,0,0,0,1,27,7,16,10,0,0
"20240416BURCHE",2024-04-16,"England League 1","Burton","Cheltenham",1,2,"A",5,9,1,2,19,9,4,4,3,1,0,0,0,0,0,3,14,3,28,8,4,0
"20240416OXFLIN",2024-04-16,"England League 1","Oxford","Lincoln",0,1,"A",17,8,5,3,12,16,8,3,4,6,0,1,0,0,0,1,25,8,28,11,10,1
"20240416PETFLE",2024-04-16,"England League 1","Peterboro","Fleetwood Town",4,1,"H",14,10,7,7,9,7,7,4,0,0,0,0,0,0,0,5,24,14,16,11,0,0
"20240416PORWYC",2024-04-16,"England League 1","Port Vale","Wycombe",1,2,"A",18,11,4,4,12,11,6,3,2,2,0,0,0,0,0,3,29,8,23,9,4,0
"20240416PORBAR",2024-04-16,"England League 1","Portsmouth","Barnsley",3,2,"H",14,14,4,5,15,10,3,3,1,1,0,0,0,0,0,5,28,9,25,6,2,0
"20240419OXFSTE",2024-04-19,"England League 1","Oxford","Stevenage",1,1,"D",25,2,6,0,9,17,8,5,0,3,0,0,0,0,0,2,27,6,26,13,3,0
"20240420NOREXE",2024-04-20,"England League 1","Northampton","Exeter",1,2,"A",20,9,7,3,12,9,10,2,1,0,0,1,0,0,0,3,29,10,21,12,1,1
"20240420BLABAR",2024-04-20,"England League 1","Blackpool","Barnsley",3,2,"H",19,11,7,5,12,17,11,5,2,3,0,0,0,0,0,5,30,12,29,16,5,0
"20240420BOLPOR",2024-04-20,"England League 1","Bolton","Port Vale",2,0,"H",27,9,7,3,12,11,6,3,3,1,0,0,0,0,0,2,36,10,23,9,4,0
"20240420BRIPET",2024-04-20,"England League 1","Bristol Rvs","Peterboro",0,2,"A",8,12,4,5,8,7,4,4,2,1,0,0,0,0,0,2,20,9,15,8,3,0
"20240420BURREA",2024-04-20,"England League 1","Burton","Reading",3,2,"H",10,12,7,4,13,6,4,9,2,0,0,0,0,0,0,5,22,11,19,13,2,0
"20240420CAMDER",2024-04-20,"England League 1","Cambridge","Derby",0,1,"A",8,15,3,4,8,10,3,7,2,2,0,0,0,0,0,1,23,7,18,10,4,0
"20240420CARWYC",2024-04-20,"England League 1","Carlisle","Wycombe",1,3,"A",11,16,4,3,12,16,3,2,2,1,0,0,0,0,0,4,27,7,28,5,3,0
"20240420CHASHR",2024-04-20,"England League 1","Charlton","Shrewsbury",1,1,"D",10,11,2,3,8,8,1,4,1,0,0,0,0,0,0,2,21,5,16,5,1,0
"20240420CHELIN",2024-04-20,"England League 1","Cheltenham","Lincoln",1,2,"A",10,19,4,7,13,14,3,9,4,0,0,0,3,3,0,3,29,11,27,12,4,0
"20240420LEYFLE",2024-04-20,"England League 1","Leyton Orient","Fleetwood Town",0,1,"A",12,14,5,8,14,6,8,5,0,1,0,0,0,0,0,1,26,13,20,13,1,0
"20240420PORWIG",2024-04-20,"England League 1","Portsmouth","Wigan",1,2,"A",22,11,8,3,14,12,4,3,2,1,0,0,0,0,0,3,33,11,26,7,3,0
"20240423CAMWYC",2024-04-23,"England League 1","Cambridge","Wycombe",1,1,"D",11,17,2,6,13,13,6,7,2,0,0,0,0,0,0,2,28,8,26,13,2,0
"20240423CHEPET",2024-04-23,"England League 1","Cheltenham","Peterboro",2,0,"H",25,9,8,3,18,9,7,4,1,0,0,0,2,2,0,2,34,11,27,11,1,0
"20240427BARNOR",2024-04-27,"England League 1","Barnsley","Northampton",1,1,"D",7,9,4,2,11,7,3,8,3,1,0,0,0,0,0,2,16,6,18,11,4,0
"20240427DERCAR",2024-04-27,"England League 1","Derby","Carlisle",2,0,"H",7,10,3,2,12,10,1,7,0,1,0,0,0,0,0,2,17,5,22,8,1,0
"20240427EXEOXF",2024-04-27,"England League 1","Exeter","Oxford",1,2,"A",10,15,1,5,20,9,8,2,2,2,0,0,0,0,0,3,25,6,29,10,4,0
"20240427FLEBUR",2024-04-27,"England League 1","Fleetwood Town","Burton",3,0,"H",15,13,7,3,9,10,4,5,0,4,0,0,0,0,0,3,28,10,19,9,4,0
"20240427LINPOR",2024-04-27,"England League 1","Lincoln","Portsmouth",0,2,"A",12,11,2,6,14,14,6,4,3,7,0,0,1,0,1,2,23,8,28,10,10,0
"20240427PETBOL",2024-04-27,"England League 1","Peterboro","Bolton",3,3,"D",15,11,6,4,17,17,10,4,1,3,0,0,0,0,0,6,26,10,34,14,4,0
"20240427PORCAM",2024-04-27,"England League 1","Port Vale","Cambridge",0,0,"D",9,8,4,2,8,16,4,3,2,4,0,0,0,0,0,0,17,6,24,7,6,0
"20240427REABLA",2024-04-27,"England League 1","Reading","Blackpool",3,2,"H",18,10,6,6,8,11,6,2,1,0,0,0,0,0,0,5,28,12,19,8,1,0
"20240427SHRLEY",2024-04-27,"England League 1","Shrewsbury","Leyton Orient",1,3,"A",19,7,7,3,9,9,9,1,0,0,0,0,0,0,0,4,26,10,18,10,0,0
"20240427STECHE",2024-04-27,"England League 1","Stevenage","Cheltenham",2,1,"H",16,20,7,6,16,17,9,10,2,3,0,0,3,2,1,3,36,13,33,19,5,0
"20240427WIGBRI",2024-04-27,"England League 1","Wigan","Bristol Rvs",2,0,"H",18,4,9,0,5,13,7,4,0,1,0,0,0,0,0,2,22,9,18,11,1,0
"20240427WYCCHA",2024-04-27,"England League 1","Wycombe","Charlton",1,0,"H",11,9,4,1,12,12,4,5,2,5,0,0,0,0,0,1,20,5,24,9,7,0
"20240809BARMAN",2024-08-09,"England League 1","Barnsley","Mansfield",1,2,"A",20,8,4,4,14,16,3,6,1,3,0,0,0,0,0,3,28,8,30,9,4,0
"20240810BIRREA",2024-08-10,"England League 1","Birmingham","Reading",1,1,"D",13,8,5,4,11,18,3,6,0,1,0,0,0,0,0,2,21,9,29,9,1,0
"20240810BRINOR",2024-08-10,"England League 1","Bristol Rvs","Northampton",1,0,"H",12,6,5,1,11,13,6,6,1,2,0,0,0,0,0,1,18,6,24,12,3,0
"20240810BURLIN",2024-08-10,"England League 1","Burton","Lincoln",2,3,"A",11,7,5,3,12,11,4,4,1,2,0,0,0,0,0,5,18,8,23,8,3,0
"20240810CRABLA",2024-08-10,"England League 1","Crawley Town","Blackpool",2,1,"H",11,19,4,5,15,9,2,10,4,2,0,0,0,0,0,3,30,9,24,12,6,0
"20240810EXEROT",2024-08-10,"England League 1","Exeter","Rotherham",1,0,"H",15,13,7,2,11,11,2,4,2,1,0,0,0,0,0,1,28,9,22,6,3,0
"20240810LEYBOL",2024-08-10,"England League 1","Leyton Orient","Bolton",1,2,"A",11,8,5,3,18,11,7,2,4,0,0,0,0,0,0,3,19,8,29,9,4,0
"20240810PETHUD",2024-08-10,"England League 1","Peterboro","Huddersfield",0,2,"A",8,17,2,5,7,17,3,10,1,1,0,0,0,0,0,2,25,7,24,13,2,0
"20240810STESHR",2024-08-10,"England League 1","Stevenage","Shrewsbury",1,0,"H",13,4,4,1,15,17,4,1,1,4,0,0,0,0,0,1,17,5,32,5,5,0
"20240810STOCAM",2024-08-10,"England League 1","Stockport","Cambridge",2,0,"H",20,11,6,2,15,15,5,3,4,2,0,0,0,0,0,2,31,8,30,8,6,0
"20240810WIGCHA",2024-08-10,"England League 1","Wigan","Charlton",0,1,"A",13,4,1,3,7,19,7,6,1,1,0,0,0,0,0,1,17,4,26,13,2,0
"20240810WREWYC",2024-08-10,"England League 1","Wrexham","Wycombe",3,2,"H",14,16,6,3,13,7,5,7,3,1,0,0,0,0,0,5,30,9,20,12,4,0
"20240817CHALEY",2024-08-17,"England League 1","Charlton","Leyton Orient",1,0,"H",10,8,4,2,10,13,9,2,1,4,0,0,1,0,1,1,18,6,23,11,5,0
"20240817SHRPET",2024-08-17,"England League 1","Shrewsbury","Peterboro",1,4,"A",10,18,4,11,15,12,3,7,3,0,0,0,0,0,0,5,28,15,27,10,3,0
"20240817BLASTO",2024-08-17,"England League 1","Blackpool","Stockport",0,3,"A",10,11,0,5,16,13,3,2,3,1,0,0,0,0,0,3,21,5,29,5,4,0
"20240817CAMCRA",2024-08-17,"England League 1","Cambridge","Crawley Town",0,1,"A",14,11,6,3,12,14,2,5,4,4,0,0,0,0,0,1,25,9,26,7,8,0
"20240817HUDSTE",2024-08-17,"England League 1","Huddersfield","Stevenage",2,1,"H",15,7,4,3,12,12,8,4,4,2,0,0,0,0,0,3,22,7,24,12,6,0
"20240817LINBAR",2024-08-17,"England League 1","Lincoln","Barnsley",1,2,"A",14,6,7,3,8,16,4,7,0,2,0,0,0,0,0,3,20,10,24,11,2,0
"20240817MANBUR",2024-08-17,"England League 1","Mansfield","Burton",3,3,"D",18,22,7,7,6,8,5,7,1,3,0,0,1,1,0,6,40,14,14,12,4,0
"20240817NOREXE",2024-08-17,"England League 1","Northampton","Exeter",2,1,"H",15,15,6,5,10,14,3,8,2,2,0,0,0,0,0,3,30,11,24,11,4,0
"20240817REAWIG",2024-08-17,"England League 1","Reading","Wigan",2,0,"H",22,6,8,2,11,14,6,5,0,3,0,0,0,0,0,2,28,10,25,11,3,0
"20240817ROTBRI",2024-08-17,"England League 1","Rotherham","Bristol Rvs",0,0,"D",20,5,5,1,8,20,5,0,3,2,0,0,0,0,0,0,25,6,28,5,5,0
"20240817WYCBIR",2024-08-17,"England League 1","Wycombe","Birmingham",2,3,"A",8,13,2,7,13,13,1,9,3,2,0,0,0,0,0,5,21,9,26,10,5,0
"20240818BOLWRE",2024-08-18,"England League 1","Bolton","Wrexham",0,0,"D",11,7,8,2,11,12,8,8,2,1,0,0,0,0,0,0,18,10,23,16,3,0
"20240824BURSTE",2024-08-24,"England League 1","Burton","Stevenage",0,0,"D",5,11,0,6,13,16,3,5,3,5,0,0,0,0,0,0,16,6,29,8,8,0
"20240824STOBRI",2024-08-24,"England League 1","Stockport","Bristol Rvs",2,0,"H",18,11,8,3,12,7,8,4,0,3,0,0,0,0,0,2,29,11,19,12,3,0
"20240824BARNOR",2024-08-24,"England League 1","Barnsley","Northampton",2,2,"D",15,12,5,5,15,11,2,3,2,0,0,0,0,0,0,4,27,10,26,5,2,0
"20240824CAMBLA",2024-08-24,"England League 1","Cambridge","Blackpool",4,4,"D",9,12,6,7,15,11,2,10,2,4,0,0,0,0,0,8,21,13,26,12,6,0
"20240824CHABOL",2024-08-24,"England League 1","Charlton","Bolton",2,0,"H",6,13,4,3,14,9,3,3,3,3,0,0,0,0,0,2,19,7,23,6,6,0
"20240824EXEPET",2024-08-24,"England League 1","Exeter","Peterboro",1,2,"A",14,13,2,8,19,9,11,5,1,3,0,0,0,0,0,3,27,10,28,16,4,0
"20240824HUDSHR",2024-08-24,"England League 1","Huddersfield","Shrewsbury",1,0,"H",12,9,5,3,12,11,5,2,1,0,0,0,0,0,0,1,21,8,23,7,1,0
"20240824LEYBIR",2024-08-24,"England League 1","Leyton Orient","Birmingham",1,2,"A",11,11,3,3,18,7,6,5,2,2,0,0,1,1,0,3,22,6,25,11,4,0
"20240824LINMAN",2024-08-24,"England League 1","Lincoln","Mansfield",4,1,"H",16,10,8,3,10,12,8,3,3,3,0,0,0,0,0,5,26,11,22,11,6,0
"20240824WIGCRA",2024-08-24,"England League 1","Wigan","Crawley Town",1,0,"H",2,14,1,3,14,7,4,9,2,2,0,0,0,0,0,1,16,4,21,13,4,0
"20240824WREREA",2024-08-24,"England League 1","Wrexham","Reading",3,0,"H",12,14,7,1,16,8,2,3,0,2,0,0,0,0,0,3,26,8,24,5,2,0
"20240824WYCROT",2024-08-24,"England League 1","Wycombe","Rotherham",2,0,"H",11,19,6,8,10,7,4,8,1,2,0,0,0,0,0,2,30,14,17,12,3,0
"20240831BLAWYC",2024-08-31,"England League 1","Blackpool","Wycombe",2,2,"D",21,12,9,5,16,14,6,1,2,1,0,0,0,0,0,4,33,14,30,7,3,0
"20240831ROTHUD",2024-08-31,"England League 1","Rotherham","Huddersfield",2,1,"H",15,11,5,2,13,11,17,3,2,3,0,1,0,0,0,3,26,7,24,20,5,1
"20240831BIRWIG",2024-08-31,"England League 1","Birmingham","Wigan",2,1,"H",16,11,8,5,8,22,7,3,0,3,0,0,0,0,0,3,27,13,30,10,3,0
"20240831BOLEXE",2024-08-31,"England League 1","Bolton","Exeter",0,2,"A",21,6,3,2,11,21,5,7,3,5,0,0,0,0,0,2,27,5,32,12,8,0
"20240831BRICAM",2024-08-31,"England League 1","Bristol Rvs","Cambridge",2,0,"H",13,9,3,1,15,5,5,8,1,1,0,0,0,0,0,2,22,4,20,13,2,0
"20240831CRABAR",2024-08-31,"England League 1","Crawley Town","Barnsley",0,3,"A",0,7,0,5,2,3,6,9,2,2,0,0,0,0,0,3,7,5,5,15,4,0
"20240831MANSTO",2024-08-31,"England League 1","Mansfield","Stockport",1,1,"D",4,13,2,6,15,7,2,6,0,1,0,0,0,0,0,2,17,8,22,8,1,0
"20240831NORBUR",2024-08-31,"England League 1","Northampton","Burton",0,0,"D",8,13,5,3,11,9,3,4,3,3,0,0,0,0,0,0,21,8,20,7,6,0
"20240831PETWRE",2024-08-31,"England League 1","Peterboro","Wrexham",0,2,"A",6,11,0,3,11,15,2,5,1,2,0,0,0,0,0,2,17,3,26,7,3,0
"20240831REACHA",2024-08-31,"England League 1","Reading","Charlton",2,0,"H",13,8,3,2,11,11,5,5,4,3,0,0,0,0,0,2,21,5,22,10,7,0
"20240831SHRLEY",2024-08-31,"England League 1","Shrewsbury","Leyton Orient",3,0,"H",9,6,4,1,16,14,1,2,2,1,0,0,0,0,0,3,15,5,30,3,3,0
"20240831STELIN",2024-08-31,"England League 1","Stevenage","Lincoln",0,1,"A",7,3,1,1,17,22,5,2,3,3,0,1,0,0,0,1,10,2,39,7,6,1
"20240907BARBRI",2024-09-07,"England League 1","Barnsley","Bristol Rvs",2,1,"H",16,8,8,2,16,8,12,5,4,0,0,0,0,0,0,3,24,10,24,17,4,0
"20240907CHAROT",2024-09-07,"England League 1","Charlton","Rotherham",1,1,"D",9,12,1,4,8,6,2,3,1,0,0,0,0,0,0,2,21,5,14,5,1,0
"20240907WRESHR",2024-09-07,"England League 1","Wrexham","Shrewsbury",3,0,"H",15,9,6,3,12,15,5,7,3,4,0,0,0,0,0,3,24,9,27,12,7,0
"20240914MANCAM",2024-09-14,"England League 1","Mansfield","Cambridge",2,1,"H",15,16,6,5,13,11,3,4,1,3,0,0,0,0,0,3,31,11,24,7,4,0
"20240914NORWYC",2024-09-14,"England League 1","Northampton","Wycombe",1,2,"A",5,14,3,4,10,11,5,2,2,4,0,0,0,0,0,3,19,7,21,7,6,0
"20240914BLAEXE",2024-09-14,"England League 1","Blackpool","Exeter",2,1,"H",15,11,7,3,12,20,11,5,7,4,0,0,0,0,0,3,26,10,32,16,11,0
"20240914BOLHUD",2024-09-14,"England League 1","Bolton","Huddersfield",0,4,"A",5,16,1,5,10,12,5,6,1,1,0,0,0,0,0,4,21,6,22,11,2,0
"20240914BRIWIG",2024-09-14,"England League 1","Bristol Rvs","Wigan",0,4,"A",11,23,2,8,11,12,5,4,0,1,1,0,0,0,0,4,34,10,23,9,1,1
"20240914CRASTO",2024-09-14,"England League 1","Crawley Town","Stockport",1,1,"D",10,11,3,4,12,14,5,6,2,2,0,0,1,1,0,2,21,7,26,11,4,0
"20240914PETLIN",2024-09-14,"England League 1","Peterboro","Lincoln",1,1,"D",9,8,5,5,8,14,5,3,3,1,0,0,0,0,0,2,17,10,22,8,4,0
"20240914REALEY",2024-09-14,"England League 1","Reading","Leyton Orient",0,1,"A",11,12,4,3,9,17,1,7,0,6,0,0,0,0,0,1,23,7,26,8,6,0
"20240914ROTBUR",2024-09-14,"England League 1","Rotherham","Burton",2,2,"D",16,8,5,3,12,13,7,4,1,1,0,0,0,0,0,4,24,8,25,11,2,0
"20240914SHRCHA",2024-09-14,"England League 1","Shrewsbury","Charlton",0,1,"A",15,8,3,2,10,21,7,7,1,3,0,0,0,0,0,1,23,5,31,14,4,0
"20240914STEBAR",2024-09-14,"England League 1","Stevenage","Barnsley",3,0,"H",13,8,4,4,18,14,7,10,4,2,0,0,1,0,1,3,21,8,32,17,6,0
"20240916BIRWRE",2024-09-16,"England League 1","Birmingham","Wrexham",3,1,"H",8,5,6,3,13,11,5,1,3,3,1,0,0,0,0,4,13,9,24,6,6,1
"20240921EXESTE",2024-09-21,"England League 1","Exeter","Stevenage",2,0,"H",14,10,3,0,10,15,8,4,1,2,0,0,0,0,0,2,24,3,25,12,3,0
"20240921LINWIG",2024-09-21,"England League 1","Lincoln","Wigan",0,0,"D",6,6,4,1,15,5,3,1,2,1,0,0,0,0,0,0,12,5,20,4,3,0
"20240921BOLREA",2024-09-21,"England League 1","Bolton","Reading",5,2,"H",18,18,8,6,20,12,6,7,4,2,0,0,0,0,0,7,36,14,32,13,6,0
"20240921BURBAR",2024-09-21,"England League 1","Burton","Barnsley",1,2,"A",8,13,3,6,6,11,3,4,2,2,0,0,0,0,0,3,21,9,17,7,4,0
"20240921CHABLA",2024-09-21,"England League 1","Charlton","Blackpool",1,2,"A",14,9,6,4,19,12,4,1,2,1,0,0,0,0,0,3,23,10,31,5,3,0
"20240921HUDNOR",2024-09-21,"England League 1","Huddersfield","Northampton",1,3,"A",16,7,4,3,10,9,7,1,2,4,0,1,1,1,0,4,23,7,19,8,6,1
"20240921MANSHR",2024-09-21,"England League 1","Mansfield","Shrewsbury",2,1,"H",14,12,5,5,8,10,3,4,1,4,0,0,0,0,0,3,26,10,18,7,5,0
"20240921PETBRI",2024-09-21,"England League 1","Peterboro","Bristol Rvs",3,2,"H",12,17,8,4,13,11,2,5,2,1,0,0,0,0,0,5,29,12,24,7,3,0
"20240921ROTBIR",2024-09-21,"England League 1","Rotherham","Birmingham",0,2,"A",7,16,1,4,15,11,9,8,3,2,0,0,0,0,0,2,23,5,26,17,5,0
"20240921STOLEY",2024-09-21,"England League 1","Stockport","Leyton Orient",1,4,"A",18,9,3,5,12,13,6,1,1,2,0,0,0,0,0,5,27,8,25,7,3,0
"20240921WRECRA",2024-09-21,"England League 1","Wrexham","Crawley Town",2,1,"H",15,18,3,7,8,7,7,8,1,0,0,0,0,0,0,3,33,10,15,15,1,0
"20240921WYCCAM",2024-09-21,"England League 1","Wycombe","Cambridge",2,1,"H",18,4,6,2,10,17,9,2,1,2,0,0,0,0,0,3,22,8,27,11,3,0
"20240924HUDBLA",2024-09-24,"England League 1","Huddersfield","Blackpool",0,2,"A",8,11,2,3,20,6,10,2,2,0,0,0,0,0,0,2,19,5,26,12,2,0
"20240924LEYPET",2024-09-24,"England League 1","Leyton Orient","Peterboro",2,2,"D",13,7,5,3,14,1,7,3,2,1,0,0,0,0,0,4,20,8,15,10,3,0
"20240924WIGSTE",2024-09-24,"England League 1","Wigan","Stevenage",0,0,"D",7,7,2,1,15,11,8,1,3,4,0,0,0,0,0,0,14,3,26,9,7,0
"20240928CRABOL",2024-09-28,"England League 1","Crawley Town","Bolton",0,2,"A",8,11,3,6,14,17,6,4,2,3,0,0,0,0,0,2,19,9,31,10,5,0
"20240928REAHUD",2024-09-28,"England League 1","Reading","Huddersfield",2,1,"H",6,19,2,7,13,11,2,11,1,3,0,0,0,0,0,3,25,9,24,13,4,0
"20240928BIRPET",2024-09-28,"England League 1","Birmingham","Peterboro",3,2,"H",12,5,4,3,13,12,7,6,3,3,0,0,0,0,0,5,17,7,25,13,6,0
"20240928BLABUR",2024-09-28,"England League 1","Blackpool","Burton",3,0,"H",16,11,6,3,8,10,7,11,0,1,0,0,0,0,0,3,27,9,18,18,1,0
"20240928BRIWYC",2024-09-28,"England League 1","Bristol Rvs","Wycombe",1,2,"A",6,13,1,5,11,14,2,4,2,2,0,0,0,0,0,3,19,6,25,6,4,0
"20240928CAMLIN",2024-09-28,"England League 1","Cambridge","Lincoln",0,2,"A",11,10,2,4,19,19,6,2,1,3,0,0,0,0,0,2,21,6,38,8,4,0
"20240928LEYWRE",2024-09-28,"England League 1","Leyton Orient","Wrexham",0,0,"D",9,6,1,2,6,12,1,3,1,3,0,0,0,0,0,0,15,3,18,4,4,0
"20240928NORMAN",2024-09-28,"England League 1","Northampton","Mansfield",0,2,"A",16,10,8,3,7,16,6,4,0,3,0,0,0,0,0,2,26,11,23,10,3,0
"20240928SHRROT",2024-09-28,"England League 1","Shrewsbury","Rotherham",1,1,"D",4,12,1,1,17,7,3,5,2,2,0,0,0,0,0,2,16,2,24,8,4,0
"20240928STECHA",2024-09-28,"England League 1","Stevenage","Charlton",1,0,"H",11,7,3,2,14,9,12,6,4,4,0,0,0,0,0,1,18,5,23,18,8,0
"20240928WIGEXE",2024-09-28,"England League 1","Wigan","Exeter",0,0,"D",16,5,6,0,8,17,6,6,0,2,0,0,0,0,0,0,21,6,25,12,2,0
"20240928BARSTO",2024-09-28,"England League 1","Barnsley","Stockport",1,1,"D",11,15,5,6,11,10,3,5,3,1,0,0,0,0,0,2,26,11,21,8,4,0
"20241001BARWYC",2024-10-01,"England League 1","Barnsley","Wycombe",2,2,"D",17,13,4,4,11,11,14,7,1,3,0,0,0,0,0,4,30,8,22,21,4,0
"20241001BIRHUD",2024-10-01,"England League 1","Birmingham","Huddersfield",1,0,"H",20,7,5,2,11,8,5,3,4,1,0,0,0,0,0,1,27,7,19,8,5,0
"20241001BLALIN",2024-10-01,"England League 1","Blackpool","Lincoln",1,1,"D",14,9,6,2,9,15,7,5,0,3,0,1,0,0,0,2,23,8,24,12,3,1
"20241001BRICHA",2024-10-01,"England League 1","Bristol Rvs","Charlton",3,2,"H",9,12,5,6,10,18,4,7,1,2,0,0,0,0,0,5,21,11,28,11,3,0
"20241001CAMROT",2024-10-01,"England League 1","Cambridge","Rotherham",0,1,"A",10,8,4,2,13,11,7,2,4,1,0,0,0,0,0,1,18,6,24,9,5,0
"20241001CRAMAN",2024-10-01,"England League 1","Crawley Town","Mansfield",0,2,"A",14,9,3,4,14,10,8,9,6,3,0,0,0,0,0,2,23,7,24,17,9,0
"20241001LEYEXE",2024-10-01,"England League 1","Leyton Orient","Exeter",0,1,"A",14,9,5,2,11,10,4,6,2,3,0,1,0,0,0,1,23,7,21,10,5,1
"20241001NORBOL",2024-10-01,"England League 1","Northampton","Bolton",2,4,"A",10,14,7,6,9,13,4,5,4,4,0,0,2,0,2,6,24,13,22,9,8,0
"20241001SHRSTO",2024-10-01,"England League 1","Shrewsbury","Stockport",0,2,"A",7,12,0,8,10,17,5,5,2,6,0,0,1,0,1,2,19,8,27,10,8,0
"20241001STEWRE",2024-10-01,"England League 1","Stevenage","Wrexham",1,0,"H",8,7,3,1,11,15,2,3,2,3,0,0,0,0,0,1,15,4,26,5,5,0
"20241001WIGPET",2024-10-01,"England League 1","Wigan","Peterboro",3,0,"H",9,11,4,3,21,9,3,8,3,4,0,0,0,0,0,3,20,7,30,11,7,0
"20241001REABUR",2024-10-01,"England League 1","Reading","Burton",3,1,"H",15,7,5,4,15,15,4,5,2,2,0,0,0,0,0,4,22,9,30,9,4,0
"20241005HUDBAR",2024-10-05,"England League 1","Huddersfield","Barnsley",2,0,"H",17,11,8,2,10,13,17,4,4,2,0,0,0,0,0,2,28,10,23,21,6,0
"20241005PETSTE",2024-10-05,"England League 1","Peterboro","Stevenage",2,1,"H",12,17,3,7,12,9,8,9,3,2,0,0,0,0,0,3,29,10,21,17,5,0
"20241005BOLSHR",2024-10-05,"England League 1","Bolton","Shrewsbury",2,2,"D",19,7,4,2,8,13,8,3,0,5,0,0,0,0,0,4,26,6,21,11,5,0
"20241005BURBRI",2024-10-05,"England League 1","Burton","Bristol Rvs",1,3,"A",11,15,6,6,11,16,0,5,3,2,1,0,0,0,0,4,26,12,27,5,5,1
"20241005CHABIR",2024-10-05,"England League 1","Charlton","Birmingham",1,0,"H",6,3,1,0,18,13,5,5,3,1,0,0,0,0,0,1,9,1,31,10,4,0
"20241005EXECAM",2024-10-05,"England League 1","Exeter","Cambridge",1,0,"H",11,12,4,4,13,10,7,4,2,2,0,0,0,0,0,1,23,8,23,11,4,0
"20241005LINLEY",2024-10-05,"England League 1","Lincoln","Leyton Orient",2,1,"H",10,11,3,4,11,10,3,7,4,3,0,0,0,0,0,3,21,7,21,10,7,0
"20241005MANBLA",2024-10-05,"England League 1","Mansfield","Blackpool",2,0,"H",6,9,3,2,12,8,10,3,4,1,0,0,0,0,0,2,15,5,20,13,5,0
"20241005ROTREA",2024-10-05,"England League 1","Rotherham","Reading",2,1,"H",17,10,6,1,11,15,9,5,3,3,0,1,0,0,0,3,27,7,26,14,6,1
"20241005STOWIG",2024-10-05,"England League 1","Stockport","Wigan",0,0,"D",13,3,4,0,14,22,1,2,3,3,0,0,0,0,0,0,16,4,36,3,6,0
"20241005WRENOR",2024-10-05,"England League 1","Wrexham","Northampton",4,1,"H",15,14,8,6,12,12,4,5,1,1,0,0,0,0,0,5,29,14,24,9,2,0
"20241005WYCCRA",2024-10-05,"England League 1","Wycombe","Crawley Town",1,0,"H",9,8,4,3,14,12,7,2,1,6,0,0,0,0,0,1,17,7,26,9,7,0
"20241012CRASHR",2024-10-12,"England League 1","Crawley Town","Shrewsbury",3,5,"A",15,18,5,6,10,15,4,6,3,4,1,0,0,0,0,8,33,11,25,10,7,1
"20241012PETROT",2024-10-12,"England League 1","Peterboro","Rotherham",3,3,"D",13,11,6,6,9,13,8,3,3,1,0,0,0,0,0,6,24,12,22,11,4,0
"20241017SHREXE",2024-10-17,"England League 1","Shrewsbury","Exeter",0,2,"A",13,9,5,4,11,12,3,4,0,1,0,0,0,0,0,2,22,9,23,7,1,0
"20241019REACRA",2024-10-19,"England League 1","Reading","Crawley Town",4,1,"H",13,18,6,8,21,6,2,13,1,2,0,0,0,0,0,5,31,14,27,15,3,0
"20241019WYCPET",2024-10-19,"England League 1","Wycombe","Peterboro",3,1,"H",18,10,8,3,10,11,4,1,1,3,0,1,0,0,0,4,28,11,21,5,4,1
"20241019BLABAR",2024-10-19,"England League 1","Blackpool","Barnsley",1,2,"A",18,10,5,2,10,12,4,6,2,1,0,0,0,0,0,3,28,7,22,10,3,0
"20241019BOLBUR",2024-10-19,"England League 1","Bolton","Burton",2,1,"H",18,8,5,4,9,9,8,4,2,3,0,0,0,0,0,3,26,9,18,12,5,0
"20241019CAMWIG",2024-10-19,"England League 1","Cambridge","Wigan",2,0,"H",11,7,4,2,17,20,0,4,5,2,0,0,0,0,0,2,18,6,37,4,7,0
"20241019CHASTO",2024-10-19,"England League 1","Charlton","Stockport",1,1,"D",15,8,7,2,13,15,12,2,1,4,0,1,0,0,0,2,23,9,28,14,5,1
"20241019HUDBRI",2024-10-19,"England League 1","Huddersfield","Bristol Rvs",3,1,"H",16,3,10,1,9,13,9,1,1,2,0,0,0,0,0,4,19,11,22,10,3,0
"20241019LINBIR",2024-10-19,"England League 1","Lincoln","Birmingham",1,3,"A",8,7,3,4,14,15,8,5,0,3,0,0,0,0,0,4,15,7,29,13,3,0
"20241019MANSTE",2024-10-19,"England League 1","Mansfield","Stevenage",0,1,"A",15,10,3,6,5,12,9,2,2,1,0,0,0,0,0,1,25,9,17,11,3,0
"20241019NORLEY",2024-10-19,"England League 1","Northampton","Leyton Orient",1,0,"H",7,5,1,1,8,14,0,4,3,3,0,0,0,0,0,1,12,2,22,4,6,0
"20241019ROTWRE",2024-10-19,"England League 1","Rotherham","Wrexham",0,1,"A",17,13,6,7,11,16,8,4,1,3,0,0,0,0,0,1,30,13,27,12,4,0
"20241022BARCHA",2024-10-22,"England League 1","Barnsley","Charlton",2,2,"D",20,8,9,5,14,9,11,5,3,1,0,0,0,0,0,4,28,14,23,16,4,0
"20241022BIRBOL",2024-10-22,"England League 1","Birmingham","Bolton",2,0,"H",18,8,5,1,14,19,6,1,1,4,0,0,0,0,0,2,26,6,33,7,5,0
"20241022BRISHR",2024-10-22,"England League 1","Bristol Rvs","Shrewsbury",1,0,"H",14,15,5,4,12,9,5,10,4,1,0,0,1,1,0,1,29,9,21,15,5,0
"20241022BURWYC",2024-10-22,"England League 1","Burton","Wycombe",2,3,"A",10,14,2,5,10,15,5,6,1,4,0,0,0,0,0,5,24,7,25,11,5,0
"20241022CRALIN",2024-10-22,"England League 1","Crawley Town","Lincoln",3,0,"H",8,8,4,2,11,13,0,10,2,2,0,0,0,0,0,3,16,6,24,10,4,0
"20241022EXEREA",2024-10-22,"England League 1","Exeter","Reading",1,2,"A",18,11,5,5,9,15,8,5,1,1,0,0,0,0,0,3,29,10,24,13,2,0
"20241022LEYROT",2024-10-22,"England League 1","Leyton Orient","Rotherham",1,0,"H",12,11,5,2,12,14,3,8,2,1,0,0,0,0,0,1,23,7,26,11,3,0
"20241022PETBLA",2024-10-22,"England League 1","Peterboro","Blackpool",5,1,"H",8,11,6,4,12,9,2,3,1,1,0,0,0,0,0,6,19,10,21,5,2,0
"20241022STECAM",2024-10-22,"England League 1","Stevenage","Cambridge",0,2,"A",10,12,4,6,7,18,4,3,2,2,0,0,0,0,0,2,22,10,25,7,4,0
"20241022STONOR",2024-10-22,"England League 1","Stockport","Northampton",1,1,"D",17,7,3,3,6,14,6,1,1,4,0,0,0,0,0,2,24,6,20,7,5,0
"20241022WIGMAN",2024-10-22,"England League 1","Wigan","Mansfield",1,2,"A",22,4,4,2,11,12,4,1,0,3,0,0,0,0,0,3,26,6,23,5,3,0
"20241022WREHUD",2024-10-22,"England League 1","Wrexham","Huddersfield",0,0,"D",5,10,1,3,13,7,5,3,1,3,0,0,0,0,0,0,15,4,20,8,4,0
"20241026MANBIR",2024-10-26,"England League 1","Mansfield","Birmingham",1,1,"D",10,19,5,4,17,13,3,6,2,1,0,0,0,0,0,2,29,9,30,9,3,0
"20241026REABRI",2024-10-26,"England League 1","Reading","Bristol Rvs",1,0,"H",14,14,6,4,7,14,4,10,1,3,0,1,0,0,0,1,28,10,21,14,4,1
"20241026BOLPET",2024-10-26,"England League 1","Bolton","Peterboro",1,0,"H",25,11,7,2,7,11,15,3,3,4,0,0,0,0,0,1,36,9,18,18,7,0
"20241026CAMBUR",2024-10-26,"England League 1","Cambridge","Burton",1,0,"H",12,15,4,5,10,9,4,3,2,3,0,0,0,0,0,1,27,9,19,7,5,0
"20241026CHAWRE",2024-10-26,"England League 1","Charlton","Wrexham",2,2,"D",18,14,7,2,12,11,6,2,3,4,0,0,0,0,0,4,32,9,23,8,7,0
"20241026HUDEXE",2024-10-26,"England League 1","Huddersfield","Exeter",2,0,"H",7,4,4,1,7,10,7,4,0,0,0,0,0,0,0,2,11,5,17,11,0,0
"20241026LINSTO",2024-10-26,"England League 1","Lincoln","Stockport",2,1,"H",12,6,5,2,16,9,11,4,1,0,0,0,0,0,0,3,18,7,25,15,1,0
"20241026NORCRA",2024-10-26,"England League 1","Northampton","Crawley Town",3,0,"H",13,13,4,3,10,12,8,9,1,2,0,0,0,0,0,3,26,7,22,17,3,0
"20241026ROTSTE",2024-10-26,"England League 1","Rotherham","Stevenage",2,0,"H",13,5,5,1,19,21,5,3,3,3,0,0,0,0,0,2,18,6,40,8,6,0
"20241026SHRBAR",2024-10-26,"England League 1","Shrewsbury","Barnsley",0,2,"A",5,10,1,6,15,8,4,8,1,1,0,0,0,0,0,2,15,7,23,12,2,0
"20241026WYCLEY",2024-10-26,"England League 1","Wycombe","Leyton Orient",3,0,"H",14,3,5,2,11,14,2,6,0,2,0,0,0,0,0,3,17,7,25,8,2,0
"20241028BLAWIG",2024-10-28,"England League 1","Blackpool","Wigan",2,2,"D",22,11,6,5,10,15,2,4,2,3,0,0,0,0,0,4,33,11,25,6,5,0
"20241029LINNOR",2024-10-29,"England League 1","Lincoln","Northampton",2,1,"H",12,9,5,3,12,6,9,1,3,4,0,1,0,0,0,3,21,8,18,10,7,1
"20241029STEBOL",2024-10-29,"England League 1","Stevenage","Bolton",1,4,"A",16,12,5,6,13,11,10,4,3,4,0,0,0,0,0,5,28,11,24,14,7,0
"20241029STOREA",2024-10-29,"England League 1","Stockport","Reading",4,1,"H",16,2,9,1,9,14,4,2,1,1,0,0,0,0,0,5,18,10,23,6,2,0
"20241105BURCRA",2024-11-05,"England League 1","Burton","Crawley Town",0,0,"D",13,11,3,2,11,10,6,4,3,1,0,0,0,0,0,0,24,5,21,10,4,0
"20241105STOWYC",2024-11-05,"England League 1","Stockport","Wycombe",0,5,"A",4,15,0,10,19,14,6,5,3,0,0,0,0,0,0,5,19,10,33,11,3,0
"20241108BARROT",2024-11-08,"England League 1","Barnsley","Rotherham",2,0,"H",18,9,6,2,12,11,8,5,1,1,0,0,0,0,0,2,27,8,23,13,2,0
"20241109BURSHR",2024-11-09,"England League 1","Burton","Shrewsbury",2,0,"H",11,12,5,2,11,12,4,4,1,1,0,0,0,0,0,2,23,7,23,8,2,0
"20241109WREMAN",2024-11-09,"England League 1","Wrexham","Mansfield",1,0,"H",12,15,2,4,8,10,0,4,2,2,0,0,0,0,0,1,27,6,18,4,4,0
"20241109BIRNOR",2024-11-09,"England League 1","Birmingham","Northampton",1,1,"D",25,5,3,3,5,7,10,2,1,3,0,0,0,0,0,2,30,6,12,12,4,0
"20241109BRILIN",2024-11-09,"England League 1","Bristol Rvs","Lincoln",1,1,"D",8,12,1,3,11,15,6,6,4,2,0,0,0,0,0,2,20,4,26,12,6,0
"20241109CRAHUD",2024-11-09,"England League 1","Crawley Town","Huddersfield",2,2,"D",3,11,2,6,14,16,1,8,2,0,0,0,0,0,0,4,14,8,30,9,2,0
"20241109EXECHA",2024-11-09,"England League 1","Exeter","Charlton",1,0,"H",13,12,1,1,13,13,13,8,2,1,0,0,0,0,0,1,25,2,26,21,3,0
"20241109LEYBLA",2024-11-09,"England League 1","Leyton Orient","Blackpool",3,0,"H",16,14,8,3,10,10,6,2,4,1,0,0,0,0,0,3,30,11,20,8,5,0
"20241109PETCAM",2024-11-09,"England League 1","Peterboro","Cambridge",6,1,"H",12,9,9,2,11,12,3,8,2,0,0,0,0,0,0,7,21,11,23,11,2,0
"20241109STEREA",2024-11-09,"England League 1","Stevenage","Reading",1,1,"D",7,20,2,9,14,19,3,7,0,1,0,0,0,0,0,2,27,11,33,10,1,0
"20241109STOBOL",2024-11-09,"England League 1","Stockport","Bolton",5,0,"H",15,4,10,0,12,12,4,6,1,0,0,0,0,0,0,5,19,10,24,10,1,0
"20241109WIGWYC",2024-11-09,"England League 1","Wigan","Wycombe",0,1,"A",11,8,4,5,11,14,9,5,2,2,0,0,0,0,0,1,19,9,25,14,4,0
"20241116EXELIN",2024-11-16,"England League 1","Exeter","Lincoln",0,0,"D",7,14,1,3,14,9,5,5,1,2,1,0,0,0,0,0,21,4,23,10,3,1
"20241116BLANOR",2024-11-16,"England League 1","Blackpool","Northampton",0,0,"D",16,12,4,4,8,9,5,6,0,1,0,0,0,0,0,0,28,8,17,11,1,0
"20241116BRICRA",2024-11-16,"England League 1","Bristol Rvs","Crawley Town",0,0,"D",10,13,3,3,16,7,8,6,1,2,0,0,0,0,0,0,23,6,23,14,3,0
"20241116CAMBAR",2024-11-16,"England League 1","Cambridge","Barnsley",1,1,"D",9,14,3,4,9,9,4,5,3,3,0,0,0,0,0,2,23,7,18,9,6,0
"20241116STOWRE",2024-11-16,"England League 1","Stockport","Wrexham",1,0,"H",19,9,7,1,6,14,9,2,4,3,0,0,1,1,0,1,28,8,20,11,7,0
"20241123BOLBLA",2024-11-23,"England League 1","Bolton","Blackpool",2,1,"H",14,6,4,2,17,16,1,3,5,5,0,0,0,0,0,3,20,6,33,4,10,0
"20241123SHRBIR",2024-11-23,"England League 1","Shrewsbury","Birmingham",3,2,"H",7,12,4,5,17,9,1,2,2,1,0,0,0,0,0,5,19,9,26,3,3,0
"20241123STELEY",2024-11-23,"England League 1","Stevenage","Leyton Orient",0,0,"D",4,3,1,1,9,13,4,5,2,3,0,0,0,0,0,0,7,2,22,9,5,0
"20241123BARWIG",2024-11-23,"England League 1","Barnsley","Wigan",0,1,"A",20,6,4,1,11,13,10,2,2,3,0,0,0,0,0,1,26,5,24,12,5,0
"20241123BURSTO",2024-11-23,"England League 1","Burton","Stockport",0,3,"A",6,15,1,10,12,6,2,4,3,3,0,0,0,0,0,3,21,11,18,6,6,0
"20241123CRAROT",2024-11-23,"England League 1","Crawley Town","Rotherham",1,0,"H",10,6,3,2,7,16,3,6,3,2,0,0,0,0,0,1,16,5,23,9,5,0
"20241123HUDCHA",2024-11-23,"England League 1","Huddersfield","Charlton",2,1,"H",13,8,6,1,7,13,4,7,2,1,0,1,0,0,0,3,21,7,20,11,3,1
"20241123LINWYC",2024-11-23,"England League 1","Lincoln","Wycombe",2,3,"A",14,16,6,6,21,13,4,7,4,1,0,0,0,0,0,5,30,12,34,11,5,0
"20241123MANBRI",2024-11-23,"England League 1","Mansfield","Bristol Rvs",0,1,"A",19,13,4,1,17,14,8,4,3,2,0,0,0,0,0,1,32,5,31,12,5,0
"20241123NORCAM",2024-11-23,"England League 1","Northampton","Cambridge",0,0,"D",9,10,1,3,13,5,4,8,0,1,0,0,1,1,0,0,19,4,18,12,1,0
"20241123PETREA",2024-11-23,"England League 1","Peterboro","Reading",1,2,"A",21,17,6,6,5,13,10,2,1,2,0,0,0,0,0,3,38,12,18,12,3,0
"20241123WREEXE",2024-11-23,"England League 1","Wrexham","Exeter",3,0,"H",13,9,4,3,8,8,8,9,1,2,0,0,0,0,0,3,22,7,16,17,3,0
"20241126BARREA",2024-11-26,"England League 1","Barnsley","Reading",2,2,"D",21,11,6,3,6,9,11,4,1,0,0,0,0,0,0,4,32,9,15,15,1,0
"20241126BRIBLA",2024-11-26,"England League 1","Bristol Rvs","Blackpool",0,2,"A",7,12,0,5,15,11,2,2,3,4,0,0,0,0,0,2,19,5,26,4,7,0
"20241126BURCHA",2024-11-26,"England League 1","Burton","Charlton",0,1,"A",7,24,1,11,7,16,3,7,0,6,1,0,0,0,0,1,31,12,23,10,6,1
"20241126CAMBOL",2024-11-26,"England League 1","Cambridge","Bolton",1,1,"D",11,13,3,4,10,13,4,5,2,5,1,0,0,0,0,2,24,7,23,9,7,1
"20241126EXEBIR",2024-11-26,"England League 1","Exeter","Birmingham",0,2,"A",3,19,1,3,17,15,2,7,4,2,0,0,0,0,0,2,22,4,32,9,6,0
"20241126LEYHUD",2024-11-26,"England League 1","Leyton Orient","Huddersfield",0,2,"A",11,14,3,6,7,12,8,4,2,1,0,0,1,0,1,2,25,9,19,12,3,0
"20241126WIGNOR",2024-11-26,"England League 1","Wigan","Northampton",2,1,"H",15,11,8,6,5,10,9,4,1,1,0,0,0,0,0,3,26,14,15,13,2,0
"20241126WRELIN",2024-11-26,"England League 1","Wrexham","Lincoln",1,0,"H",11,14,3,1,10,13,1,6,1,0,0,0,0,0,0,1,25,4,23,7,1,0
"20241126WYCMAN",2024-11-26,"England League 1","Wycombe","Mansfield",1,0,"H",9,7,3,1,12,12,3,4,1,1,0,0,0,0,0,1,16,4,24,7,2,0
"20241203BOLMAN",2024-12-03,"England League 1","Bolton","Mansfield",3,1,"H",14,8,8,2,7,18,6,4,1,3,0,1,0,0,0,4,22,10,25,10,4,1
"20241203CHACRA",2024-12-03,"England League 1","Charlton","Crawley Town",1,2,"A",11,7,3,6,14,11,3,0,0,1,0,0,0,0,0,3,18,9,25,3,1,0
"20241203EXEWYC",2024-12-03,"England League 1","Exeter","Wycombe",2,2,"D",6,10,2,6,18,12,6,1,0,1,0,0,0,0,0,4,16,8,30,7,1,0
"20241203LEYBRI",2024-12-03,"England League 1","Leyton Orient","Bristol Rvs",3,0,"H",18,3,9,0,9,13,5,1,1,1,0,0,0,0,0,3,21,9,22,6,2,0
"20241203ROTLIN",2024-12-03,"England League 1","Rotherham","Lincoln",2,1,"H",8,14,5,5,16,19,3,5,3,4,0,0,0,0,0,3,22,10,35,8,7,0
"20241203STENOR",2024-12-03,"England League 1","Stevenage","Northampton",2,0,"H",16,1,6,0,13,12,14,2,3,2,0,1,0,0,0,2,17,6,25,16,5,1
"20241203WREBAR",2024-12-03,"England League 1","Wrexham","Barnsley",1,0,"H",13,10,7,2,7,10,5,4,3,3,0,0,0,0,0,1,23,9,17,9,6,0
"20241203HUDWIG",2024-12-03,"England League 1","Huddersfield","Wigan",1,0,"H",17,8,5,2,11,9,5,4,2,3,0,0,0,0,0,1,25,7,20,9,5,0
"20241203REACAM",2024-12-03,"England League 1","Reading","Cambridge",3,0,"H",14,11,9,3,11,11,6,4,2,1,0,0,0,0,0,3,25,12,22,10,3,0
"20241204BIRSTO",2024-12-04,"England League 1","Birmingham","Stockport",2,0,"H",9,13,5,5,13,11,5,5,4,2,0,0,0,0,0,2,22,10,24,10,6,0
"20241204PETBUR",2024-12-04,"England League 1","Peterboro","Burton",0,1,"A",7,9,1,3,6,14,11,4,0,0,0,0,0,0,0,1,16,4,20,15,0,0
"20241204SHRBLA",2024-12-04,"England League 1","Shrewsbury","Blackpool",1,2,"A",13,7,2,3,12,8,7,4,3,1,0,0,0,0,0,3,20,5,20,11,4,0
"20241207LINCHA",2024-12-07,"England League 1","Lincoln","Charlton",0,0,"D",10,7,1,1,7,12,7,4,0,2,0,0,0,0,0,0,17,2,19,11,2,0
"20241207WIGLEY",2024-12-07,"England League 1","Wigan","Leyton Orient",0,2,"A",6,9,1,4,7,14,3,1,1,1,0,0,0,0,0,2,15,5,21,4,2,0
"20241207BARBIR",2024-12-07,"England League 1","Barnsley","Birmingham",1,2,"A",9,4,5,4,11,7,4,2,3,3,1,0,0,0,0,3,13,9,18,6,6,1
"20241207BURWRE",2024-12-07,"England League 1","Burton","Wrexham",0,1,"A",5,16,1,4,12,13,4,8,1,0,0,0,0,0,0,1,21,5,25,12,1,0
"20241207CAMSHR",2024-12-07,"England League 1","Cambridge","Shrewsbury",4,1,"H",11,11,6,4,11,8,5,5,2,1,0,0,0,0,0,5,22,10,19,10,3,0
"20241207MANHUD",2024-12-07,"England League 1","Mansfield","Huddersfield",1,2,"A",15,14,4,4,10,9,6,7,1,3,0,0,0,0,0,3,29,8,19,13,4,0
"20241207STOEXE",2024-12-07,"England League 1","Stockport","Exeter",2,0,"H",15,3,7,0,10,10,2,2,2,3,0,0,0,0,0,2,18,7,20,4,5,0
"20241207WYCREA",2024-12-07,"England League 1","Wycombe","Reading",1,1,"D",9,11,3,6,11,10,8,5,4,2,0,0,0,0,0,2,20,9,21,13,6,0
"20241209NORPET",2024-12-09,"England League 1","Northampton","Peterboro",2,1,"H",7,12,3,4,9,8,7,4,0,0,0,0,0,0,0,3,19,7,17,11,0,0
"20241214BOLWIG",2024-12-14,"England League 1","Bolton","Wigan",0,2,"A",8,12,3,7,14,19,2,2,3,4,0,0,0,0,0,2,20,10,33,4,7,0
"20241214LEYBUR",2024-12-14,"England League 1","Leyton Orient","Burton",0,0,"D",12,5,3,2,16,9,11,5,1,2,0,0,0,0,0,0,17,5,25,16,3,0
"20241214BIRBRI",2024-12-14,"England League 1","Birmingham","Bristol Rvs",2,0,"H",26,3,8,1,7,9,8,0,0,0,0,0,0,0,0,2,29,9,16,8,0,0
"20241214CHAMAN",2024-12-14,"England League 1","Charlton","Mansfield",0,0,"D",9,11,2,0,14,15,5,5,2,3,0,0,0,0,0,0,20,2,29,10,5,0
"20241214EXEBAR",2024-12-14,"England League 1","Exeter","Barnsley",1,2,"A",7,13,3,3,8,10,2,4,0,3,0,0,0,0,0,3,20,6,18,6,3,0
"20241214HUDLIN",2024-12-14,"England League 1","Huddersfield","Lincoln",2,2,"D",11,9,3,3,7,11,6,7,1,2,0,0,0,0,0,4,20,6,18,13,3,0
"20241214PETCRA",2024-12-14,"England League 1","Peterboro","Crawley Town",4,3,"H",16,15,10,7,5,15,6,7,0,2,0,0,1,1,0,7,31,17,20,13,2,0
"20241214REABLA",2024-12-14,"England League 1","Reading","Blackpool",0,3,"A",10,15,2,8,11,9,7,6,3,0,0,0,0,0,0,3,25,10,20,13,3,0
"20241214ROTNOR",2024-12-14,"England League 1","Rotherham","Northampton",3,0,"H",16,8,6,3,13,16,4,1,1,2,0,0,0,0,0,3,24,9,29,5,3,0
"20241214SHRWYC",2024-12-14,"England League 1","Shrewsbury","Wycombe",1,4,"A",6,7,3,4,11,11,4,3,1,4,0,0,0,0,0,5,13,7,22,7,5,0
"20241214STESTO",2024-12-14,"England League 1","Stevenage","Stockport",2,1,"H",7,9,3,3,18,19,4,3,3,3,0,0,0,0,0,3,16,6,37,7,6,0
"20241214WRECAM",2024-12-14,"England League 1","Wrexham","Cambridge",2,2,"D",11,14,4,6,10,11,6,9,3,2,0,0,0,0,0,4,25,10,21,15,5,0
"20241220CAMHUD",2024-12-20,"England League 1","Cambridge","Huddersfield",0,4,"A",13,17,3,10,13,11,3,4,1,2,0,0,0,0,0,4,30,13,24,7,3,0
"20241220STOPET",2024-12-20,"England League 1","Stockport","Peterboro",2,1,"H",13,5,3,1,16,16,2,1,3,4,0,0,0,0,0,3,18,4,32,3,7,0
"20241220WYCBOL",2024-12-20,"England League 1","Wycombe","Bolton",0,0,"D",11,7,5,3,16,15,7,3,1,3,0,0,0,0,0,0,18,8,31,10,4,0
"20241221BRIWRE",2024-12-21,"England League 1","Bristol Rvs","Wrexham",1,1,"D",3,13,1,2,9,14,3,7,3,4,0,0,0,0,0,2,16,3,23,10,7,0
"20241221LINREA",2024-12-21,"England League 1","Lincoln","Reading",2,0,"H",15,4,7,1,14,9,9,0,2,1,0,1,0,0,0,2,19,8,23,9,3,1
"20241221BARLEY",2024-12-21,"England League 1","Barnsley","Leyton Orient",0,4,"A",10,10,1,7,2,9,5,8,0,3,0,0,0,0,0,4,20,8,11,13,3,0
"20241221BLASTE",2024-12-21,"England League 1","Blackpool","Stevenage",0,0,"D",12,15,2,3,19,13,6,8,3,1,0,0,0,0,0,0,27,5,32,14,4,0
"20241221BUREXE",2024-12-21,"England League 1","Burton","Exeter",1,2,"A",10,14,3,3,10,10,4,0,4,4,0,0,0,0,0,3,24,6,20,4,8,0
"20241221MANROT",2024-12-21,"England League 1","Mansfield","Rotherham",1,0,"H",6,7,3,1,16,12,4,8,1,0,0,0,0,0,0,1,13,4,28,12,1,0
"20241221NORCHA",2024-12-21,"England League 1","Northampton","Charlton",0,5,"A",5,15,1,7,11,20,2,4,2,3,0,0,0,0,0,5,20,8,31,6,5,0
"20241221WIGSHR",2024-12-21,"England League 1","Wigan","Shrewsbury",2,2,"D",10,8,3,3,12,13,4,3,3,3,0,0,0,0,0,4,18,6,25,7,6,0
"20241223CRABIR",2024-12-23,"England League 1","Crawley Town","Birmingham",0,1,"A",5,12,0,4,11,15,3,6,1,1,0,0,0,0,0,1,17,4,26,9,2,0
"20241226LEYCRA",2024-12-26,"England League 1","Leyton Orient","Crawley Town",3,0,"H",22,4,8,2,10,16,4,3,2,3,0,0,0,0,0,3,26,10,26,7,5,0
"20241226BIRBUR",2024-12-26,"England League 1","Birmingham","Burton",2,0,"H",12,2,2,0,4,6,8,0,0,2,0,0,0,0,0,2,14,2,10,8,2,0
"20241226BOLBAR",2024-12-26,"England League 1","Bolton","Barnsley",1,2,"A",11,12,4,7,14,16,7,8,4,4,0,0,0,0,0,3,23,11,30,15,8,0
"20241226CHACAM",2024-12-26,"England League 1","Charlton","Cambridge",2,1,"H",13,12,6,1,17,10,4,2,0,1,0,0,0,0,0,3,25,7,27,6,1,0
"20241226EXEBRI",2024-12-26,"England League 1","Exeter","Bristol Rvs",3,1,"H",14,15,5,6,15,10,4,5,2,2,0,0,0,0,0,4,29,11,25,9,4,0
"20241226HUDSTO",2024-12-26,"England League 1","Huddersfield","Stockport",1,0,"H",5,7,1,3,13,12,2,5,1,2,0,0,0,0,0,1,12,4,25,7,3,0
"20241226PETMAN",2024-12-26,"England League 1","Peterboro","Mansfield",0,3,"A",6,23,2,11,8,25,1,14,2,4,1,0,0,0,0,3,29,13,33,15,6,1
"20241226REANOR",2024-12-26,"England League 1","Reading","Northampton",4,1,"H",8,7,5,1,10,13,4,5,0,2,0,0,0,0,0,5,15,6,23,9,2,0
"20241226ROTWIG",2024-12-26,"England League 1","Rotherham","Wigan",0,1,"A",9,15,3,5,9,11,4,5,1,1,0,0,0,0,0,1,24,8,20,9,2,0
"20241226SHRLIN",2024-12-26,"England League 1","Shrewsbury","Lincoln",1,0,"H",7,9,5,4,11,14,6,2,4,4,0,0,0,0,0,1,16,9,25,8,8,0
"20241226STEWYC",2024-12-26,"England League 1","Stevenage","Wycombe",0,3,"A",7,10,1,6,19,10,3,6,3,0,0,0,0,0,0,3,17,7,29,9,3,0
"20241226WREBLA",2024-12-26,"England League 1","Wrexham","Blackpool",2,1,"H",19,8,4,3,13,11,5,1,0,1,0,0,1,0,1,3,27,7,24,6,1,0
"20241229CHAWYC",2024-12-29,"England League 1","Charlton","Wycombe",2,1,"H",11,7,3,2,13,9,3,2,1,1,0,0,0,0,0,3,18,5,22,5,2,0
"20241229ROTSTO",2024-12-29,"England League 1","Rotherham","Stockport",1,1,"D",8,15,2,4,19,17,3,5,3,2,0,0,0,0,0,2,23,6,36,8,5,0
"20241229BIRBLA",2024-12-29,"England League 1","Birmingham","Blackpool",0,0,"D",6,9,4,2,15,13,4,5,1,1,0,0,0,0,0,0,15,6,28,9,2,0
"20241229BOLLIN",2024-12-29,"England League 1","Bolton","Lincoln",3,0,"H",15,7,3,2,12,16,7,2,0,3,0,1,0,0,0,3,22,5,28,9,3,1
"20241229EXECRA",2024-12-29,"England League 1","Exeter","Crawley Town",4,4,"D",18,11,7,5,12,15,6,3,3,2,0,0,0,0,0,8,29,12,27,9,5,0
"20241229HUDBUR",2024-12-29,"England League 1","Huddersfield","Burton",1,1,"D",27,6,7,3,5,13,17,4,1,1,0,1,0,0,0,2,33,10,18,21,2,1
"20241229LEYCAM",2024-12-29,"England League 1","Leyton Orient","Cambridge",2,0,"H",14,6,4,2,16,9,6,7,2,2,0,0,0,0,0,2,20,6,25,13,4,0
"20241229PETBAR",2024-12-29,"England League 1","Peterboro","Barnsley",1,3,"A",3,15,2,6,11,14,1,7,0,2,1,0,1,1,0,4,18,8,25,8,2,1
"20241229REAMAN",2024-12-29,"England League 1","Reading","Mansfield",2,1,"H",9,15,5,2,11,15,0,7,2,2,0,0,0,0,0,3,24,7,26,7,4,0
"20241229SHRNOR",2024-12-29,"England League 1","Shrewsbury","Northampton",1,1,"D",11,9,3,2,11,13,7,5,3,1,0,0,0,0,0,2,20,5,24,12,4,0
"20241229STEBRI",2024-12-29,"England League 1","Stevenage","Bristol Rvs",3,0,"H",11,5,5,2,13,7,3,7,2,3,0,1,0,0,0,3,16,7,20,10,5,1
"20241229WREWIG",2024-12-29,"England League 1","Wrexham","Wigan",2,1,"H",9,10,3,1,6,13,2,8,2,3,0,0,1,1,0,3,19,4,19,10,5,0
"20220101BARBRA",2022-01-01,"England League Two","Barrow","Bradford",1,2,"A",18,6,5,3,9,14,6,3,2,1,0,0,0,0,0,3,24,8,23,9,3,0
"20220101CRACOL",2022-01-01,"England League Two","Crawley Town","Colchester",3,1,"H",14,19,4,6,10,10,5,6,1,2,0,0,0,0,0,4,33,10,20,11,3,0
"20220101FORSTE",2022-01-01,"England League Two","Forest Green","Stevenage",2,0,"H",26,7,6,2,8,13,11,7,1,1,0,0,0,0,0,2,33,8,21,18,2,0
"20220101HAROLD",2022-01-01,"England League Two","Hartlepool","Oldham",0,0,"D",15,12,2,1,6,20,16,4,0,4,0,0,0,0,0,0,27,3,26,20,4,0
"20220101SCUCAR",2022-01-01,"England League Two","Scunthorpe","Carlisle",0,1,"A",16,14,3,6,12,12,11,5,2,1,0,0,0,0,0,1,30,9,24,16,3,0
"20220101SUTEXE",2022-01-01,"England League Two","Sutton","Exeter",2,1,"H",12,9,5,2,11,8,5,1,1,0,0,0,0,0,0,3,21,7,19,6,1,0
"20220101SWINOR",2022-01-01,"England League Two","Swindon","Northampton",5,2,"H",20,14,6,6,8,12,3,6,2,3,0,0,0,0,0,7,34,12,20,9,5,0
"20220101WALNEW",2022-01-01,"England League Two","Walsall","Newport County",3,3,"D",17,12,5,5,13,12,12,1,1,1,0,0,0,0,0,6,29,10,25,13,2,0
"20220104FOREXE",2022-01-04,"England League Two","Forest Green","Exeter",0,0,"D",7,19,1,7,7,7,6,13,3,1,0,0,0,0,0,0,26,8,14,19,4,0
"20220108CARBRA",2022-01-08,"England League Two","Carlisle","Bradford",2,0,"H",9,9,3,0,5,18,6,7,0,3,0,0,0,0,0,2,18,3,23,13,3,0
"20220108NEWSAL",2022-01-08,"England League Two","Newport County","Salford",0,2,"A",16,11,4,4,4,14,3,3,1,1,0,0,0,0,0,2,27,8,18,6,2,0
"20220108NORCRA",2022-01-08,"England League Two","Northampton","Crawley Town",0,1,"A",17,3,1,1,6,6,14,2,1,2,0,0,0,0,0,1,20,2,12,16,3,0
"20220108STEWAL",2022-01-08,"England League Two","Stevenage","Walsall",3,1,"H",8,12,5,2,16,18,5,5,2,2,0,0,0,0,0,4,20,7,34,10,4,0
"20220108TRASCU",2022-01-08,"England League Two","Tranmere","Scunthorpe",4,0,"H",12,8,8,3,6,9,8,7,1,1,0,0,0,0,0,4,20,11,15,15,2,0
"20220111MANSWI",2022-01-11,"England League Two","Mansfield","Swindon",3,2,"H",10,12,3,6,16,6,3,6,2,3,0,0,0,0,0,5,22,9,22,9,5,0
"20220111FORCOL",2022-01-11,"England League Two","Forest Green","Colchester",2,0,"H",14,8,4,6,10,11,6,3,1,1,0,0,0,0,0,2,22,10,21,9,2,0
"20220111SALTRA",2022-01-11,"England League Two","Salford","Tranmere",1,1,"D",12,7,2,2,18,19,8,1,4,1,0,0,0,0,0,2,19,4,37,9,5,0
"20220115NEWHAR",2022-01-15,"England League Two","Newport County","Harrogate",4,0,"H",17,13,6,3,14,10,4,7,2,3,0,0,0,0,0,4,30,9,24,11,5,0
"20220115BRASAL",2022-01-15,"England League Two","Bradford","Salford",2,1,"H",19,13,6,4,10,11,13,1,0,3,0,1,0,0,0,3,32,10,21,14,3,1
"20220115BRIHAR",2022-01-15,"England League Two","Bristol Rvs","Hartlepool",2,0,"H",14,11,3,3,15,13,2,12,2,4,0,1,0,0,0,2,25,6,28,14,6,1
"20220115CARCRA",2022-01-15,"England League Two","Carlisle","Crawley Town",1,1,"D",10,14,3,4,17,13,4,3,2,2,0,0,0,0,0,2,24,7,30,7,4,0
"20220115COLBAR",2022-01-15,"England League Two","Colchester","Barrow",0,2,"A",11,16,1,8,12,8,7,8,1,3,0,0,0,0,0,2,27,9,20,15,4,0
"20220115EXESCU",2022-01-15,"England League Two","Exeter","Scunthorpe",2,0,"H",19,5,5,0,13,18,10,2,0,2,0,0,0,0,0,2,24,5,31,12,2,0
"20220115MANWAL",2022-01-15,"England League Two","Mansfield","Walsall",2,0,"H",17,10,6,3,14,11,6,4,1,0,0,0,0,0,0,2,27,9,25,10,1,0
"20220115NORFOR",2022-01-15,"England League Two","Northampton","Forest Green",1,1,"D",11,8,2,4,20,9,4,7,4,1,0,0,0,0,0,2,19,6,29,11,5,0
"20220115PORSWI",2022-01-15,"England League Two","Port Vale","Swindon",1,3,"A",5,20,1,8,9,9,1,8,0,1,1,0,0,0,0,4,25,9,18,9,1,1
"20220115STESUT",2022-01-15,"England League Two","Stevenage","Sutton",3,3,"D",17,11,8,4,11,10,2,2,1,0,0,0,0,0,0,6,28,12,21,4,1,0
"20220115TRAROC",2022-01-15,"England League Two","Tranmere","Rochdale",2,0,"H",5,13,3,5,12,7,3,12,2,0,0,0,0,0,0,2,18,8,19,15,2,0
"20220118CARHAR",2022-01-18,"England League Two","Carlisle","Hartlepool",0,0,"D",17,6,6,2,13,7,4,2,1,1,0,0,0,0,0,0,23,8,20,6,2,0
"20220118PORSAL",2022-01-18,"England League Two","Port Vale","Salford",0,1,"A",17,3,3,1,12,16,3,3,2,2,0,0,0,0,0,1,20,4,28,6,4,0
"20220118STECRA",2022-01-18,"England League Two","Stevenage","Crawley Town",2,1,"H",17,12,9,3,14,9,9,4,0,2,0,0,0,0,0,3,29,12,23,13,2,0
"20220118SUTCOL",2022-01-18,"England League Two","Sutton","Colchester",3,2,"H",12,8,8,5,9,18,1,4,2,4,0,0,0,0,0,5,20,13,27,5,6,0
"20220122SWIBRI",2022-01-22,"England League Two","Swindon","Bristol Rvs",1,1,"D",12,11,4,4,13,13,8,4,1,6,0,0,0,0,0,2,23,8,26,12,7,0
"20220122BARMAN",2022-01-22,"England League Two","Barrow","Mansfield",1,3,"A",9,10,2,6,10,10,7,8,3,2,0,1,0,0,0,4,19,8,20,15,5,1
"20220122CRATRA",2022-01-22,"England League Two","Crawley Town","Tranmere",0,1,"A",5,11,1,3,12,19,3,5,1,2,0,0,0,0,0,1,16,4,31,8,3,0
"20220122FORCAR",2022-01-22,"England League Two","Forest Green","Carlisle",3,0,"H",20,7,9,1,9,10,3,6,1,2,0,0,0,0,0,3,27,10,19,9,3,0
"20220122HAROLD",2022-01-22,"England League Two","Harrogate","Oldham",3,0,"H",17,10,6,2,5,15,6,5,1,1,0,0,0,0,0,3,27,8,20,11,2,0
"20220122HARSTE",2022-01-22,"England League Two","Hartlepool","Stevenage",1,1,"D",14,9,4,2,7,12,5,3,1,0,0,0,0,0,0,2,23,6,19,8,1,0
"20220122LEYPOR",2022-01-22,"England League Two","Leyton Orient","Port Vale",0,0,"D",7,6,2,2,11,14,3,5,4,2,0,0,0,0,0,0,13,4,25,8,6,0
"20220122ROCBRA",2022-01-22,"England League Two","Rochdale","Bradford",0,0,"D",12,13,4,3,14,12,5,5,0,1,0,0,0,0,0,0,25,7,26,10,1,0
"20220122SALCOL",2022-01-22,"England League Two","Salford","Colchester",0,3,"A",9,14,4,8,8,12,3,6,2,1,0,0,0,0,0,3,23,12,20,9,3,0
"20220122SCUNEW",2022-01-22,"England League Two","Scunthorpe","Newport County",0,1,"A",6,25,2,8,11,10,1,9,3,1,0,0,0,0,0,1,31,10,21,10,4,0
"20220122SUTNOR",2022-01-22,"England League Two","Sutton","Northampton",0,0,"D",12,8,5,3,7,13,3,3,0,3,1,0,0,0,0,0,20,8,20,6,3,1
"20220122WALEXE",2022-01-22,"England League Two","Walsall","Exeter",0,2,"A",8,15,3,9,13,9,4,9,1,2,1,0,0,0,0,2,23,12,22,13,3,1
"20220125BARSAL",2022-01-25,"England League Two","Barrow","Salford",0,2,"A",14,11,1,3,13,9,6,7,2,3,0,0,0,0,0,2,25,4,22,13,5,0
"20220125LEYNEW",2022-01-25,"England League Two","Leyton Orient","Newport County",0,1,"A",9,9,2,4,16,11,4,4,2,1,0,0,0,0,0,1,18,6,27,8,3,0
"20220125SCUBRI",2022-01-25,"England League Two","Scunthorpe","Bristol Rvs",2,3,"A",14,12,5,5,8,7,7,3,1,1,0,0,0,0,0,5,26,10,15,10,2,0
"20220125WALBRA",2022-01-25,"England League Two","Walsall","Bradford",1,2,"A",12,8,6,4,16,16,5,1,4,2,0,0,0,0,0,3,20,10,32,6,6,0
"20220129BRACRA",2022-01-29,"England League Two","Bradford","Crawley Town",1,2,"A",13,16,3,6,16,12,7,3,2,2,0,0,0,0,0,3,29,9,28,10,4,0
"20220129BRIWAL",2022-01-29,"England League Two","Bristol Rvs","Walsall",1,0,"H",10,7,5,2,8,22,5,5,1,5,1,0,0,0,0,1,17,7,30,10,6,1
"20220129CARSUT",2022-01-29,"England League Two","Carlisle","Sutton",0,2,"A",10,12,2,6,10,13,5,8,1,2,0,0,0,0,0,2,22,8,23,13,3,0
"20220129COLSWI",2022-01-29,"England League Two","Colchester","Swindon",1,1,"D",6,11,2,5,18,10,4,5,3,2,2,0,0,0,0,2,17,7,28,9,5,2
"20220129EXEHAR",2022-01-29,"England League Two","Exeter","Hartlepool",0,0,"D",13,8,2,1,9,4,4,5,2,1,0,1,0,0,0,0,21,3,13,9,3,1
"20220129MANLEY",2022-01-29,"England League Two","Mansfield","Leyton Orient",2,0,"H",6,6,4,1,11,8,5,3,1,1,0,0,0,0,0,2,12,5,19,8,2,0
"20220129NEWBAR",2022-01-29,"England League Two","Newport County","Barrow",2,1,"H",11,8,6,1,12,11,3,7,1,5,0,0,0,0,0,3,19,7,23,10,6,0
"20220129NORSAL",2022-01-29,"England League Two","Northampton","Salford",1,0,"H",10,6,4,2,12,14,8,8,0,2,0,0,0,0,0,1,16,6,26,16,2,0
"20220129OLDROC",2022-01-29,"England League Two","Oldham","Rochdale",0,0,"D",6,7,0,0,9,12,1,9,3,2,0,0,0,0,0,0,13,0,21,10,5,0
"20220129PORSCU",2022-01-29,"England League Two","Port Vale","Scunthorpe",1,0,"H",8,5,3,2,10,6,6,3,2,0,0,0,0,0,0,1,13,5,16,9,2,0
"20220129STEHAR",2022-01-29,"England League Two","Stevenage","Harrogate",3,0,"H",8,11,4,2,13,4,5,6,1,0,0,0,0,0,0,3,19,6,17,11,1,0
"20220129TRAFOR",2022-01-29,"England League Two","Tranmere","Forest Green",0,4,"A",6,12,3,6,11,10,5,6,1,0,0,0,0,0,0,4,18,9,21,11,1,0
"20220201BRALEY",2022-02-01,"England League Two","Bradford","Leyton Orient",1,1,"D",12,5,2,3,11,16,5,4,2,2,0,0,0,0,0,2,17,5,27,9,4,0
"20220201COLROC",2022-02-01,"England League Two","Colchester","Rochdale",1,1,"D",9,9,4,2,15,8,4,5,1,1,0,0,0,0,0,2,18,6,23,9,2,0
"20220201HARMAN",2022-02-01,"England League Two","Harrogate","Mansfield",0,0,"D",13,13,4,4,9,14,7,7,2,2,0,0,0,0,0,0,26,8,23,14,4,0
"20220201NORBAR",2022-02-01,"England League Two","Northampton","Barrow",0,1,"A",13,8,4,4,8,18,3,6,1,4,0,0,0,0,0,1,21,8,26,9,5,0
"20220201PORFOR",2022-02-01,"England League Two","Port Vale","Forest Green",1,1,"D",8,8,4,2,14,12,5,8,0,0,0,0,0,0,0,2,16,6,26,13,0,0
"20220201SALCAR",2022-02-01,"England League Two","Salford","Carlisle",2,1,"H",16,6,5,1,8,11,8,2,0,2,0,0,0,0,0,3,22,6,19,10,2,0
"20220201SWICRA",2022-02-01,"England League Two","Swindon","Crawley Town",1,1,"D",20,11,4,4,8,17,9,2,2,3,0,0,0,0,0,2,31,8,25,11,5,0
"20220201TRASTE",2022-02-01,"England League Two","Tranmere","Stevenage",1,0,"H",12,10,6,2,4,6,7,5,0,1,0,0,0,0,0,1,22,8,10,12,1,0
"20220205HARBRA",2022-02-05,"England League Two","Harrogate","Bradford",2,0,"H",10,17,3,6,8,14,3,7,1,2,0,0,0,0,0,2,27,9,22,10,3,0
"20220205BARTRA",2022-02-05,"England League Two","Barrow","Tranmere",1,1,"D",7,16,2,5,13,6,3,8,3,1,0,0,0,0,0,2,23,7,19,11,4,0
"20220205CRASTE",2022-02-05,"England League Two","Crawley Town","Stevenage",2,2,"D",16,12,6,3,6,14,7,3,1,1,0,0,0,0,0,4,28,9,20,10,2,0
"20220205FORNEW",2022-02-05,"England League Two","Forest Green","Newport County",2,0,"H",16,6,10,2,7,12,3,3,0,3,0,0,0,0,0,2,22,12,19,6,3,0
"20220205LEYCOL",2022-02-05,"England League Two","Leyton Orient","Colchester",0,1,"A",5,10,4,4,14,13,7,6,2,3,0,0,1,0,1,1,15,8,27,13,5,0
"20220205SCUOLD",2022-02-05,"England League Two","Scunthorpe","Oldham",0,1,"A",8,10,1,1,13,14,2,8,4,3,0,0,0,0,0,1,18,2,27,10,7,0
"20220205SUTBRI",2022-02-05,"England League Two","Sutton","Bristol Rvs",1,1,"D",16,9,10,2,21,6,8,8,4,1,0,0,0,0,0,2,25,12,27,16,5,0
"20220205SWIEXE",2022-02-05,"England League Two","Swindon","Exeter",1,2,"A",6,18,3,7,6,9,6,7,0,0,0,0,0,0,0,3,24,10,15,13,0,0
"20220205WALNOR",2022-02-05,"England League Two","Walsall","Northampton",0,1,"A",9,8,3,7,13,11,4,2,2,2,0,0,0,0,0,1,17,10,24,6,4,0
"20220208CARPOR",2022-02-08,"England League Two","Carlisle","Port Vale",1,3,"A",7,17,1,8,11,8,4,4,0,0,0,0,0,0,0,4,24,9,19,8,0,0
"20220208EXELEY",2022-02-08,"England League Two","Exeter","Leyton Orient",1,0,"H",13,5,3,2,13,9,5,3,2,3,0,0,0,0,0,1,18,5,22,8,5,0
"20220208FORROC",2022-02-08,"England League Two","Forest Green","Rochdale",2,1,"H",13,7,5,1,9,9,8,2,1,1,0,0,0,0,0,3,20,6,18,10,2,0
"20220208HARCRA",2022-02-08,"England League Two","Harrogate","Crawley Town",1,3,"A",9,13,4,4,8,11,2,6,2,2,0,0,0,0,0,4,22,8,19,8,4,0
"20220208HARBAR",2022-02-08,"England League Two","Hartlepool","Barrow",3,1,"H",10,6,4,3,6,13,2,3,1,3,0,0,0,0,0,4,16,7,19,5,4,0
"20220208MANCOL",2022-02-08,"England League Two","Mansfield","Colchester",2,1,"H",12,7,4,1,13,8,5,4,3,2,0,0,0,0,0,3,19,5,21,9,5,0
"20220208NORNEW",2022-02-08,"England League Two","Northampton","Newport County",1,0,"H",13,12,4,6,7,13,6,4,2,2,0,0,0,0,0,1,25,10,20,10,4,0
"20220208OLDBRI",2022-02-08,"England League Two","Oldham","Bristol Rvs",2,1,"H",13,8,5,5,11,15,6,8,1,2,0,0,0,0,0,3,21,10,26,14,3,0
"20220208SCUWAL",2022-02-08,"England League Two","Scunthorpe","Walsall",1,0,"H",8,16,2,5,14,15,1,7,0,1,1,0,0,0,0,1,24,7,29,8,1,1
"20220208STEBRA",2022-02-08,"England League Two","Stevenage","Bradford",0,1,"A",16,14,4,5,6,10,5,8,1,2,0,0,0,0,0,1,30,9,16,13,3,0
"20220208SUTSAL",2022-02-08,"England League Two","Sutton","Salford",0,0,"D",10,9,2,1,12,12,7,5,2,1,0,0,0,0,0,0,19,3,24,12,3,0
"20220208TRASWI",2022-02-08,"England League Two","Tranmere","Swindon",3,0,"H",14,6,5,0,17,11,3,2,1,2,0,0,0,0,0,3,20,5,28,5,3,0
"20220212BARSTE",2022-02-12,"England League Two","Barrow","Stevenage",0,0,"D",11,8,2,4,3,14,8,2,0,0,1,1,0,0,0,0,19,6,17,10,0,2
"20220212BRAEXE",2022-02-12,"England League Two","Bradford","Exeter",0,1,"A",10,14,2,7,9,11,6,9,1,1,0,0,0,0,0,1,24,9,20,15,2,0
"20220212BRIMAN",2022-02-12,"England League Two","Bristol Rvs","Mansfield",0,0,"D",9,6,1,4,7,15,4,4,2,3,0,0,0,0,0,0,15,5,22,8,5,0
"20220212COLCAR",2022-02-12,"England League Two","Colchester","Carlisle",2,2,"D",18,6,4,4,10,10,8,1,1,3,0,0,0,0,0,4,24,8,20,9,4,0
"20220212CRAHAR",2022-02-12,"England League Two","Crawley Town","Hartlepool",0,1,"A",17,9,4,5,9,13,8,2,0,1,0,0,0,0,0,1,26,9,22,10,1,0
"20220212LEYSAL",2022-02-12,"England League Two","Leyton Orient","Salford",0,2,"A",11,10,4,6,17,9,5,5,0,0,0,0,0,0,0,2,21,10,26,10,0,0
"20220212NEWOLD",2022-02-12,"England League Two","Newport County","Oldham",3,3,"D",36,14,12,7,6,7,10,4,1,2,0,1,0,0,0,6,50,19,13,14,3,1
"20220212PORNOR",2022-02-12,"England League Two","Port Vale","Northampton",0,0,"D",10,7,2,1,8,12,3,2,1,3,0,0,0,0,0,0,17,3,20,5,4,0
"20220212ROCHAR",2022-02-12,"England League Two","Rochdale","Harrogate",3,3,"D",18,16,9,9,9,14,11,4,2,1,0,0,0,0,0,6,34,18,23,15,3,0
"20220212SUTFOR",2022-02-12,"England League Two","Sutton","Forest Green",1,1,"D",10,12,4,4,11,11,4,4,1,0,0,0,0,0,0,2,22,8,22,8,1,0
"20220212SWISCU",2022-02-12,"England League Two","Swindon","Scunthorpe",3,0,"H",24,13,9,7,6,11,8,3,1,2,0,0,0,0,0,3,37,16,17,11,3,0
"20220212WALTRA",2022-02-12,"England League Two","Walsall","Tranmere",1,0,"H",7,7,1,1,14,16,6,6,2,1,0,0,0,0,0,1,14,2,30,12,3,0
"20220215BRISUT",2022-02-15,"England League Two","Bristol Rvs","Sutton",2,0,"H",20,15,6,2,9,11,5,6,1,3,0,0,0,0,0,2,35,8,20,11,4,0
"20220215EXEHAR",2022-02-15,"England League Two","Exeter","Harrogate",4,3,"H",19,17,11,10,10,8,12,6,0,2,0,0,0,0,0,7,36,21,18,18,2,0
"20220215HARTRA",2022-02-15,"England League Two","Hartlepool","Tranmere",1,0,"H",8,14,2,3,8,18,3,3,2,2,0,0,0,0,0,1,22,5,26,6,4,0
"20220219NORCOL",2022-02-19,"England League Two","Northampton","Colchester",3,0,"H",13,11,7,2,12,9,4,5,0,1,0,0,0,0,0,3,24,9,21,9,1,0
"20220219CARSWI",2022-02-19,"England League Two","Carlisle","Swindon",0,3,"A",17,17,6,7,10,9,6,3,1,2,0,0,0,0,0,3,34,13,19,9,3,0
"20220219FORWAL",2022-02-19,"England League Two","Forest Green","Walsall",0,1,"A",9,16,1,2,5,9,6,4,3,2,0,0,0,0,0,1,25,3,14,10,5,0
"20220219HARSUT",2022-02-19,"England League Two","Hartlepool","Sutton",1,1,"D",9,10,4,2,8,11,3,3,0,0,0,0,0,0,0,2,19,6,19,6,0,0
"20220219NEWMAN",2022-02-19,"England League Two","Newport County","Mansfield",1,1,"D",17,13,3,3,7,9,4,8,1,3,1,0,0,0,0,2,30,6,16,12,4,1
"20220219OLDBRA",2022-02-19,"England League Two","Oldham","Bradford",2,0,"H",14,10,6,2,8,12,5,6,1,1,0,1,0,0,0,2,24,8,20,11,2,1
"20220219SCUROC",2022-02-19,"England League Two","Scunthorpe","Rochdale",1,2,"A",11,11,4,5,11,14,1,6,3,2,0,0,0,0,0,3,22,9,25,7,5,0
"20220219STEBRI",2022-02-19,"England League Two","Stevenage","Bristol Rvs",0,4,"A",12,24,2,11,10,12,10,8,1,3,0,0,0,0,0,4,36,13,22,18,4,0
"20220219TRAPOR",2022-02-19,"England League Two","Tranmere","Port Vale",1,1,"D",17,10,4,1,13,11,3,4,2,2,0,0,0,0,0,2,27,5,24,7,4,0
"20220222BRAHAR",2022-02-22,"England League Two","Bradford","Harrogate",1,3,"A",25,9,5,3,14,10,10,1,1,2,0,0,0,0,0,4,34,8,24,11,3,0
"20220222COLHAR",2022-02-22,"England League Two","Colchester","Hartlepool",1,2,"A",10,14,5,6,18,5,2,7,2,2,0,0,0,0,0,3,24,11,23,9,4,0
"20220222LEYBRI",2022-02-22,"England League Two","Leyton Orient","Bristol Rvs",0,2,"A",14,11,2,7,13,17,2,1,4,3,0,0,1,0,1,2,25,9,30,3,7,0
"20220222ROCPOR",2022-02-22,"England League Two","Rochdale","Port Vale",1,1,"D",3,10,1,3,9,11,1,8,2,1,0,0,0,0,0,2,13,4,20,9,3,0
"20220222SCUNOR",2022-02-22,"England League Two","Scunthorpe","Northampton",0,0,"D",8,9,2,3,14,19,7,5,2,5,0,0,0,0,0,0,17,5,33,12,7,0
"20220222SWIWAL",2022-02-22,"England League Two","Swindon","Walsall",5,0,"H",20,10,11,3,9,9,3,3,0,2,0,0,0,0,0,5,30,14,18,6,2,0
"20220226BARHAR",2022-02-26,"England League Two","Barrow","Harrogate",0,0,"D",7,6,0,0,8,11,3,1,1,1,0,0,0,0,0,0,13,0,19,4,2,0
"20220226BRAMAN",2022-02-26,"England League Two","Bradford","Mansfield",0,2,"A",14,14,4,5,5,10,5,6,0,4,0,0,0,0,0,2,28,9,15,11,4,0
"20220226BRIEXE",2022-02-26,"England League Two","Bristol Rvs","Exeter",1,1,"D",16,15,5,4,10,9,7,3,0,1,0,0,0,0,0,2,31,9,19,10,1,0
"20220226COLOLD",2022-02-26,"England League Two","Colchester","Oldham",1,1,"D",14,9,5,3,7,8,6,4,1,1,0,0,0,0,0,2,23,8,15,10,2,0
"20220226CRAFOR",2022-02-26,"England League Two","Crawley Town","Forest Green",2,1,"H",11,15,3,5,16,12,5,6,4,2,0,0,0,0,0,3,26,8,28,11,6,0
"20220226LEYCAR",2022-02-26,"England League Two","Leyton Orient","Carlisle",0,1,"A",12,11,4,5,9,12,7,4,1,4,1,0,0,0,0,1,23,9,21,11,5,1
"20220226NEWTRA",2022-02-26,"England League Two","Newport County","Tranmere",4,2,"H",17,6,10,2,10,15,8,1,0,2,0,0,0,0,0,6,23,12,25,9,2,0
"20220226PORSTE",2022-02-26,"England League Two","Port Vale","Stevenage",2,0,"H",6,9,3,2,10,8,3,2,1,1,0,0,0,0,0,2,15,5,18,5,2,0
"20220226ROCNOR",2022-02-26,"England League Two","Rochdale","Northampton",1,0,"H",12,5,2,2,10,14,10,1,0,2,0,0,0,0,0,1,17,4,24,11,2,0
"20220226SUTSCU",2022-02-26,"England League Two","Sutton","Scunthorpe",4,1,"H",12,12,6,3,14,11,2,4,0,1,0,0,0,0,0,5,24,9,25,6,1,0
"20220226SWISAL",2022-02-26,"England League Two","Swindon","Salford",1,2,"A",16,13,5,7,11,9,5,2,0,1,0,0,0,0,0,3,29,12,20,7,1,0
"20220226WALHAR",2022-02-26,"England League Two","Walsall","Hartlepool",3,1,"H",14,12,7,5,13,11,5,6,0,0,0,0,0,0,0,4,26,12,24,11,0,0
"20220301BRIBAR",2022-03-01,"England League Two","Bristol Rvs","Barrow",1,0,"H",19,13,7,6,10,12,10,4,3,0,0,1,0,0,0,1,32,13,22,14,3,1
"20220301CARROC",2022-03-01,"England League Two","Carlisle","Rochdale",2,0,"H",10,23,3,7,10,8,0,6,2,0,0,0,0,0,0,2,33,10,18,6,2,0
"20220301COLLEY",2022-03-01,"England League Two","Colchester","Leyton Orient",2,2,"D",20,6,8,2,13,10,10,2,2,4,0,0,0,0,0,4,26,10,23,12,6,0
"20220301CRAOLD",2022-03-01,"England League Two","Crawley Town","Oldham",2,2,"D",14,9,4,3,17,12,5,4,2,0,0,0,0,0,0,4,23,7,29,9,2,0
"20220301HARPOR",2022-03-01,"England League Two","Harrogate","Port Vale",1,1,"D",9,15,3,3,8,13,4,6,2,1,0,0,0,0,0,2,24,6,21,10,3,0
"20220301NEWFOR",2022-03-01,"England League Two","Newport County","Forest Green",1,1,"D",9,16,3,7,13,11,2,11,4,1,1,0,0,0,0,2,25,10,24,13,5,1
"20220301NORWAL",2022-03-01,"England League Two","Northampton","Walsall",1,1,"D",16,13,4,4,14,11,6,6,3,1,0,0,0,0,0,2,29,8,25,12,4,0
"20220304MANEXE",2022-03-04,"England League Two","Mansfield","Exeter",2,1,"H",9,16,3,10,6,9,4,4,0,0,0,0,0,0,0,3,25,13,15,8,0,0
"20220305HARHAR",2022-03-05,"England League Two","Harrogate","Hartlepool",1,2,"A",13,10,3,4,11,8,6,5,0,0,0,0,0,0,0,3,23,7,19,11,0,0
"20220305BARWAL",2022-03-05,"England League Two","Barrow","Walsall",1,1,"D",7,10,1,3,11,12,4,6,1,2,0,0,0,0,0,2,17,4,23,10,3,0
"20220305BRASWI",2022-03-05,"England League Two","Bradford","Swindon",1,2,"A",10,16,4,8,15,16,4,7,1,3,0,0,0,0,0,3,26,12,31,11,4,0
"20220305COLPOR",2022-03-05,"England League Two","Colchester","Port Vale",1,0,"H",6,10,2,3,7,10,2,5,0,1,0,0,0,0,0,1,16,5,17,7,1,0
"20220305CRASCU",2022-03-05,"England League Two","Crawley Town","Scunthorpe",0,0,"D",13,7,4,3,9,11,4,2,1,1,0,0,0,0,0,0,20,7,20,6,2,0
"20220305LEYSTE",2022-03-05,"England League Two","Leyton Orient","Stevenage",2,2,"D",9,10,5,4,10,16,0,4,1,1,0,0,0,0,0,4,19,9,26,4,2,0
"20220305NEWBRI",2022-03-05,"England League Two","Newport County","Bristol Rvs",1,0,"H",15,15,3,5,14,13,8,6,0,3,0,0,1,1,0,1,30,8,27,14,3,0
"20220305NORTRA",2022-03-05,"England League Two","Northampton","Tranmere",3,2,"H",9,13,5,4,16,17,4,7,2,3,0,0,0,0,0,5,22,9,33,11,5,0
"20220305OLDCAR",2022-03-05,"England League Two","Oldham","Carlisle",1,2,"A",12,15,3,5,9,11,5,4,4,3,0,0,0,0,0,3,27,8,20,9,7,0
"20220305SALFOR",2022-03-05,"England League Two","Salford","Forest Green",1,1,"D",7,12,2,4,9,16,1,10,2,2,0,0,0,0,0,2,19,6,25,11,4,0
"20220305SUTROC",2022-03-05,"England League Two","Sutton","Rochdale",3,0,"H",13,9,8,1,8,12,8,7,1,2,0,0,0,0,0,3,22,9,20,15,3,0
"20220308CRABRI",2022-03-08,"England League Two","Crawley Town","Bristol Rvs",1,2,"A",21,12,6,7,13,16,5,6,3,1,0,0,0,0,0,3,33,13,29,11,4,0
"20220308EXESWI",2022-03-08,"England League Two","Exeter","Swindon",3,1,"H",17,8,6,1,16,13,9,3,0,2,0,0,0,0,0,4,25,7,29,12,2,0
"20220311TRAMAN",2022-03-11,"England League Two","Tranmere","Mansfield",3,2,"H",11,12,3,5,7,13,3,6,0,0,0,0,0,0,0,5,23,8,20,9,0,0
"20220312BRIHAR",2022-03-12,"England League Two","Bristol Rvs","Harrogate",3,0,"H",12,11,4,2,8,14,5,5,3,1,0,0,0,0,0,3,23,6,22,10,4,0
"20220312CARNOR",2022-03-12,"England League Two","Carlisle","Northampton",2,1,"H",12,14,7,2,9,10,0,5,1,3,0,0,0,0,0,3,26,9,19,5,4,0
"20220312EXESAL",2022-03-12,"England League Two","Exeter","Salford",0,0,"D",12,4,3,0,14,8,11,5,0,1,0,0,0,0,0,0,16,3,22,16,1,0
"20220312FORBRA",2022-03-12,"England League Two","Forest Green","Bradford",0,2,"A",17,8,6,5,8,11,7,4,0,1,1,0,0,0,0,2,25,11,19,11,1,1
"20220312HARLEY",2022-03-12,"England League Two","Hartlepool","Leyton Orient",0,0,"D",8,11,3,5,9,19,2,3,0,3,0,0,0,0,0,0,19,8,28,5,3,0
"20220312PORCRA",2022-03-12,"England League Two","Port Vale","Crawley Town",4,1,"H",13,6,5,2,11,9,4,5,0,1,0,0,0,0,0,5,19,7,20,9,1,0
"20220312ROCBAR",2022-03-12,"England League Two","Rochdale","Barrow",0,0,"D",18,9,6,1,15,12,9,2,2,2,0,0,0,0,0,0,27,7,27,11,4,0
"20220312SCUCOL",2022-03-12,"England League Two","Scunthorpe","Colchester",1,3,"A",9,16,2,9,13,11,3,8,1,1,1,0,0,0,0,4,25,11,24,11,2,1
"20220312STENEW",2022-03-12,"England League Two","Stevenage","Newport County",0,2,"A",18,12,2,2,13,6,6,3,0,1,0,0,0,0,0,2,30,4,19,9,1,0
"20220312SWIOLD",2022-03-12,"England League Two","Swindon","Oldham",1,0,"H",21,8,7,2,12,20,3,2,2,6,0,1,0,0,0,1,29,9,32,5,8,1
"20220312WALSUT",2022-03-12,"England League Two","Walsall","Sutton",1,0,"H",11,9,4,1,13,12,4,4,1,3,0,0,0,0,0,1,20,5,25,8,4,0
"20220315BRICOL",2022-03-15,"England League Two","Bristol Rvs","Colchester",1,0,"H",10,9,4,3,11,13,3,7,1,3,0,0,0,0,0,1,19,7,24,10,4,0
"20220315CARNEW",2022-03-15,"England League Two","Carlisle","Newport County",1,2,"A",12,13,2,8,7,6,4,7,0,0,0,0,0,0,0,3,25,10,13,11,0,0
"20220315EXECRA",2022-03-15,"England League Two","Exeter","Crawley Town",2,1,"H",5,9,3,3,16,12,4,4,0,2,0,0,0,0,0,3,14,6,28,8,2,0
"20220315FORLEY",2022-03-15,"England League Two","Forest Green","Leyton Orient",1,1,"D",5,7,2,1,19,5,2,2,2,1,0,0,0,0,0,2,12,3,24,4,3,0
"20220315HARBRA",2022-03-15,"England League Two","Hartlepool","Bradford",0,2,"A",12,10,3,5,13,13,4,1,1,1,0,0,0,0,0,2,22,8,26,5,2,0
"20220315PORMAN",2022-03-15,"England League Two","Port Vale","Mansfield",3,1,"H",7,7,4,2,15,15,2,4,3,3,0,0,0,0,0,4,14,6,30,6,6,0
"20220315ROCSAL",2022-03-15,"England League Two","Rochdale","Salford",1,1,"D",7,16,3,2,14,12,1,3,1,0,0,0,0,0,0,2,23,5,26,4,1,0
"20220315SCUBAR",2022-03-15,"England League Two","Scunthorpe","Barrow",0,1,"A",8,18,2,9,13,9,3,11,1,1,1,1,0,0,0,1,26,11,22,14,2,2
"20220315STENOR",2022-03-15,"England League Two","Stevenage","Northampton",1,2,"A",14,12,4,5,10,14,5,2,0,2,0,0,1,1,0,3,26,9,24,7,2,0
"20220315SWISUT",2022-03-15,"England League Two","Swindon","Sutton",2,1,"H",13,9,5,3,13,15,2,5,2,2,1,0,0,0,0,3,22,8,28,7,4,1
"20220315TRAHAR",2022-03-15,"England League Two","Tranmere","Harrogate",2,0,"H",16,8,7,2,14,9,7,3,3,1,0,1,0,0,0,2,24,9,23,10,4,1
"20220315WALOLD",2022-03-15,"England League Two","Walsall","Oldham",2,1,"H",16,7,6,2,15,9,7,3,3,2,0,0,0,0,0,3,23,8,24,10,5,0
"20220318NEWHAR",2022-03-18,"England League Two","Newport County","Hartlepool",2,3,"A",9,12,6,5,6,13,5,2,0,2,0,0,0,0,0,5,21,11,19,7,2,0
"20220319BARCAR",2022-03-19,"England League Two","Barrow","Carlisle",1,2,"A",9,10,3,2,7,14,5,7,2,3,0,0,0,0,0,3,19,5,21,12,5,0
"20220319BRAPOR",2022-03-19,"England League Two","Bradford","Port Vale",1,2,"A",9,13,1,4,6,14,4,5,1,4,0,0,0,0,0,3,22,5,20,9,5,0
"20220319CRASWI",2022-03-19,"England League Two","Crawley Town","Swindon",3,1,"H",12,20,7,7,18,10,3,5,2,2,0,0,0,0,0,4,32,14,28,8,4,0
"20220319HARWAL",2022-03-19,"England League Two","Harrogate","Walsall",1,1,"D",13,11,5,2,11,18,5,3,4,4,0,0,0,0,0,2,24,7,29,8,8,0
"20220319LEYROC",2022-03-19,"England League Two","Leyton Orient","Rochdale",3,1,"H",12,8,5,4,11,14,6,5,2,2,0,0,0,0,0,4,20,9,25,11,4,0
"20220319NORBRI",2022-03-19,"England League Two","Northampton","Bristol Rvs",0,1,"A",7,5,1,3,18,16,2,7,3,4,0,0,0,0,0,1,12,4,34,9,7,0
"20220319OLDEXE",2022-03-19,"England League Two","Oldham","Exeter",0,2,"A",9,11,4,6,7,12,7,8,2,2,0,1,0,0,0,2,20,10,19,15,4,1
"20220319SALSCU",2022-03-19,"England League Two","Salford","Scunthorpe",5,1,"H",17,10,9,4,6,17,3,4,1,1,0,0,0,0,0,6,27,13,23,7,2,0
"20220319SUTTRA",2022-03-19,"England League Two","Sutton","Tranmere",1,1,"D",13,14,5,4,9,10,4,11,0,1,0,0,0,0,0,2,27,9,19,15,1,0
"20220321COLFOR",2022-03-21,"England League Two","Colchester","Forest Green",0,1,"A",14,10,3,5,12,14,3,1,1,0,0,0,0,0,0,1,24,8,26,4,1,0
"20220322HARLEY",2022-03-22,"England League Two","Harrogate","Leyton Orient",0,3,"A",10,16,3,6,13,12,2,5,2,0,0,0,0,0,0,3,26,9,25,7,2,0
"20220322OLDSUT",2022-03-22,"England League Two","Oldham","Sutton",1,3,"A",12,16,3,6,7,6,6,7,0,0,0,0,0,0,0,4,28,9,13,13,0,0
"20220322POREXE",2022-03-22,"England League Two","Port Vale","Exeter",0,0,"D",13,6,4,2,4,11,8,4,0,1,0,0,0,0,0,0,19,6,15,12,1,0
"20220322ROCMAN",2022-03-22,"England League Two","Rochdale","Mansfield",0,1,"A",10,12,3,7,10,8,5,3,1,0,0,0,0,0,0,1,22,10,18,8,1,0
"20220326BRANEW",2022-03-26,"England League Two","Bradford","Newport County",0,0,"D",14,13,4,4,7,10,4,5,1,2,0,0,0,0,0,0,27,8,17,9,3,0
"20220326CARBRI",2022-03-26,"England League Two","Carlisle","Bristol Rvs",1,0,"H",15,18,5,7,8,9,2,11,4,2,0,0,1,0,1,1,33,12,17,13,6,0
"20220326COLTRA",2022-03-26,"England League Two","Colchester","Tranmere",1,0,"H",7,11,1,2,8,15,4,9,2,4,0,0,0,0,0,1,18,3,23,13,6,0
"20220326CRAROC",2022-03-26,"England League Two","Crawley Town","Rochdale",1,0,"H",12,14,5,3,11,12,5,5,1,0,0,0,0,0,0,1,26,8,23,10,1,0
"20220326EXESTE",2022-03-26,"England League Two","Exeter","Stevenage",2,1,"H",15,9,7,2,10,8,8,4,2,2,0,0,0,0,0,3,24,9,18,12,4,0
"20220326LEYBAR",2022-03-26,"England League Two","Leyton Orient","Barrow",2,0,"H",17,14,5,4,12,18,7,7,2,5,0,0,0,0,0,2,31,9,30,14,7,0
"20220326NORHAR",2022-03-26,"England League Two","Northampton","Hartlepool",2,0,"H",10,8,5,2,8,12,2,8,1,3,0,0,0,0,0,2,18,7,20,10,4,0
"20220326OLDMAN",2022-03-26,"England League Two","Oldham","Mansfield",1,2,"A",13,22,4,10,9,11,5,6,2,1,0,0,0,0,0,3,35,14,20,11,3,0
"20220326PORSUT",2022-03-26,"England League Two","Port Vale","Sutton",2,0,"H",15,10,6,1,13,13,6,6,2,1,0,0,0,0,0,2,25,7,26,12,3,0
"20220326SALWAL",2022-03-26,"England League Two","Salford","Walsall",2,1,"H",11,13,4,3,11,10,5,7,1,3,0,0,0,0,0,3,24,7,21,12,4,0
"20220326SCUHAR",2022-03-26,"England League Two","Scunthorpe","Harrogate",0,3,"A",7,19,3,7,6,8,2,4,1,1,0,0,0,0,0,3,26,10,14,6,2,0
"20220329HARMAN",2022-03-29,"England League Two","Hartlepool","Mansfield",2,2,"D",10,23,6,9,7,18,1,3,0,3,0,0,0,0,0,4,33,15,25,4,3,0
"20220329OLDLEY",2022-03-29,"England League Two","Oldham","Leyton Orient",2,0,"H",10,3,4,1,4,14,6,5,0,2,0,0,0,0,0,2,13,5,18,11,2,0
"20220329ROCCAR",2022-03-29,"England League Two","Rochdale","Carlisle",2,0,"H",8,6,2,2,11,13,1,6,1,3,0,0,0,0,0,2,14,4,24,7,4,0
"20220329SALCRA",2022-03-29,"England League Two","Salford","Crawley Town",2,1,"H",14,11,5,3,11,15,2,9,2,2,0,0,0,0,0,3,25,8,26,11,4,0
"20220402BARPOR",2022-04-02,"England League Two","Barrow","Port Vale",1,2,"A",10,13,2,5,12,12,6,5,2,2,0,0,0,0,0,3,23,7,24,11,4,0
"20220402BRIBRA",2022-04-02,"England League Two","Bristol Rvs","Bradford",2,1,"H",31,9,7,2,8,17,4,3,1,2,0,0,0,0,0,3,40,9,25,7,3,0
"20220402FORSCU",2022-04-02,"England League Two","Forest Green","Scunthorpe",1,0,"H",15,11,6,5,14,14,8,0,1,2,0,0,1,1,0,1,26,11,28,8,3,0
"20220402HARCOL",2022-04-02,"England League Two","Harrogate","Colchester",1,2,"A",11,8,3,5,7,11,7,4,0,3,0,0,0,0,0,3,19,8,18,11,3,0
"20220402HARSAL",2022-04-02,"England League Two","Hartlepool","Salford",0,2,"A",6,10,0,2,14,12,7,1,0,2,0,0,0,0,0,2,16,2,26,8,2,0
"20220402MANNOR",2022-04-02,"England League Two","Mansfield","Northampton",1,0,"H",17,8,5,3,16,9,14,3,3,0,0,1,0,0,0,1,25,8,25,17,3,1
"20220402NEWEXE",2022-04-02,"England League Two","Newport County","Exeter",0,1,"A",11,10,3,3,11,10,6,5,3,0,0,0,0,0,0,1,21,6,21,11,3,0
"20220402ROCSWI",2022-04-02,"England League Two","Rochdale","Swindon",0,0,"D",11,15,4,6,12,15,4,4,1,1,0,0,0,0,0,0,26,10,27,8,2,0
"20220402STEOLD",2022-04-02,"England League Two","Stevenage","Oldham",0,1,"A",15,8,1,2,9,10,7,4,2,2,0,0,0,0,0,1,23,3,19,11,4,0
"20220402TRACAR",2022-04-02,"England League Two","Tranmere","Carlisle",2,2,"D",9,23,4,4,8,11,3,5,4,2,0,0,0,0,0,4,32,8,19,8,6,0
"20220402WALLEY",2022-04-02,"England League Two","Walsall","Leyton Orient",0,2,"A",6,8,1,4,12,11,5,7,0,3,0,0,0,0,0,2,14,5,23,12,3,0
"20220405FORMAN",2022-04-05,"England League Two","Forest Green","Mansfield",1,0,"H",9,9,4,2,18,13,4,4,3,3,0,1,0,0,0,1,18,6,31,8,6,1
"20220405SALPOR",2022-04-05,"England League Two","Salford","Port Vale",0,1,"A",13,13,4,4,11,12,6,3,4,3,0,0,0,0,0,1,26,8,23,9,7,0
"20220409CAREXE",2022-04-09,"England League Two","Carlisle","Exeter",0,1,"A",5,19,2,6,6,7,4,8,4,0,0,0,0,0,0,1,24,8,13,12,4,0
"20220409COLSTE",2022-04-09,"England League Two","Colchester","Stevenage",0,2,"A",18,13,5,6,14,14,7,8,3,3,0,1,0,0,0,2,31,11,28,15,6,1
"20220409CRABAR",2022-04-09,"England League Two","Crawley Town","Barrow",1,0,"H",18,11,5,2,9,15,7,5,0,3,0,0,0,0,0,1,29,7,24,12,3,0
"20220409FORHAR",2022-04-09,"England League Two","Forest Green","Hartlepool",1,1,"D",18,8,5,1,9,7,9,2,1,1,0,0,0,0,0,2,26,6,16,11,2,0
"20220409NORBRA",2022-04-09,"England League Two","Northampton","Bradford",0,0,"D",16,11,5,1,16,13,6,1,1,1,0,0,0,0,0,0,27,6,29,7,2,0
"20220409POROLD",2022-04-09,"England League Two","Port Vale","Oldham",3,2,"H",12,14,5,5,9,9,10,6,3,0,0,0,0,0,0,5,26,10,18,16,3,0
"20220409ROCWAL",2022-04-09,"England League Two","Rochdale","Walsall",1,0,"H",11,7,5,2,14,17,8,5,0,3,0,0,0,0,0,1,18,7,31,13,3,0
"20220409SALHAR",2022-04-09,"England League Two","Salford","Harrogate",2,0,"H",14,11,4,3,6,12,6,4,1,1,0,0,1,1,0,2,25,7,18,10,2,0
"20220409SCUMAN",2022-04-09,"England League Two","Scunthorpe","Mansfield",0,4,"A",5,16,0,6,15,9,3,4,2,1,0,0,0,0,0,4,21,6,24,7,3,0
"20220409SUTLEY",2022-04-09,"England League Two","Sutton","Leyton Orient",1,0,"H",7,9,2,2,14,18,4,5,1,3,0,0,0,0,0,1,16,4,32,9,4,0
"20220409SWINEW",2022-04-09,"England League Two","Swindon","Newport County",0,1,"A",12,4,2,1,10,15,5,4,0,2,0,0,0,0,0,1,16,3,25,9,2,0
"20220409TRABRI",2022-04-09,"England League Two","Tranmere","Bristol Rvs",1,1,"D",12,11,4,2,16,11,5,12,3,0,0,0,0,0,0,2,23,6,27,17,3,0
"20220415EXECOL",2022-04-15,"England League Two","Exeter","Colchester",2,0,"H",16,1,8,0,9,9,8,0,0,1,0,0,0,0,0,2,17,8,18,8,1,0
"20220415BARFOR",2022-04-15,"England League Two","Barrow","Forest Green",4,0,"H",11,8,4,2,15,15,7,7,3,3,0,0,0,0,0,4,19,6,30,14,6,0
"20220415BRATRA",2022-04-15,"England League Two","Bradford","Tranmere",1,1,"D",15,15,6,2,9,16,4,3,2,3,1,0,0,0,0,2,30,8,25,7,5,1
"20220415BRISAL",2022-04-15,"England League Two","Bristol Rvs","Salford",1,0,"H",16,9,4,2,7,12,9,4,3,3,0,0,1,1,0,1,25,6,19,13,6,0
"20220415HARSWI",2022-04-15,"England League Two","Harrogate","Swindon",1,4,"A",13,15,6,8,6,7,4,1,1,0,0,0,0,0,0,5,28,14,13,5,1,0
"20220415HARPOR",2022-04-15,"England League Two","Hartlepool","Port Vale",0,1,"A",11,12,1,3,6,6,5,6,2,0,0,0,0,0,0,1,23,4,12,11,2,0
"20220415LEYSCU",2022-04-15,"England League Two","Leyton Orient","Scunthorpe",3,0,"H",22,12,7,3,8,10,2,5,2,1,0,0,0,0,0,3,34,10,18,7,3,0
"20220415MANSUT",2022-04-15,"England League Two","Mansfield","Sutton",2,3,"A",14,8,5,5,12,14,6,7,1,0,0,0,0,0,0,5,22,10,26,13,1,0
"20220415NEWCRA",2022-04-15,"England League Two","Newport County","Crawley Town",1,2,"A",15,9,5,4,10,12,3,4,1,0,0,0,0,0,0,3,24,9,22,7,1,0
"20220415OLDNOR",2022-04-15,"England League Two","Oldham","Northampton",0,2,"A",9,13,3,5,10,13,3,4,1,4,1,0,0,0,0,2,22,8,23,7,5,1
"20220415STEROC",2022-04-15,"England League Two","Stevenage","Rochdale",1,0,"H",7,10,3,2,8,8,3,6,1,1,0,0,0,0,0,1,17,5,16,9,2,0
"20220415WALCAR",2022-04-15,"England League Two","Walsall","Carlisle",1,0,"H",12,13,2,2,8,12,2,6,3,1,0,0,0,0,0,1,25,4,20,8,4,0
"20220418CARMAN",2022-04-18,"England League Two","Carlisle","Mansfield",1,0,"H",15,17,4,5,5,6,8,8,4,0,0,0,0,0,0,1,32,9,11,16,4,0
"20220418COLBRA",2022-04-18,"England League Two","Colchester","Bradford",3,0,"H",8,9,4,2,9,16,1,2,0,0,0,1,0,0,0,3,17,6,25,3,0,1
"20220418CRAWAL",2022-04-18,"England League Two","Crawley Town","Walsall",1,0,"H",8,13,3,5,13,7,3,6,0,0,0,0,0,0,0,1,21,8,20,9,0,0
"20220418FOROLD",2022-04-18,"England League Two","Forest Green","Oldham",2,0,"H",15,14,8,4,13,14,6,7,1,3,0,0,0,0,0,2,29,12,27,13,4,0
"20220418NORHAR",2022-04-18,"England League Two","Northampton","Harrogate",3,0,"H",12,5,4,1,9,10,4,2,0,2,0,0,0,0,0,3,17,5,19,6,2,0
"20220418PORBRI",2022-04-18,"England League Two","Port Vale","Bristol Rvs",1,3,"A",12,10,2,4,16,7,6,4,2,6,0,0,0,0,0,4,22,6,23,10,8,0
"20220418ROCHAR",2022-04-18,"England League Two","Rochdale","Hartlepool",2,1,"H",14,7,7,2,5,8,4,6,1,0,0,0,0,0,0,3,21,9,13,10,1,0
"20220418SALBAR",2022-04-18,"England League Two","Salford","Barrow",2,2,"D",13,13,4,5,13,10,4,5,1,2,0,0,0,0,0,4,26,9,23,9,3,0
"20220418SCUSTE",2022-04-18,"England League Two","Scunthorpe","Stevenage",1,1,"D",9,23,1,9,12,6,3,5,2,0,0,0,0,0,0,2,32,10,18,8,2,0
"20220418SUTNEW",2022-04-18,"England League Two","Sutton","Newport County",1,0,"H",7,13,1,3,6,13,3,6,5,2,0,0,0,0,0,1,20,4,19,9,7,0
"20220418SWILEY",2022-04-18,"England League Two","Swindon","Leyton Orient",1,2,"A",17,5,7,3,8,9,6,3,2,4,0,1,0,0,0,3,22,10,17,9,6,1
"20220418TRAEXE",2022-04-18,"England League Two","Tranmere","Exeter",2,0,"H",11,14,4,1,13,11,5,6,2,2,0,0,0,0,0,2,25,5,24,11,4,0
"20220422NEWCOL",2022-04-22,"England League Two","Newport County","Colchester",1,2,"A",11,10,3,3,12,10,2,3,3,3,0,0,0,0,0,3,21,6,22,5,6,0
"20220423BARSUT",2022-04-23,"England League Two","Barrow","Sutton",1,0,"H",10,8,1,1,11,12,5,5,1,1,1,0,0,0,0,1,18,2,23,10,2,1
"20220423BRASCU",2022-04-23,"England League Two","Bradford","Scunthorpe",2,1,"H",27,3,7,1,8,16,4,2,0,1,0,0,0,0,0,3,30,8,24,6,1,0
"20220423BRIFOR",2022-04-23,"England League Two","Bristol Rvs","Forest Green",0,0,"D",15,15,5,8,14,15,5,6,5,4,0,0,1,0,1,0,30,13,29,11,9,0
"20220423EXEROC",2022-04-23,"England League Two","Exeter","Rochdale",2,0,"H",14,8,5,4,9,11,3,4,3,2,0,0,0,0,0,2,22,9,20,7,5,0
"20220423HARCAR",2022-04-23,"England League Two","Harrogate","Carlisle",3,0,"H",17,7,7,4,7,9,3,11,2,2,0,0,0,0,0,3,24,11,16,14,4,0
"20220423HARSWI",2022-04-23,"England League Two","Hartlepool","Swindon",0,3,"A",13,18,2,8,14,15,6,5,1,1,0,0,0,0,0,3,31,10,29,11,2,0
"20220423LEYNOR",2022-04-23,"England League Two","Leyton Orient","Northampton",2,4,"A",13,13,4,6,9,17,3,2,0,5,1,0,0,0,0,6,26,10,26,5,5,1
"20220423MANCRA",2022-04-23,"England League Two","Mansfield","Crawley Town",2,0,"H",17,5,10,0,17,16,5,3,2,0,0,1,0,0,0,2,22,10,33,8,2,1
"20220423OLDSAL",2022-04-23,"England League Two","Oldham","Salford",1,2,"A",15,10,6,5,7,15,8,2,0,2,0,0,0,0,0,3,25,11,22,10,2,0
"20220423STETRA",2022-04-23,"England League Two","Stevenage","Tranmere",2,0,"H",16,8,3,1,13,11,6,2,2,1,0,0,0,0,0,2,24,4,24,8,3,0
"20220423WALPOR",2022-04-23,"England League Two","Walsall","Port Vale",2,0,"H",12,8,2,2,11,15,4,9,2,1,0,0,0,0,0,2,20,4,26,13,3,0
"20220426EXEBAR",2022-04-26,"England League Two","Exeter","Barrow",2,1,"H",12,5,6,2,13,9,7,3,2,1,0,0,0,0,0,3,17,8,22,10,3,0
"20220426MANSTE",2022-04-26,"England League Two","Mansfield","Stevenage",2,0,"H",14,10,4,3,7,9,7,6,2,2,0,0,0,0,0,2,24,7,16,13,4,0
"20220426SUTCRA",2022-04-26,"England League Two","Sutton","Crawley Town",3,0,"H",14,10,4,4,8,12,3,5,1,3,0,0,0,0,0,3,24,8,20,8,4,0
"20220426SWIFOR",2022-04-26,"England League Two","Swindon","Forest Green",2,1,"H",7,19,3,6,17,15,3,8,3,4,1,0,0,0,0,3,26,9,32,11,7,1
"20220430CARSTE",2022-04-30,"England League Two","Carlisle","Stevenage",2,1,"H",16,12,4,2,10,5,5,2,0,1,0,0,0,0,0,3,28,6,15,7,1,0
"20220430COLWAL",2022-04-30,"England League Two","Colchester","Walsall",2,2,"D",18,15,4,7,9,13,3,3,0,1,0,0,0,0,0,4,33,11,22,6,1,0
"20220430CRALEY",2022-04-30,"England League Two","Crawley Town","Leyton Orient",0,2,"A",18,12,3,7,7,8,7,0,5,1,0,0,0,0,0,2,30,10,15,7,6,0
"20220430FORHAR",2022-04-30,"England League Two","Forest Green","Harrogate",1,3,"A",20,11,6,4,11,11,11,1,1,1,0,0,0,0,0,4,31,10,22,12,2,0
"20220430NOREXE",2022-04-30,"England League Two","Northampton","Exeter",1,1,"D",16,8,5,3,14,9,8,5,1,5,0,0,0,0,0,2,24,8,23,13,6,0
"20220430ROCBRI",2022-04-30,"England League Two","Rochdale","Bristol Rvs",3,4,"A",13,24,5,10,14,7,2,6,4,1,0,1,0,0,0,7,37,15,21,8,5,1
"20220430SCUHAR",2022-04-30,"England League Two","Scunthorpe","Hartlepool",1,1,"D",10,23,5,5,12,6,3,7,2,2,0,0,0,0,0,2,33,10,18,10,4,0
"20220430SUTBRA",2022-04-30,"England League Two","Sutton","Bradford",1,4,"A",11,21,1,12,14,17,5,8,2,3,0,0,0,0,0,5,32,13,31,13,5,0
"20220430SWIBAR",2022-04-30,"England League Two","Swindon","Barrow",2,1,"H",17,12,6,4,7,18,10,2,1,3,0,0,1,1,0,3,29,10,25,12,4,0
"20220430TRAOLD",2022-04-30,"England League Two","Tranmere","Oldham",2,0,"H",17,9,6,1,15,9,5,4,2,0,0,0,0,0,0,2,26,7,24,9,2,0
"20220502SALMAN",2022-05-02,"England League Two","Salford","Mansfield",2,2,"D",17,14,6,5,10,16,6,6,4,1,0,0,0,0,0,4,31,11,26,12,5,0
"20220502PORNEW",2022-05-02,"England League Two","Port Vale","Newport County",1,2,"A",7,10,2,6,12,18,2,8,1,0,0,0,0,0,0,3,17,8,30,10,1,0
"20220507BARNOR",2022-05-07,"England League Two","Barrow","Northampton",1,3,"A",13,9,3,4,11,13,7,2,2,2,0,1,0,0,0,4,22,7,24,9,4,1
"20220507BRACAR",2022-05-07,"England League Two","Bradford","Carlisle",2,0,"H",18,11,6,3,15,10,3,1,1,4,0,0,0,0,0,2,29,9,25,4,5,0
"20220507BRISCU",2022-05-07,"England League Two","Bristol Rvs","Scunthorpe",7,0,"H",34,5,14,1,10,17,19,3,0,4,0,0,0,0,0,7,39,15,27,22,4,0
"20220507EXEPOR",2022-05-07,"England League Two","Exeter","Port Vale",0,1,"A",17,6,3,2,11,7,12,2,1,3,0,0,0,0,0,1,23,5,18,14,4,0
"20220507HARSUT",2022-05-07,"England League Two","Harrogate","Sutton",0,2,"A",23,17,5,8,7,8,11,7,0,1,0,0,0,0,0,2,40,13,15,18,1,0
"20220507HARCOL",2022-05-07,"England League Two","Hartlepool","Colchester",0,2,"A",19,10,7,7,15,10,7,3,1,1,0,0,0,0,0,2,29,14,25,10,2,0
"20220507LEYTRA",2022-05-07,"England League Two","Leyton Orient","Tranmere",0,1,"A",10,9,2,1,9,13,10,3,1,4,0,0,0,0,0,1,19,3,22,13,5,0
"20220507MANFOR",2022-05-07,"England League Two","Mansfield","Forest Green",2,2,"D",14,15,4,5,12,6,4,8,1,1,0,0,1,1,0,4,29,9,18,12,2,0
"20220507NEWROC",2022-05-07,"England League Two","Newport County","Rochdale",0,2,"A",14,11,2,3,7,7,7,3,0,0,0,0,0,0,0,2,25,5,14,10,0,0
"20220507OLDCRA",2022-05-07,"England League Two","Oldham","Crawley Town",3,3,"D",11,25,7,10,7,12,3,10,0,1,0,0,0,0,0,6,36,17,19,13,1,0
"20220507STESAL",2022-05-07,"England League Two","Stevenage","Salford",4,2,"H",13,23,4,8,7,7,3,7,1,0,0,0,1,1,0,6,36,12,14,10,1,0
"20220507WALSWI",2022-05-07,"England League Two","Walsall","Swindon",0,3,"A",15,12,2,5,11,13,7,5,2,2,0,0,0,0,0,3,27,7,24,12,4,0
"20220730AFCGIL",2022-07-30,"England League Two","AFC Wimbledon","Gillingham",2,0,"H",7,5,5,1,12,17,3,4,3,5,0,0,0,0,0,2,12,6,29,7,8,0
"20220730BRADON",2022-07-30,"England League Two","Bradford","Doncaster",0,0,"D",22,3,2,1,11,9,7,6,0,3,1,1,0,0,0,0,25,3,20,13,3,2
"20220730CARCRA",2022-07-30,"England League Two","Carlisle","Crawley Town",1,0,"H",23,6,8,0,9,6,6,4,1,3,0,0,0,0,0,1,29,8,15,10,4,0
"20220730HARSWI",2022-07-30,"England League Two","Harrogate","Swindon",3,0,"H",14,10,5,1,11,7,4,5,3,0,0,0,0,0,0,3,24,6,18,9,3,0
"20220730LEYGRI",2022-07-30,"England League Two","Leyton Orient","Grimsby",2,0,"H",14,10,5,6,9,7,3,2,3,2,0,0,0,0,0,2,24,11,16,5,5,0
"20220730NORCOL",2022-07-30,"England League Two","Northampton","Colchester",3,2,"H",11,5,4,4,15,13,3,4,1,4,0,0,0,0,0,5,16,8,28,7,5,0
"20220730ROCCRE",2022-07-30,"England League Two","Rochdale","Crewe",1,2,"A",12,9,4,3,10,9,6,1,2,2,0,0,0,0,0,3,21,7,19,7,4,0
"20220730SALMAN",2022-07-30,"England League Two","Salford","Mansfield",2,0,"H",8,14,3,4,11,19,3,9,2,0,0,0,0,0,0,2,22,7,30,12,2,0
"20220730STOBAR",2022-07-30,"England League Two","Stockport","Barrow",2,3,"A",11,10,5,7,13,9,4,3,2,4,0,0,0,0,0,5,21,12,22,7,6,0
"20220730SUTNEW",2022-07-30,"England League Two","Sutton","Newport County",1,1,"D",12,7,3,3,10,16,4,7,3,3,0,0,0,0,0,2,19,6,26,11,6,0
"20220730TRASTE",2022-07-30,"England League Two","Tranmere","Stevenage",1,2,"A",8,16,4,10,15,9,5,9,1,3,0,0,0,0,0,3,24,14,24,14,4,0
"20220730WALHAR",2022-07-30,"England League Two","Walsall","Hartlepool",4,0,"H",21,4,11,2,8,13,8,2,0,2,0,0,0,0,0,4,25,13,21,10,2,0
"20220806BARBRA",2022-08-06,"England League Two","Barrow","Bradford",3,2,"H",14,7,4,6,15,19,4,6,1,2,0,0,0,0,0,5,21,10,34,10,3,0
"20220806COLCAR",2022-08-06,"England League Two","Colchester","Carlisle",1,1,"D",12,11,5,5,13,8,5,5,0,2,0,0,0,0,0,2,23,10,21,10,2,0
"20220806CRALEY",2022-08-06,"England League Two","Crawley Town","Leyton Orient",0,1,"A",3,11,1,2,8,14,6,3,0,0,0,0,0,0,0,1,14,3,22,9,0,0
"20220806CREHAR",2022-08-06,"England League Two","Crewe","Harrogate",3,0,"H",12,10,5,3,12,11,5,1,2,0,0,0,0,0,0,3,22,8,23,6,2,0
"20220806DONSUT",2022-08-06,"England League Two","Doncaster","Sutton",2,1,"H",12,15,4,4,13,21,2,3,1,3,0,0,1,1,0,3,27,8,34,5,4,0
"20220806GILROC",2022-08-06,"England League Two","Gillingham","Rochdale",1,0,"H",13,5,5,1,12,15,7,6,3,1,0,0,0,0,0,1,18,6,27,13,4,0
"20220806GRINOR",2022-08-06,"England League Two","Grimsby","Northampton",1,1,"D",23,8,9,4,17,16,5,1,0,1,0,0,0,0,0,2,31,13,33,6,1,0
"20220806HARAFC",2022-08-06,"England League Two","Hartlepool","AFC Wimbledon",0,0,"D",12,7,2,4,12,12,6,5,3,0,0,0,0,0,0,0,19,6,24,11,3,0
"20220806MANTRA",2022-08-06,"England League Two","Mansfield","Tranmere",1,0,"H",17,6,9,3,15,10,12,4,2,1,0,0,0,0,0,1,23,12,25,16,3,0
"20220806NEWWAL",2022-08-06,"England League Two","Newport County","Walsall",0,1,"A",13,3,2,0,8,15,7,1,0,3,0,1,0,0,0,1,16,2,23,8,3,1
"20220806STESTO",2022-08-06,"England League Two","Stevenage","Stockport",2,1,"H",16,4,3,2,15,19,4,4,1,2,0,1,0,0,0,3,20,5,34,8,3,1
"20220806SWISAL",2022-08-06,"England League Two","Swindon","Salford",0,0,"D",9,15,2,4,15,6,3,6,6,1,1,0,0,0,0,0,24,6,21,9,7,1
"20220813AFCDON",2022-08-13,"England League Two","AFC Wimbledon","Doncaster",2,2,"D",16,13,6,4,17,8,3,11,2,4,0,0,1,0,1,4,29,10,25,14,6,0
"20220813BRANEW",2022-08-13,"England League Two","Bradford","Newport County",2,0,"H",9,9,3,2,10,15,6,4,1,3,0,1,1,0,1,2,18,5,25,10,4,1
"20220813CARSWI",2022-08-13,"England League Two","Carlisle","Swindon",1,1,"D",17,11,5,6,6,12,5,3,1,2,0,0,1,1,0,2,28,11,18,8,3,0
"20220813HARCRA",2022-08-13,"England League Two","Harrogate","Crawley Town",0,0,"D",15,11,5,4,9,9,8,5,0,0,0,0,0,0,0,0,26,9,18,13,0,0
"20220813LEYMAN",2022-08-13,"England League Two","Leyton Orient","Mansfield",1,0,"H",6,16,3,7,10,7,4,9,4,2,0,0,1,0,1,1,22,10,17,13,6,0
"20220813NORHAR",2022-08-13,"England League Two","Northampton","Hartlepool",2,1,"H",20,11,10,3,7,8,2,2,3,3,0,0,0,0,0,3,31,13,15,4,6,0
"20220813ROCGRI",2022-08-13,"England League Two","Rochdale","Grimsby",0,1,"A",16,14,3,5,12,17,8,5,4,2,0,0,0,0,0,1,30,8,29,13,6,0
"20220813SALCRE",2022-08-13,"England League Two","Salford","Crewe",3,0,"H",17,3,6,0,11,16,2,2,2,2,0,1,0,0,0,3,20,6,27,4,4,1
"20220813STOCOL",2022-08-13,"England League Two","Stockport","Colchester",1,0,"H",21,2,7,0,10,13,4,1,0,2,0,0,0,0,0,1,23,7,23,5,2,0
"20220813SUTBAR",2022-08-13,"England League Two","Sutton","Barrow",1,0,"H",9,7,6,3,14,8,4,5,0,1,0,0,0,0,0,1,16,9,22,9,1,0
"20220813TRAGIL",2022-08-13,"England League Two","Tranmere","Gillingham",3,0,"H",11,9,4,0,10,7,2,2,0,2,0,0,0,0,0,3,20,4,17,4,2,0
"20220813WALSTE",2022-08-13,"England League Two","Walsall","Stevenage",1,1,"D",6,14,1,4,13,12,3,3,2,2,0,0,0,0,0,2,20,5,25,6,4,0
"20220816BARWAL",2022-08-16,"England League Two","Barrow","Walsall",2,1,"H",7,7,5,1,8,9,10,3,1,2,0,0,0,0,0,3,14,6,17,13,3,0
"20220816COLBRA",2022-08-16,"England League Two","Colchester","Bradford",1,0,"H",16,15,4,3,12,11,5,8,0,4,0,0,0,0,0,1,31,7,23,13,4,0
"20220816CRANOR",2022-08-16,"England League Two","Crawley Town","Northampton",2,3,"A",8,11,5,7,10,8,2,3,0,1,0,0,0,0,0,5,19,12,18,5,1,0
"20220816CRESUT",2022-08-16,"England League Two","Crewe","Sutton",1,0,"H",10,20,4,6,16,16,4,5,1,2,0,0,1,1,0,1,30,10,32,9,3,0
"20220816DONSTO",2022-08-16,"England League Two","Doncaster","Stockport",2,1,"H",20,2,8,1,8,12,10,2,1,2,0,1,0,0,0,3,22,9,20,12,3,1
"20220816GILHAR",2022-08-16,"England League Two","Gillingham","Harrogate",0,2,"A",15,13,2,5,8,9,11,6,5,3,0,0,0,0,0,2,28,7,17,17,8,0
"20220816HARTRA",2022-08-16,"England League Two","Hartlepool","Tranmere",0,0,"D",7,13,1,5,8,12,7,9,3,2,0,0,0,0,0,0,20,6,20,16,5,0
"20220816MANAFC",2022-08-16,"England League Two","Mansfield","AFC Wimbledon",5,2,"H",13,5,6,2,16,12,7,3,2,4,0,1,0,0,0,7,18,8,28,10,6,1
"20220816NEWSAL",2022-08-16,"England League Two","Newport County","Salford",2,3,"A",12,12,4,6,10,7,4,4,3,2,0,0,0,0,0,5,24,10,17,8,5,0
"20220816STEROC",2022-08-16,"England League Two","Stevenage","Rochdale",1,0,"H",17,3,6,1,11,13,8,2,1,2,0,0,0,0,0,1,20,7,24,10,3,0
"20220816SWILEY",2022-08-16,"England League Two","Swindon","Leyton Orient",1,1,"D",7,18,3,9,11,8,2,6,1,2,0,0,1,1,0,2,25,12,19,8,3,0
"20220820HARBRA",2022-08-20,"England League Two","Hartlepool","Bradford",1,3,"A",5,11,2,6,7,9,3,7,0,2,0,0,0,0,0,4,16,8,16,10,2,0
"20220820BARHAR",2022-08-20,"England League Two","Barrow","Harrogate",1,0,"H",11,5,3,1,13,11,7,1,4,4,0,0,0,0,0,1,16,4,24,8,8,0
"20220820COLLEY",2022-08-20,"England League Two","Colchester","Leyton Orient",1,3,"A",7,16,3,6,10,8,6,3,0,3,0,0,0,0,0,4,23,9,18,9,3,0
"20220820CRAAFC",2022-08-20,"England League Two","Crawley Town","AFC Wimbledon",0,2,"A",10,9,2,4,13,13,5,1,1,2,1,0,0,0,0,2,19,6,26,6,3,1
"20220820CRENOR",2022-08-20,"England League Two","Crewe","Northampton",2,2,"D",6,14,3,4,7,8,5,8,2,2,0,0,0,0,0,4,20,7,15,13,4,0
"20220820DONSAL",2022-08-20,"England League Two","Doncaster","Salford",2,1,"H",11,13,6,3,10,15,5,6,0,3,0,0,0,0,0,3,24,9,25,11,3,0
"20220820GILWAL",2022-08-20,"England League Two","Gillingham","Walsall",0,0,"D",9,9,2,1,9,17,6,5,0,4,0,0,0,0,0,0,18,3,26,11,4,0
"20220820GRISUT",2022-08-20,"England League Two","Grimsby","Sutton",0,0,"D",9,13,3,4,17,11,5,6,3,2,0,0,0,0,0,0,22,7,28,11,5,0
"20220820MANSTO",2022-08-20,"England League Two","Mansfield","Stockport",2,1,"H",14,9,6,2,13,8,6,2,1,1,0,0,0,0,0,3,23,8,21,8,2,0
"20220820NEWTRA",2022-08-20,"England League Two","Newport County","Tranmere",2,1,"H",13,5,5,1,11,9,4,3,1,0,0,0,0,0,0,3,18,6,20,7,1,0
"20220820STECAR",2022-08-20,"England League Two","Stevenage","Carlisle",2,1,"H",19,11,5,6,8,8,6,4,2,1,0,0,0,0,0,3,30,11,16,10,3,0
"20220820SWIROC",2022-08-20,"England League Two","Swindon","Rochdale",3,0,"H",20,5,10,0,7,7,10,3,2,2,0,0,0,0,0,3,25,10,14,13,4,0
"20220827AFCBAR",2022-08-27,"England League Two","AFC Wimbledon","Barrow",0,1,"A",11,10,2,3,17,9,4,1,2,2,0,0,0,0,0,1,21,5,26,5,4,0
"20220827BRACRE",2022-08-27,"England League Two","Bradford","Crewe",0,0,"D",11,8,2,2,8,6,4,6,2,0,0,0,0,0,0,0,19,4,14,10,2,0
"20220827CARGIL",2022-08-27,"England League Two","Carlisle","Gillingham",1,0,"H",6,8,2,3,9,11,1,4,1,2,0,0,0,0,0,1,14,5,20,5,3,0
"20220827HARNEW",2022-08-27,"England League Two","Harrogate","Newport County",0,4,"A",7,8,0,3,5,17,2,1,0,2,0,0,0,0,0,4,15,3,22,3,2,0
"20220827LEYHAR",2022-08-27,"England League Two","Leyton Orient","Hartlepool",4,2,"H",21,8,7,2,10,12,2,1,3,3,0,0,0,0,0,6,29,9,22,3,6,0
"20220827NORDON",2022-08-27,"England League Two","Northampton","Doncaster",0,1,"A",10,11,3,2,13,11,3,5,2,1,0,0,0,0,0,1,21,5,24,8,3,0
"20220827ROCCRA",2022-08-27,"England League Two","Rochdale","Crawley Town",1,1,"D",9,4,6,1,10,8,6,2,2,2,0,1,0,0,0,2,13,7,18,8,4,1
"20220827SALSTE",2022-08-27,"England League Two","Salford","Stevenage",1,0,"H",12,8,5,2,9,10,7,5,0,1,0,0,2,1,1,1,20,7,19,12,1,0
"20220827STOSWI",2022-08-27,"England League Two","Stockport","Swindon",1,1,"D",13,11,4,2,10,10,5,6,2,2,1,0,0,0,0,2,24,6,20,11,4,1
"20220827SUTMAN",2022-08-27,"England League Two","Sutton","Mansfield",2,1,"H",10,8,3,3,14,10,5,9,3,2,0,0,0,0,0,3,18,6,24,14,5,0
"20220827TRACOL",2022-08-27,"England League Two","Tranmere","Colchester",2,0,"H",9,3,4,0,9,6,4,1,1,1,0,0,0,0,0,2,12,4,15,5,2,0
"20220827WALGRI",2022-08-27,"England League Two","Walsall","Grimsby",1,2,"A",14,8,7,3,3,11,4,2,1,1,0,0,0,0,0,3,22,10,14,6,2,0
"20220903BRAWAL",2022-09-03,"England League Two","Bradford","Walsall",2,1,"H",9,24,3,6,3,9,4,10,2,1,0,0,0,0,0,3,33,9,12,14,3,0
"20220903CARROC",2022-09-03,"England League Two","Carlisle","Rochdale",3,3,"D",15,9,4,4,11,6,5,4,0,1,0,0,0,0,0,6,24,8,17,9,1,0
"20220903COLHAR",2022-09-03,"England League Two","Colchester","Hartlepool",1,1,"D",11,7,5,1,9,14,8,3,2,3,0,0,0,0,0,2,18,6,23,11,5,0
"20220903CRESTE",2022-09-03,"England League Two","Crewe","Stevenage",1,2,"A",11,10,4,5,17,15,11,3,3,2,0,0,0,0,0,3,21,9,32,14,5,0
"20220903DONMAN",2022-09-03,"England League Two","Doncaster","Mansfield",1,3,"A",9,16,5,5,10,18,3,4,1,3,0,0,0,0,0,4,25,10,28,7,4,0
"20220903GILSWI",2022-09-03,"England League Two","Gillingham","Swindon",0,0,"D",8,23,2,4,8,9,5,8,0,1,1,0,0,0,0,0,31,6,17,13,1,1
"20220903LEYTRA",2022-09-03,"England League Two","Leyton Orient","Tranmere",2,0,"H",10,9,2,3,8,10,7,2,3,1,0,0,0,0,0,2,19,5,18,9,4,0
"20220903NEWGRI",2022-09-03,"England League Two","Newport County","Grimsby",0,2,"A",12,13,5,6,10,14,1,5,2,2,0,0,0,0,0,2,25,11,24,6,4,0
"20220903NORBAR",2022-09-03,"England League Two","Northampton","Barrow",3,1,"H",14,16,5,5,15,8,6,4,4,4,0,0,0,0,0,4,30,10,23,10,8,0
"20220903SALCRA",2022-09-03,"England League Two","Salford","Crawley Town",2,2,"D",19,8,6,3,15,21,6,3,1,5,0,0,0,0,0,4,27,9,36,9,6,0
"20220903STOAFC",2022-09-03,"England League Two","Stockport","AFC Wimbledon",1,0,"H",16,8,9,1,11,12,13,3,1,1,0,0,0,0,0,1,24,10,23,16,2,0
"20220903SUTHAR",2022-09-03,"England League Two","Sutton","Harrogate",2,1,"H",20,7,7,1,8,7,14,3,1,2,0,1,0,0,0,3,27,8,15,17,3,1
"20220913AFCNOR",2022-09-13,"England League Two","AFC Wimbledon","Northampton",0,2,"A",11,7,3,5,17,15,7,5,3,1,0,0,0,0,0,2,18,8,32,12,4,0
"20220913BARDON",2022-09-13,"England League Two","Barrow","Doncaster",2,0,"H",20,7,8,1,10,10,4,2,1,2,0,0,0,0,0,2,27,9,20,6,3,0
"20220913CRASTO",2022-09-13,"England League Two","Crawley Town","Stockport",3,2,"H",5,14,4,7,10,8,0,7,2,0,0,0,0,0,0,5,19,11,18,7,2,0
"20220913GRIGIL",2022-09-13,"England League Two","Grimsby","Gillingham",1,1,"D",15,10,6,3,13,10,5,5,1,2,0,0,1,1,0,2,25,9,23,10,3,0
"20220913HARSAL",2022-09-13,"England League Two","Harrogate","Salford",0,1,"A",14,18,2,6,13,10,4,5,1,3,0,0,0,0,0,1,32,8,23,9,4,0
"20220913HARCRE",2022-09-13,"England League Two","Hartlepool","Crewe",1,1,"D",15,11,5,3,11,9,4,2,0,1,0,0,0,0,0,2,26,8,20,6,1,0
"20220913MANCAR",2022-09-13,"England League Two","Mansfield","Carlisle",0,0,"D",12,6,3,3,12,16,6,0,1,3,0,0,0,0,0,0,18,6,28,6,4,0
"20220913ROCLEY",2022-09-13,"England League Two","Rochdale","Leyton Orient",0,1,"A",5,13,2,4,6,9,4,4,2,3,0,0,0,0,0,1,18,6,15,8,5,0
"20220913STENEW",2022-09-13,"England League Two","Stevenage","Newport County",1,0,"H",14,7,2,1,9,12,7,0,3,0,0,0,0,0,0,1,21,3,21,7,3,0
"20220913SWISUT",2022-09-13,"England League Two","Swindon","Sutton",3,2,"H",18,15,9,8,5,8,8,9,2,2,0,0,0,0,0,5,33,17,13,17,4,0
"20220913TRABRA",2022-09-13,"England League Two","Tranmere","Bradford",1,2,"A",9,13,2,8,14,10,6,7,3,1,0,0,0,0,0,3,22,10,24,13,4,0
"20220913WALCOL",2022-09-13,"England League Two","Walsall","Colchester",1,1,"D",10,8,3,1,16,17,3,3,2,4,0,0,0,0,0,2,18,4,33,6,6,0
"20220917BRASTE",2022-09-17,"England League Two","Bradford","Stevenage",3,0,"H",12,14,6,3,14,14,2,11,1,1,1,0,0,0,0,3,26,9,28,13,2,1
"20220917CARAFC",2022-09-17,"England League Two","Carlisle","AFC Wimbledon",2,1,"H",17,6,7,2,10,9,11,2,2,4,0,0,0,0,0,3,23,9,19,13,6,0
"20220917COLGRI",2022-09-17,"England League Two","Colchester","Grimsby",0,1,"A",10,6,1,4,13,9,6,3,1,2,0,0,0,0,0,1,16,5,22,9,3,0
"20220917CRECRA",2022-09-17,"England League Two","Crewe","Crawley Town",1,0,"H",16,8,6,2,9,5,9,2,2,0,0,0,0,0,0,1,24,8,14,11,2,0
"20220917DONSWI",2022-09-17,"England League Two","Doncaster","Swindon",0,1,"A",8,11,3,4,7,14,4,7,1,1,0,0,0,0,0,1,19,7,21,11,2,0
"20220917GILMAN",2022-09-17,"England League Two","Gillingham","Mansfield",0,2,"A",6,14,2,3,13,10,5,10,1,1,0,0,0,0,0,2,20,5,23,15,2,0
"20220917LEYWAL",2022-09-17,"England League Two","Leyton Orient","Walsall",1,0,"H",9,7,4,3,14,7,4,5,1,1,0,0,0,0,0,1,16,7,21,9,2,0
"20220917NEWBAR",2022-09-17,"England League Two","Newport County","Barrow",0,2,"A",12,11,1,2,17,14,7,1,1,1,0,0,0,0,0,2,23,3,31,8,2,0
"20220917NORROC",2022-09-17,"England League Two","Northampton","Rochdale",3,0,"H",12,10,5,2,6,15,2,6,0,3,0,0,0,0,0,3,22,7,21,8,3,0
"20220917SALTRA",2022-09-17,"England League Two","Salford","Tranmere",0,1,"A",8,13,0,4,9,23,4,5,2,2,0,0,0,0,0,1,21,4,32,9,4,0
"20220917STOHAR",2022-09-17,"England League Two","Stockport","Harrogate",0,0,"D",13,9,2,4,10,9,4,3,1,3,0,0,0,0,0,0,22,6,19,7,4,0
"20220917SUTHAR",2022-09-17,"England League Two","Sutton","Hartlepool",2,0,"H",10,8,6,1,7,9,6,7,0,1,0,0,0,0,0,2,18,7,16,13,1,0
"20220924NORSTO",2022-09-24,"England League Two","Northampton","Stockport",2,1,"H",9,11,3,2,18,21,1,4,2,2,0,1,0,0,0,3,20,5,39,5,4,1
"20220924BARLEY",2022-09-24,"England League Two","Barrow","Leyton Orient",0,2,"A",13,11,4,3,6,12,7,6,0,4,1,0,0,0,0,2,24,7,18,13,4,1
"20220924BRAAFC",2022-09-24,"England League Two","Bradford","AFC Wimbledon",2,2,"D",12,10,4,4,10,13,8,6,2,3,0,0,0,0,0,4,22,8,23,14,5,0
"20220924COLROC",2022-09-24,"England League Two","Colchester","Rochdale",0,1,"A",7,10,1,6,12,9,8,4,2,3,0,0,0,0,0,1,17,7,21,12,5,0
"20220924CREMAN",2022-09-24,"England League Two","Crewe","Mansfield",1,2,"A",13,16,2,6,18,16,4,8,2,2,0,0,0,0,0,3,29,8,34,12,4,0
"20220924DONCRA",2022-09-24,"England League Two","Doncaster","Crawley Town",4,1,"H",17,9,6,3,12,17,7,5,0,1,0,0,0,0,0,5,26,9,29,12,1,0
"20220924GRISWI",2022-09-24,"England League Two","Grimsby","Swindon",1,2,"A",16,13,8,4,13,15,3,7,1,3,0,1,0,0,0,3,29,12,28,10,4,1
"20220924HARGIL",2022-09-24,"England League Two","Hartlepool","Gillingham",0,0,"D",15,4,3,0,14,14,7,2,1,3,0,0,0,0,0,0,19,3,28,9,4,0
"20220924NEWCAR",2022-09-24,"England League Two","Newport County","Carlisle",1,1,"D",7,10,3,2,8,10,0,6,3,1,0,0,0,0,0,2,17,5,18,6,4,0
"20220924STEHAR",2022-09-24,"England League Two","Stevenage","Harrogate",1,0,"H",24,4,8,1,12,13,8,3,1,0,0,0,0,0,0,1,28,9,25,11,1,0
"20220924SUTSAL",2022-09-24,"England League Two","Sutton","Salford",1,2,"A",13,14,2,4,21,10,4,3,1,4,1,0,0,0,0,3,27,6,31,7,5,1
"20220924WALTRA",2022-09-24,"England League Two","Walsall","Tranmere",0,1,"A",11,7,3,6,8,14,4,3,1,2,0,0,0,0,0,1,18,9,22,7,3,0
"20220927GRICAR",2022-09-27,"England League Two","Grimsby","Carlisle",1,2,"A",18,5,4,3,9,11,7,1,1,2,0,0,0,0,0,3,23,7,20,8,3,0
"20220930MANHAR",2022-09-30,"England League Two","Mansfield","Hartlepool",2,2,"D",14,7,6,2,11,10,11,1,2,1,0,0,0,0,0,4,21,8,21,12,3,0
"20221001HARBRA",2022-10-01,"England League Two","Harrogate","Bradford",1,2,"A",12,7,6,3,9,6,6,4,2,1,0,0,0,0,0,3,19,9,15,10,3,0
"20221001AFCCOL",2022-10-01,"England League Two","AFC Wimbledon","Colchester",2,1,"H",10,10,4,3,19,14,7,8,5,3,0,0,0,0,0,3,20,7,33,15,8,0
"20221001CARCRE",2022-10-01,"England League Two","Carlisle","Crewe",0,0,"D",6,9,3,2,14,5,7,3,1,3,0,0,0,0,0,0,15,5,19,10,4,0
"20221001CRASTE",2022-10-01,"England League Two","Crawley Town","Stevenage",1,2,"A",13,22,4,5,16,4,3,4,3,0,0,0,0,0,0,3,35,9,20,7,3,0
"20221001GILSUT",2022-10-01,"England League Two","Gillingham","Sutton",1,0,"H",14,8,6,2,10,12,7,5,0,2,0,0,0,0,0,1,22,8,22,12,2,0
"20221001LEYNEW",2022-10-01,"England League Two","Leyton Orient","Newport County",1,2,"A",20,5,5,2,11,7,14,2,1,0,0,0,3,3,0,3,25,7,18,16,1,0
"20221001ROCDON",2022-10-01,"England League Two","Rochdale","Doncaster",1,2,"A",7,8,1,2,11,6,6,4,0,1,0,0,0,0,0,3,15,3,17,10,1,0
"20221001SALGRI",2022-10-01,"England League Two","Salford","Grimsby",1,1,"D",13,18,5,6,4,16,4,12,0,1,0,0,0,0,0,2,31,11,20,16,1,0
"20221001STOWAL",2022-10-01,"England League Two","Stockport","Walsall",1,1,"D",18,6,4,3,9,16,7,2,0,3,0,0,0,0,0,2,24,7,25,9,3,0
"20221001SWINOR",2022-10-01,"England League Two","Swindon","Northampton",1,2,"A",8,9,1,3,11,11,10,4,2,2,0,0,0,0,0,3,17,4,22,14,4,0
"20221001TRABAR",2022-10-01,"England League Two","Tranmere","Barrow",1,0,"H",12,5,6,1,8,9,7,2,1,2,0,0,0,0,0,1,17,7,17,9,3,0
"20221004HARDON",2022-10-04,"England League Two","Hartlepool","Doncaster",2,1,"H",19,14,6,4,11,7,4,4,0,1,0,0,0,0,0,3,33,10,18,8,1,0
"20221004STESUT",2022-10-04,"England League Two","Stevenage","Sutton",3,0,"H",11,6,7,0,12,16,2,2,2,5,0,0,0,0,0,3,17,7,28,4,7,0
"20221004SWINEW",2022-10-04,"England League Two","Swindon","Newport County",1,0,"H",20,10,8,4,5,8,8,3,3,1,0,0,0,0,0,1,30,12,13,11,4,0
"20221004WALNOR",2022-10-04,"England League Two","Walsall","Northampton",1,0,"H",13,7,5,0,9,4,4,9,4,2,0,0,0,0,0,1,20,5,13,13,6,0
"20221008BARMAN",2022-10-08,"England League Two","Barrow","Mansfield",0,1,"A",10,11,3,2,15,14,4,9,1,3,0,0,0,0,0,1,21,5,29,13,4,0
"20221008BRASTO",2022-10-08,"England League Two","Bradford","Stockport",0,1,"A",7,14,1,5,16,16,4,7,2,2,0,0,0,0,0,1,21,6,32,11,4,0
"20221008COLHAR",2022-10-08,"England League Two","Colchester","Harrogate",2,1,"H",13,11,6,3,14,18,5,4,3,3,0,0,0,0,0,3,24,9,32,9,6,0
"20221008CREGIL",2022-10-08,"England League Two","Crewe","Gillingham",1,1,"D",11,10,4,2,11,18,5,7,2,0,0,0,0,0,0,2,21,6,29,12,2,0
"20221008DONLEY",2022-10-08,"England League Two","Doncaster","Leyton Orient",1,1,"D",5,14,4,6,11,11,0,6,1,1,0,0,0,0,0,2,19,10,22,6,2,0
"20221008GRICRA",2022-10-08,"England League Two","Grimsby","Crawley Town",3,0,"H",13,9,6,2,14,6,6,10,2,1,0,0,1,0,1,3,22,8,20,16,3,0
"20221008HARCAR",2022-10-08,"England League Two","Hartlepool","Carlisle",1,3,"A",13,13,2,5,10,8,3,9,1,0,0,0,1,1,0,4,26,7,18,12,1,0
"20221008NEWROC",2022-10-08,"England League Two","Newport County","Rochdale",0,1,"A",21,7,3,3,10,17,13,2,1,5,0,0,0,0,0,1,28,6,27,15,6,0
"20221008NORSAL",2022-10-08,"England League Two","Northampton","Salford",0,1,"A",12,7,4,2,13,14,4,1,2,0,0,0,0,0,0,1,19,6,27,5,2,0
"20221008STESWI",2022-10-08,"England League Two","Stevenage","Swindon",2,0,"H",15,10,5,0,14,8,2,7,1,2,0,0,1,0,1,2,25,5,22,9,3,0
"20221008SUTTRA",2022-10-08,"England League Two","Sutton","Tranmere",0,2,"A",7,13,0,3,6,12,2,3,1,2,0,0,0,0,0,2,20,3,18,5,3,0
"20221008WALAFC",2022-10-08,"England League Two","Walsall","AFC Wimbledon",3,1,"H",6,12,3,3,11,16,2,7,3,2,0,0,1,1,0,4,18,6,27,9,5,0
"20221014TRACRE",2022-10-14,"England League Two","Tranmere","Crewe",3,0,"H",16,6,7,0,7,5,6,6,1,0,0,0,0,0,0,3,22,7,12,12,1,0
"20221015HARHAR",2022-10-15,"England League Two","Harrogate","Hartlepool",2,1,"H",15,14,6,5,5,10,2,6,0,0,0,0,0,0,0,3,29,11,15,8,0,0
"20221015MANWAL",2022-10-15,"England League Two","Mansfield","Walsall",2,1,"H",13,5,4,2,10,13,1,5,1,0,0,0,1,1,0,3,18,6,23,6,1,0
"20221015AFCSUT",2022-10-15,"England League Two","AFC Wimbledon","Sutton",0,1,"A",5,13,1,7,19,17,4,8,2,3,0,0,0,0,0,1,18,8,36,12,5,0
"20221015CARDON",2022-10-15,"England League Two","Carlisle","Doncaster",3,0,"H",23,5,8,1,8,7,5,3,1,2,0,0,0,0,0,3,28,9,15,8,3,0
"20221015CRANEW",2022-10-15,"England League Two","Crawley Town","Newport County",2,1,"H",10,13,4,6,13,14,4,3,1,3,0,0,0,0,0,3,23,10,27,7,4,0
"20221015GILSTE",2022-10-15,"England League Two","Gillingham","Stevenage",1,1,"D",6,8,2,1,9,17,2,4,1,3,0,0,0,0,0,2,14,3,26,6,4,0
"20221015LEYNOR",2022-10-15,"England League Two","Leyton Orient","Northampton",0,0,"D",14,8,3,2,7,14,5,4,0,3,0,1,0,0,0,0,22,5,21,9,3,1
"20221015ROCBAR",2022-10-15,"England League Two","Rochdale","Barrow",2,1,"H",14,11,6,2,16,13,2,8,3,2,0,0,0,0,0,3,25,8,29,10,5,0
"20221015SALBRA",2022-10-15,"England League Two","Salford","Bradford",0,1,"A",3,10,1,4,10,11,5,2,1,1,0,0,0,0,0,1,13,5,21,7,2,0
"20221015STOGRI",2022-10-15,"England League Two","Stockport","Grimsby",1,3,"A",9,13,5,5,10,14,4,5,1,5,1,0,0,0,0,4,22,10,24,9,6,1
"20221015SWICOL",2022-10-15,"England League Two","Swindon","Colchester",1,0,"H",16,5,3,1,9,8,15,3,1,2,0,0,0,0,0,1,21,4,17,18,3,0
"20221022CARLEY",2022-10-22,"England League Two","Carlisle","Leyton Orient",2,3,"A",14,11,2,4,7,11,7,4,4,3,1,0,0,0,0,5,25,6,18,11,7,1
"20221022CRAMAN",2022-10-22,"England League Two","Crawley Town","Mansfield",3,2,"H",10,11,6,3,13,10,3,0,4,1,0,0,0,0,0,5,21,9,23,3,5,0
"20221022CREDON",2022-10-22,"England League Two","Crewe","Doncaster",1,1,"D",15,11,6,4,14,10,7,4,3,0,0,0,0,0,0,2,26,10,24,11,3,0
"20221022GILBAR",2022-10-22,"England League Two","Gillingham","Barrow",1,1,"D",10,14,3,6,12,8,3,4,0,2,0,0,0,0,0,2,24,9,20,7,2,0
"20221022GRIBRA",2022-10-22,"England League Two","Grimsby","Bradford",0,0,"D",15,11,4,2,10,10,8,5,1,1,0,0,0,0,0,0,26,6,20,13,2,0
"20221022HARTRA",2022-10-22,"England League Two","Harrogate","Tranmere",1,1,"D",12,14,1,5,14,9,6,9,3,1,0,0,0,0,0,2,26,6,23,15,4,0
"20221022NEWCOL",2022-10-22,"England League Two","Newport County","Colchester",1,0,"H",9,6,4,1,8,7,3,5,0,0,0,0,1,1,0,1,15,5,15,8,0,0
"20221022ROCAFC",2022-10-22,"England League Two","Rochdale","AFC Wimbledon",1,2,"A",11,9,3,5,12,18,3,4,1,4,0,0,0,0,0,3,20,8,30,7,5,0
"20221022SALSTO",2022-10-22,"England League Two","Salford","Stockport",0,2,"A",15,10,3,5,13,10,6,5,2,0,0,0,0,0,0,2,25,8,23,11,2,0
"20221022STENOR",2022-10-22,"England League Two","Stevenage","Northampton",2,3,"A",7,14,3,4,9,15,4,10,1,3,0,1,0,0,0,5,21,7,24,14,4,1
"20221022SUTWAL",2022-10-22,"England League Two","Sutton","Walsall",1,1,"D",15,8,5,2,7,10,7,3,1,1,0,1,0,0,0,2,23,7,17,10,2,1
"20221022SWIHAR",2022-10-22,"England League Two","Swindon","Hartlepool",2,1,"H",13,4,6,3,11,9,7,3,3,2,0,0,0,0,0,3,17,9,20,10,5,0
"20221025AFCCRE",2022-10-25,"England League Two","AFC Wimbledon","Crewe",1,1,"D",14,10,6,1,14,16,6,9,1,5,0,0,0,0,0,2,24,7,30,15,6,0
"20221025BARGRI",2022-10-25,"England League Two","Barrow","Grimsby",1,0,"H",13,9,3,2,8,14,8,7,2,2,0,0,0,0,0,1,22,5,22,15,4,0
"20221025BRASWI",2022-10-25,"England League Two","Bradford","Swindon",1,1,"D",14,17,5,8,7,9,4,10,0,1,0,0,0,0,0,2,31,13,16,14,1,0
"20221025COLCRA",2022-10-25,"England League Two","Colchester","Crawley Town",2,2,"D",13,7,4,2,7,12,9,6,1,3,0,0,0,0,0,4,20,6,19,15,4,0
"20221025DONSTE",2022-10-25,"England League Two","Doncaster","Stevenage",0,1,"A",11,6,2,3,8,14,4,0,2,1,0,0,0,0,0,1,17,5,22,4,3,0
"20221025HARSAL",2022-10-25,"England League Two","Hartlepool","Salford",0,2,"A",15,9,1,6,8,8,5,7,0,1,0,0,0,0,0,2,24,7,16,12,1,0
"20221025LEYGIL",2022-10-25,"England League Two","Leyton Orient","Gillingham",2,0,"H",9,10,2,1,13,10,1,4,2,1,0,0,1,0,1,2,19,3,23,5,3,0
"20221025MANNEW",2022-10-25,"England League Two","Mansfield","Newport County",0,0,"D",6,16,2,3,10,16,5,4,0,2,1,0,0,0,0,0,22,5,26,9,2,1
"20221025NORSUT",2022-10-25,"England League Two","Northampton","Sutton",2,2,"D",11,11,5,2,10,11,5,5,1,2,0,0,0,0,0,4,22,7,21,10,3,0
"20221025STOCAR",2022-10-25,"England League Two","Stockport","Carlisle",2,0,"H",16,8,5,1,8,12,4,3,0,2,0,0,0,0,0,2,24,6,20,7,2,0
"20221025TRAROC",2022-10-25,"England League Two","Tranmere","Rochdale",1,1,"D",16,6,6,3,10,6,6,0,1,1,0,0,0,0,0,2,22,9,16,6,2,0
"20221025WALHAR",2022-10-25,"England League Two","Walsall","Harrogate",3,1,"H",15,6,6,1,8,13,6,2,0,3,0,0,0,0,0,4,21,7,21,8,3,0
"20221029NORNEW",2022-10-29,"England League Two","Northampton","Newport County",1,1,"D",10,14,3,7,10,9,3,5,2,0,0,0,0,0,0,2,24,10,19,8,2,0
"20221029AFCHAR",2022-10-29,"England League Two","AFC Wimbledon","Harrogate",3,2,"H",12,12,4,7,10,10,6,4,2,0,0,0,0,0,0,5,24,11,20,10,2,0
"20221029BARCRE",2022-10-29,"England League Two","Barrow","Crewe",3,0,"H",12,9,8,2,18,14,10,3,3,2,0,0,0,0,0,3,21,10,32,13,5,0
"20221029BRACRA",2022-10-29,"England League Two","Bradford","Crawley Town",1,1,"D",23,13,7,5,8,7,11,7,1,2,0,0,0,0,0,2,36,12,15,18,3,0
"20221029COLSTE",2022-10-29,"England League Two","Colchester","Stevenage",1,1,"D",5,19,1,4,13,10,2,8,1,3,0,0,0,0,0,2,24,5,23,10,4,0
"20221029DONGIL",2022-10-29,"England League Two","Doncaster","Gillingham",1,0,"H",14,5,5,3,7,15,6,3,1,2,0,0,0,0,0,1,19,8,22,9,3,0
"20221029HARGRI",2022-10-29,"England League Two","Hartlepool","Grimsby",2,1,"H",10,11,3,4,12,15,4,6,2,2,0,0,0,0,0,3,21,7,27,10,4,0
"20221029LEYSAL",2022-10-29,"England League Two","Leyton Orient","Salford",1,0,"H",17,7,4,0,11,13,7,1,1,3,0,0,0,0,0,1,24,4,24,8,4,0
"20221029MANSWI",2022-10-29,"England League Two","Mansfield","Swindon",2,5,"A",14,17,8,11,15,9,5,3,3,2,1,0,0,0,0,7,31,19,24,8,5,1
"20221029STOSUT",2022-10-29,"England League Two","Stockport","Sutton",3,0,"H",17,6,6,1,3,7,9,3,1,2,0,1,0,0,0,3,23,7,10,12,3,1
"20221029TRACAR",2022-10-29,"England League Two","Tranmere","Carlisle",0,2,"A",9,6,3,3,10,9,7,0,0,2,0,0,0,0,0,2,15,6,19,7,2,0
"20221029WALROC",2022-10-29,"England League Two","Walsall","Rochdale",1,0,"H",9,10,3,2,12,11,6,3,2,1,0,0,0,0,0,1,19,5,23,9,3,0
"20221101BARCOL",2022-11-01,"England League Two","Barrow","Colchester",3,1,"H",10,6,4,2,8,13,8,3,2,1,0,0,0,0,0,4,16,6,21,11,3,0
"20221101TRASTO",2022-11-01,"England League Two","Tranmere","Stockport",0,0,"D",5,15,1,2,12,5,2,8,1,0,0,0,0,0,0,0,20,3,17,10,1,0
"20221108AFCLEY",2022-11-08,"England League Two","AFC Wimbledon","Leyton Orient",2,0,"H",7,10,3,3,18,20,0,5,4,5,0,0,0,0,0,2,17,6,38,5,9,0
"20221108HARCAR",2022-11-08,"England League Two","Harrogate","Carlisle",3,3,"D",17,14,8,4,2,10,6,8,0,1,0,0,0,0,0,6,31,12,12,14,1,0
"20221108MANBRA",2022-11-08,"England League Two","Mansfield","Bradford",1,2,"A",6,10,3,5,11,9,9,1,2,2,0,1,0,0,0,3,16,8,20,10,4,1
"20221108ROCSAL",2022-11-08,"England League Two","Rochdale","Salford",1,0,"H",9,11,2,1,8,9,5,2,1,1,0,0,0,0,0,1,20,3,17,7,2,0
"20221112CARWAL",2022-11-12,"England League Two","Carlisle","Walsall",0,0,"D",9,9,1,1,11,9,11,4,0,0,0,0,0,0,0,0,18,2,20,15,0,0
"20221112CRABAR",2022-11-12,"England League Two","Crawley Town","Barrow",1,0,"H",6,19,2,4,18,7,2,12,2,2,0,0,0,0,0,1,25,6,25,14,4,0
"20221112CRECOL",2022-11-12,"England League Two","Crewe","Colchester",1,0,"H",9,12,3,6,16,17,1,7,2,3,0,0,0,0,0,1,21,9,33,8,5,0
"20221112GILNOR",2022-11-12,"England League Two","Gillingham","Northampton",0,2,"A",8,11,3,4,15,14,3,1,0,2,0,0,0,0,0,2,19,7,29,4,2,0
"20221112GRIDON",2022-11-12,"England League Two","Grimsby","Doncaster",1,3,"A",8,14,4,4,13,5,6,5,3,0,0,0,0,0,0,4,22,8,18,11,3,0
"20221112HARLEY",2022-11-12,"England League Two","Harrogate","Leyton Orient",0,2,"A",16,15,6,6,10,8,7,3,2,0,0,0,0,0,0,2,31,12,18,10,2,0
"20221112NEWSTO",2022-11-12,"England League Two","Newport County","Stockport",1,2,"A",9,12,6,3,13,6,4,4,2,0,0,0,0,0,0,3,21,9,19,8,2,0
"20221112ROCMAN",2022-11-12,"England League Two","Rochdale","Mansfield",0,1,"A",4,13,1,3,9,14,2,5,3,2,0,0,0,0,0,1,17,4,23,7,5,0
"20221112SALAFC",2022-11-12,"England League Two","Salford","AFC Wimbledon",0,0,"D",11,8,3,4,13,13,7,2,3,1,0,0,0,0,0,0,19,7,26,9,4,0
"20221112STEHAR",2022-11-12,"England League Two","Stevenage","Hartlepool",1,0,"H",12,6,6,2,7,19,6,2,1,4,0,0,0,0,0,1,18,8,26,8,5,0
"20221112SUTBRA",2022-11-12,"England League Two","Sutton","Bradford",0,2,"A",9,11,1,4,16,13,5,2,0,3,0,0,0,0,0,2,20,5,29,7,3,0
"20221112SWITRA",2022-11-12,"England League Two","Swindon","Tranmere",1,1,"D",9,8,3,3,8,12,4,0,0,2,0,1,0,0,0,2,17,6,20,4,2,1
"20221119BARHAR",2022-11-19,"England League Two","Barrow","Hartlepool",3,1,"H",9,9,5,5,11,10,2,2,0,4,0,0,0,0,0,4,18,10,21,4,4,0
"20221119BRANOR",2022-11-19,"England League Two","Bradford","Northampton",1,3,"A",12,14,6,6,10,10,3,4,1,1,0,0,0,0,0,4,26,12,20,7,2,0
"20221119COLDON",2022-11-19,"England League Two","Colchester","Doncaster",3,0,"H",11,9,6,0,15,8,9,6,3,3,0,0,0,0,0,3,20,6,23,15,6,0
"20221119GRISTE",2022-11-19,"England League Two","Grimsby","Stevenage",1,1,"D",17,12,3,4,14,8,4,5,1,2,0,0,0,0,0,2,29,7,22,9,3,0
"20221119HARMAN",2022-11-19,"England League Two","Harrogate","Mansfield",3,0,"H",10,16,6,4,9,12,4,9,3,2,0,0,0,0,0,3,26,10,21,13,5,0
"20221119NEWGIL",2022-11-19,"England League Two","Newport County","Gillingham",2,0,"H",9,13,3,2,12,16,7,2,2,3,0,0,0,0,0,2,22,5,28,9,5,0
"20221119SALCAR",2022-11-19,"England League Two","Salford","Carlisle",1,4,"A",14,18,5,7,8,9,8,6,3,1,0,0,0,0,0,5,32,12,17,14,4,0
"20221119STOLEY",2022-11-19,"England League Two","Stockport","Leyton Orient",1,2,"A",12,6,5,4,15,17,2,2,0,2,0,0,0,0,0,3,18,9,32,4,2,0
"20221119SUTROC",2022-11-19,"England League Two","Sutton","Rochdale",1,0,"H",11,11,4,3,12,6,2,9,0,0,0,0,0,0,0,1,22,7,18,11,0,0
"20221119SWICRE",2022-11-19,"England League Two","Swindon","Crewe",0,1,"A",18,10,7,2,5,8,9,3,2,1,0,0,0,0,0,1,28,9,13,12,3,0
"20221119TRAAFC",2022-11-19,"England League Two","Tranmere","AFC Wimbledon",0,2,"A",12,8,3,5,11,10,7,4,2,1,1,0,0,0,0,2,20,8,21,11,3,1
"20221119WALCRA",2022-11-19,"England League Two","Walsall","Crawley Town",2,1,"H",24,6,9,2,9,12,8,2,0,2,0,1,1,0,1,3,30,11,21,10,2,1
"20221122CRAGIL",2022-11-22,"England League Two","Crawley Town","Gillingham",0,0,"D",8,8,1,1,10,14,4,3,0,2,0,0,0,0,0,0,16,2,24,7,2,0
"20221202CRENEW",2022-12-02,"England League Two","Crewe","Newport County",1,2,"A",7,18,2,4,12,12,2,6,2,3,0,0,1,0,1,3,25,6,24,8,5,0
"20221202DONWAL",2022-12-02,"England League Two","Doncaster","Walsall",0,2,"A",14,10,1,3,5,11,5,4,0,0,0,0,0,0,0,2,24,4,16,9,0,0
"20221202STEBAR",2022-12-02,"England League Two","Stevenage","Barrow",5,0,"H",8,10,4,0,14,14,5,2,2,1,0,0,0,0,0,5,18,4,28,7,3,0
"20221203AFCGRI",2022-12-03,"England League Two","AFC Wimbledon","Grimsby",1,0,"H",12,6,2,1,9,18,5,4,3,1,0,0,0,0,0,1,18,3,27,9,4,0
"20221203GILSAL",2022-12-03,"England League Two","Gillingham","Salford",0,3,"A",12,13,3,5,8,10,7,2,1,0,0,0,0,0,0,3,25,8,18,9,1,0
"20221203LEYBRA",2022-12-03,"England League Two","Leyton Orient","Bradford",3,0,"H",10,8,7,2,14,9,5,3,0,1,0,0,0,0,0,3,18,9,23,8,1,0
"20221203CARSUT",2022-12-03,"England League Two","Carlisle","Sutton",1,1,"D",9,11,1,5,6,8,8,8,2,3,0,0,0,0,0,2,20,6,14,16,5,0
"20221203CRASWI",2022-12-03,"England League Two","Crawley Town","Swindon",2,0,"H",13,10,5,0,17,8,2,6,1,1,0,0,0,0,0,2,23,5,25,8,2,0
"20221203HARSTO",2022-12-03,"England League Two","Hartlepool","Stockport",0,5,"A",7,11,1,8,13,8,1,3,0,2,0,0,0,0,0,5,18,9,21,4,2,0
"20221203MANCOL",2022-12-03,"England League Two","Mansfield","Colchester",2,1,"H",12,5,6,2,11,9,1,2,2,2,0,0,0,0,0,3,17,8,20,3,4,0
"20221203NORTRA",2022-12-03,"England League Two","Northampton","Tranmere",0,0,"D",14,14,3,5,4,12,7,4,1,3,0,0,0,0,0,0,28,8,16,11,4,0
"20221203ROCHAR",2022-12-03,"England League Two","Rochdale","Harrogate",1,4,"A",11,10,2,4,12,10,6,5,2,1,0,0,0,0,0,5,21,6,22,11,3,0
"20221209CRAHAR",2022-12-09,"England League Two","Crawley Town","Hartlepool",0,2,"A",8,5,1,2,7,8,3,3,0,0,0,0,0,0,0,2,13,3,15,6,0,0
"20221210GRITRA",2022-12-10,"England League Two","Grimsby","Tranmere",2,1,"H",15,8,5,2,11,12,9,3,1,1,0,0,0,0,0,3,23,7,23,12,2,0
"20221210NEWDON",2022-12-10,"England League Two","Newport County","Doncaster",0,1,"A",12,15,1,4,13,10,6,6,0,2,0,0,0,0,0,1,27,5,23,12,2,0
"20221210STEMAN",2022-12-10,"England League Two","Stevenage","Mansfield",0,0,"D",7,5,1,2,9,8,3,2,1,0,0,0,0,0,0,0,12,3,17,5,1,0
"20221210SUTCOL",2022-12-10,"England League Two","Sutton","Colchester",1,0,"H",14,7,7,0,9,16,5,2,3,3,0,1,0,0,0,1,21,7,25,7,6,1
"20221210SWIAFC",2022-12-10,"England League Two","Swindon","AFC Wimbledon",0,0,"D",12,12,1,6,9,17,6,7,2,4,0,0,0,0,0,0,24,7,26,13,6,0
"20221217BARSWI",2022-12-17,"England League Two","Barrow","Swindon",0,1,"A",7,16,0,8,13,12,6,3,1,3,0,0,0,0,0,1,23,8,25,9,4,0
"20221217LEYSUT",2022-12-17,"England League Two","Leyton Orient","Sutton",2,0,"H",7,2,1,1,12,16,4,3,2,1,0,0,0,0,0,2,9,2,28,7,3,0
"20221220NORCAR",2022-12-20,"England League Two","Northampton","Carlisle",2,1,"H",14,9,4,2,13,10,8,3,3,2,0,0,0,0,0,3,23,6,23,11,5,0
"20221226AFCNEW",2022-12-26,"England League Two","AFC Wimbledon","Newport County",1,1,"D",7,13,2,4,12,14,4,3,0,4,1,0,0,0,0,2,20,6,26,7,4,1
"20221226CARBRA",2022-12-26,"England League Two","Carlisle","Bradford",1,0,"H",11,7,5,0,7,16,9,3,0,2,0,0,0,0,0,1,18,5,23,12,2,0
"20221226CRASUT",2022-12-26,"England League Two","Crawley Town","Sutton",1,2,"A",3,9,2,5,12,17,4,2,1,2,0,0,0,0,0,3,12,7,29,6,3,0
"20221226GILCOL",2022-12-26,"England League Two","Gillingham","Colchester",0,1,"A",7,7,2,2,12,15,6,1,3,1,0,0,0,0,0,1,14,4,27,7,4,0
"20221226HARGRI",2022-12-26,"England League Two","Harrogate","Grimsby",3,2,"H",12,16,3,8,10,11,3,4,2,1,0,0,0,0,0,5,28,11,21,7,3,0
"20221226MANNOR",2022-12-26,"England League Two","Mansfield","Northampton",1,1,"D",8,15,3,4,11,10,2,5,3,1,0,0,0,0,0,2,23,7,21,7,4,0
"20221226ROCHAR",2022-12-26,"England League Two","Rochdale","Hartlepool",1,2,"A",9,15,2,7,9,16,6,9,1,3,0,0,0,0,0,3,24,9,25,15,4,0
"20221226SALBAR",2022-12-26,"England League Two","Salford","Barrow",1,1,"D",8,19,2,4,11,17,2,7,2,3,1,0,0,0,0,2,27,6,28,9,5,1
"20221226STOCRE",2022-12-26,"England League Two","Stockport","Crewe",2,0,"H",25,0,9,0,12,10,5,5,0,1,0,0,0,0,0,2,25,9,22,10,1,0
"20221226SWIWAL",2022-12-26,"England League Two","Swindon","Walsall",1,2,"A",13,11,3,2,9,12,4,6,1,1,0,0,0,0,0,3,24,5,21,10,2,0
"20221226TRADON",2022-12-26,"England League Two","Tranmere","Doncaster",3,0,"H",11,9,5,2,6,8,2,5,1,2,0,0,0,0,0,3,20,7,14,7,3,0
"20221227LEYSTE",2022-12-27,"England League Two","Leyton Orient","Stevenage",0,0,"D",11,12,4,3,14,20,6,3,2,2,0,0,0,0,0,0,23,7,34,9,4,0
"20221229CRECAR",2022-12-29,"England League Two","Crewe","Carlisle",0,3,"A",6,14,1,6,6,9,6,8,1,1,1,0,0,0,0,3,20,7,15,14,2,1
"20221229BARTRA",2022-12-29,"England League Two","Barrow","Tranmere",1,2,"A",17,11,4,7,12,13,5,4,1,0,0,1,0,0,0,3,28,11,25,9,1,1
"20221229BRAHAR",2022-12-29,"England League Two","Bradford","Harrogate",1,0,"H",13,6,5,1,13,10,3,6,1,2,0,0,1,0,1,1,19,6,23,9,3,0
"20221229COLAFC",2022-12-29,"England League Two","Colchester","AFC Wimbledon",1,2,"A",9,12,4,8,14,14,4,3,3,2,0,0,0,0,0,3,21,12,28,7,5,0
"20221229DONROC",2022-12-29,"England League Two","Doncaster","Rochdale",4,3,"H",9,5,4,3,10,12,6,3,0,1,0,0,0,0,0,7,14,7,22,9,1,0
"20221229GRISAL",2022-12-29,"England League Two","Grimsby","Salford",1,4,"A",16,12,4,5,15,9,7,1,1,0,0,0,0,0,0,5,28,9,24,8,1,0
"20221229HARMAN",2022-12-29,"England League Two","Hartlepool","Mansfield",1,2,"A",8,13,1,6,9,10,3,6,2,1,0,0,0,0,0,3,21,7,19,9,3,0
"20221229NORSWI",2022-12-29,"England League Two","Northampton","Swindon",1,2,"A",16,11,8,4,11,12,15,3,2,3,0,0,0,0,0,3,27,12,23,18,5,0
"20221229SUTGIL",2022-12-29,"England League Two","Sutton","Gillingham",2,1,"H",14,10,3,2,9,12,5,1,2,1,0,0,0,0,0,3,24,5,21,6,3,0
"20221229WALSTO",2022-12-29,"England League Two","Walsall","Stockport",0,2,"A",12,20,4,7,16,10,7,5,3,1,0,0,0,0,0,2,32,11,26,12,4,0
"20221230NEWLEY",2022-12-30,"England League Two","Newport County","Leyton Orient",0,0,"D",7,7,2,2,11,10,3,6,1,1,0,0,0,0,0,0,14,4,21,9,2,0
"20221230STECRA",2022-12-30,"England League Two","Stevenage","Crawley Town",3,1,"H",24,8,7,2,9,9,7,5,1,0,0,0,0,0,0,4,32,9,18,12,1,0
"20230101BRASAL",2023-01-01,"England League Two","Bradford","Salford",3,2,"H",14,13,6,3,16,14,4,6,4,2,0,0,0,0,0,5,27,9,30,10,6,0
"20230101COLSWI",2023-01-01,"England League Two","Colchester","Swindon",1,0,"H",10,11,5,4,12,12,4,6,3,2,0,0,0,0,0,1,21,9,24,10,5,0
"20230101CRETRA",2023-01-01,"England League Two","Crewe","Tranmere",1,0,"H",11,22,3,3,7,7,5,13,1,1,0,0,0,0,0,1,33,6,14,18,2,0
"20230101DONCAR",2023-01-01,"England League Two","Doncaster","Carlisle",2,1,"H",17,7,4,2,8,6,5,0,1,1,0,0,0,0,0,3,24,6,14,5,2,0
"20230101GRISTO",2023-01-01,"England League Two","Grimsby","Stockport",1,0,"H",14,12,3,2,15,8,2,10,2,0,0,0,0,0,0,1,26,5,23,12,2,0
"20230101HARHAR",2023-01-01,"England League Two","Hartlepool","Harrogate",3,3,"D",20,11,6,5,4,11,2,4,1,1,0,0,0,0,0,6,31,11,15,6,2,0
"20230101SUTAFC",2023-01-01,"England League Two","Sutton","AFC Wimbledon",2,1,"H",15,6,10,4,15,12,2,2,1,1,0,0,0,0,0,3,21,14,27,4,2,0
"20230101WALMAN",2023-01-01,"England League Two","Walsall","Mansfield",2,1,"H",11,18,3,2,8,10,5,4,2,2,0,0,0,0,0,3,29,5,18,9,4,0
"20230102BARROC",2023-01-02,"England League Two","Barrow","Rochdale",0,0,"D",17,4,2,0,11,15,3,2,1,3,0,0,0,0,0,0,21,2,26,5,4,0
"20230102NEWCRA",2023-01-02,"England League Two","Newport County","Crawley Town",2,2,"D",18,14,7,6,6,14,6,1,1,3,0,0,0,0,0,4,32,13,20,7,4,0
"20230102NORLEY",2023-01-02,"England League Two","Northampton","Leyton Orient",1,0,"H",8,7,4,1,14,16,6,6,3,2,0,1,0,0,0,1,15,5,30,12,5,1
"20230102STEGIL",2023-01-02,"England League Two","Stevenage","Gillingham",1,0,"H",10,6,3,2,11,20,2,2,3,1,0,0,0,0,0,1,16,5,31,4,4,0
"20230107SALNOR",2023-01-07,"England League Two","Salford","Northampton",2,1,"H",13,12,6,4,9,13,2,4,1,1,0,0,0,0,0,3,25,10,22,6,2,0
"20230107CREAFC",2023-01-07,"England League Two","Crewe","AFC Wimbledon",0,0,"D",9,8,2,1,16,14,4,4,1,2,0,0,0,0,0,0,17,3,30,8,3,0
"20230107HARCOL",2023-01-07,"England League Two","Harrogate","Colchester",1,3,"A",16,6,9,4,8,15,9,4,2,3,0,0,0,0,0,4,22,13,23,13,5,0
"20230107LEYDON",2023-01-07,"England League Two","Leyton Orient","Doncaster",1,0,"H",7,8,4,0,11,11,6,3,1,1,0,0,0,0,0,1,15,4,22,9,2,0
"20230107MANBAR",2023-01-07,"England League Two","Mansfield","Barrow",2,3,"A",12,6,6,3,12,15,4,3,1,3,0,0,0,0,0,5,18,9,27,7,4,0
"20230107ROCNEW",2023-01-07,"England League Two","Rochdale","Newport County",1,1,"D",10,12,5,5,8,12,3,4,1,4,0,0,0,0,0,2,22,10,20,7,5,0
"20230107TRASUT",2023-01-07,"England League Two","Tranmere","Sutton",2,2,"D",7,6,3,3,13,11,6,2,4,2,0,0,0,0,0,4,13,6,24,8,6,0
"20230110BRAROC",2023-01-10,"England League Two","Bradford","Rochdale",1,2,"A",12,12,3,6,11,14,5,4,1,3,0,0,0,0,0,3,24,9,25,9,4,0
"20230114AFCBRA",2023-01-14,"England League Two","AFC Wimbledon","Bradford",0,0,"D",15,13,3,5,14,20,10,3,0,2,0,1,0,0,0,0,28,8,34,13,2,1
"20230114CARNEW",2023-01-14,"England League Two","Carlisle","Newport County",2,0,"H",9,12,4,3,10,14,4,2,2,1,0,0,0,0,0,2,21,7,24,6,3,0
"20230114GILHAR",2023-01-14,"England League Two","Gillingham","Hartlepool",2,0,"H",10,6,3,2,7,12,2,3,1,2,0,0,0,0,0,2,16,5,19,5,3,0
"20230114HARSTE",2023-01-14,"England League Two","Harrogate","Stevenage",1,1,"D",11,17,4,4,5,10,2,8,0,1,0,0,0,0,0,2,28,8,15,10,1,0
"20230114LEYBAR",2023-01-14,"England League Two","Leyton Orient","Barrow",0,0,"D",13,11,4,2,11,8,3,7,1,2,1,0,0,0,0,0,24,6,19,10,3,1
"20230114MANCRE",2023-01-14,"England League Two","Mansfield","Crewe",1,1,"D",17,10,5,3,12,12,8,6,2,1,1,0,0,0,0,2,27,8,24,14,3,1
"20230114ROCCOL",2023-01-14,"England League Two","Rochdale","Colchester",1,2,"A",5,10,5,4,14,8,6,2,2,1,0,0,0,0,0,3,15,9,22,8,3,0
"20230114SALSUT",2023-01-14,"England League Two","Salford","Sutton",2,0,"H",9,14,5,4,12,17,5,8,3,2,0,0,0,0,0,2,23,9,29,13,5,0
"20230114STONOR",2023-01-14,"England League Two","Stockport","Northampton",2,0,"H",15,12,3,3,6,10,5,9,1,1,0,0,0,0,0,2,27,6,16,14,2,0
"20230114SWIGRI",2023-01-14,"England League Two","Swindon","Grimsby",5,0,"H",23,6,11,3,7,16,4,5,1,2,0,1,0,0,0,5,29,14,23,9,3,1
"20230114TRAWAL",2023-01-14,"England League Two","Tranmere","Walsall",1,1,"D",13,5,4,1,13,11,6,3,2,1,0,1,0,0,0,2,18,5,24,9,3,1
"20230121COLGIL",2023-01-21,"England League Two","Colchester","Gillingham",0,2,"A",15,6,6,3,11,13,8,2,1,2,0,0,0,0,0,2,21,9,24,10,3,0
"20230121HARROC",2023-01-21,"England League Two","Hartlepool","Rochdale",2,0,"H",15,10,7,3,12,8,8,4,3,0,0,2,0,0,0,2,25,10,20,12,3,2
"20230121STELEY",2023-01-21,"England League Two","Stevenage","Leyton Orient",3,0,"H",20,8,8,0,11,13,5,4,2,1,0,1,0,0,0,3,28,8,24,9,3,1
"20230124CARHAR",2023-01-24,"England League Two","Carlisle","Hartlepool",3,1,"H",14,8,11,3,8,8,4,4,0,0,0,0,0,0,0,4,22,14,16,8,0,0
"20230124COLSAL",2023-01-24,"England League Two","Colchester","Salford",1,1,"D",17,10,6,2,16,11,6,6,0,0,0,0,0,0,0,2,27,8,27,12,0,0
"20230124STOBRA",2023-01-24,"England League Two","Stockport","Bradford",0,0,"D",12,5,1,1,10,13,9,1,1,1,0,0,0,0,0,0,17,2,23,10,2,0
"20230128AFCSTO",2023-01-28,"England League Two","AFC Wimbledon","Stockport",1,0,"H",13,11,3,2,12,16,2,9,5,2,0,0,0,0,0,1,24,5,28,11,7,0
"20230128BARNOR",2023-01-28,"England League Two","Barrow","Northampton",0,2,"A",7,8,2,4,13,16,3,3,1,2,0,0,0,0,0,2,15,6,29,6,3,0
"20230128CRASAL",2023-01-28,"England League Two","Crawley Town","Salford",3,2,"H",12,16,7,8,20,7,3,6,3,1,0,0,0,0,0,5,28,15,27,9,4,0
"20230128HARSUT",2023-01-28,"England League Two","Harrogate","Sutton",0,1,"A",9,16,3,3,16,8,7,7,1,1,0,0,0,0,0,1,25,6,24,14,2,0
"20230128HARCOL",2023-01-28,"England League Two","Hartlepool","Colchester",1,2,"A",16,10,5,8,12,6,7,1,2,1,0,0,0,0,0,3,26,13,18,8,3,0
"20230128MANDON",2023-01-28,"England League Two","Mansfield","Doncaster",4,1,"H",12,8,4,3,11,8,4,2,2,2,0,0,0,0,0,5,20,7,19,6,4,0
"20230128ROCCAR",2023-01-28,"England League Two","Rochdale","Carlisle",0,1,"A",9,9,2,3,13,9,1,6,2,3,0,0,0,0,0,1,18,5,22,7,5,0
"20230128SWIGIL",2023-01-28,"England League Two","Swindon","Gillingham",3,3,"D",21,12,8,4,10,10,7,1,1,2,1,0,0,0,0,6,33,12,20,8,3,1
"20230128TRALEY",2023-01-28,"England League Two","Tranmere","Leyton Orient",1,0,"H",9,11,1,0,6,10,6,1,0,2,0,0,0,0,0,1,20,1,16,7,2,0
"20230131CARBAR",2023-01-31,"England League Two","Carlisle","Barrow",5,1,"H",12,4,9,1,3,10,5,2,2,2,0,0,0,0,0,6,16,10,13,7,4,0
"20230131CRESTO",2023-01-31,"England League Two","Crewe","Stockport",1,1,"D",16,8,4,3,12,16,8,4,0,2,0,0,0,0,0,2,24,7,28,12,2,0
"20230131SALWAL",2023-01-31,"England League Two","Salford","Walsall",1,0,"H",14,17,2,6,4,17,2,4,3,2,0,0,0,0,0,1,31,8,21,6,5,0
"20230204NEWSWI",2023-02-04,"England League Two","Newport County","Swindon",2,1,"H",16,6,7,2,16,9,6,2,4,1,0,1,0,0,0,3,22,9,25,8,5,1
"20230204BRAMAN",2023-02-04,"England League Two","Bradford","Mansfield",1,1,"D",12,12,7,6,6,18,9,4,1,3,0,0,1,1,0,2,24,13,24,13,4,0
"20230204CARHAR",2023-02-04,"England League Two","Carlisle","Harrogate",0,1,"A",19,3,8,0,10,14,10,2,2,2,0,0,0,0,0,1,22,8,24,12,4,0
"20230204COLBAR",2023-02-04,"England League Two","Colchester","Barrow",1,1,"D",7,12,3,3,13,16,8,8,3,4,0,0,0,0,0,2,19,6,29,16,7,0
"20230204CREGRI",2023-02-04,"England League Two","Crewe","Grimsby",0,3,"A",7,15,0,5,10,9,8,1,0,1,0,0,0,0,0,3,22,5,19,9,1,0
"20230204DONHAR",2023-02-04,"England League Two","Doncaster","Hartlepool",0,1,"A",14,5,5,1,6,9,6,3,1,1,0,0,0,0,0,1,19,6,15,9,2,0
"20230204GILCRA",2023-02-04,"England League Two","Gillingham","Crawley Town",1,0,"H",14,5,8,2,9,7,5,6,0,0,0,0,0,0,0,1,19,10,16,11,0,0
"20230204LEYAFC",2023-02-04,"England League Two","Leyton Orient","AFC Wimbledon",1,0,"H",12,11,5,2,16,8,8,2,3,1,0,0,0,0,0,1,23,7,24,10,4,0
"20230204NORWAL",2023-02-04,"England League Two","Northampton","Walsall",0,0,"D",8,8,2,1,11,16,1,3,1,3,1,0,0,0,0,0,16,3,27,4,4,1
"20230204SALROC",2023-02-04,"England League Two","Salford","Rochdale",2,1,"H",14,10,3,5,12,16,4,7,2,1,0,0,0,0,0,3,24,8,28,11,3,0
"20230204STOTRA",2023-02-04,"England League Two","Stockport","Tranmere",3,2,"H",13,11,5,5,11,11,3,8,0,1,0,0,0,0,0,5,24,10,22,11,1,0
"20230204SUTSTE",2023-02-04,"England League Two","Sutton","Stevenage",0,0,"D",5,14,2,3,9,15,2,4,1,2,0,0,0,0,0,0,19,5,24,6,3,0
"20230207CRELEY",2023-02-07,"England League Two","Crewe","Leyton Orient",0,2,"A",5,12,1,3,12,13,4,9,1,0,0,0,0,0,0,2,17,4,25,13,1,0
"20230207DONTRA",2023-02-07,"England League Two","Doncaster","Tranmere",2,0,"H",6,18,2,6,6,11,0,9,1,3,0,0,0,0,0,2,24,8,17,9,4,0
"20230211AFCCAR",2023-02-11,"England League Two","AFC Wimbledon","Carlisle",0,0,"D",10,12,3,4,9,12,2,7,1,2,0,0,0,0,0,0,22,7,21,9,3,0
"20230211BARNEW",2023-02-11,"England League Two","Barrow","Newport County",0,1,"A",7,13,3,6,14,14,7,5,1,3,1,0,0,0,0,1,20,9,28,12,4,1
"20230211CRACRE",2023-02-11,"England League Two","Crawley Town","Crewe",2,2,"D",11,6,2,4,16,14,7,3,2,2,0,1,0,0,0,4,17,6,30,10,4,1
"20230211GRICOL",2023-02-11,"England League Two","Grimsby","Colchester",0,1,"A",11,7,1,2,10,12,2,3,1,2,0,0,0,0,0,1,18,3,22,5,3,0
"20230211HARSTO",2023-02-11,"England League Two","Harrogate","Stockport",1,3,"A",4,18,0,9,12,10,5,6,1,2,0,0,0,0,0,4,22,9,22,11,3,0
"20230211HARSUT",2023-02-11,"England League Two","Hartlepool","Sutton",2,2,"D",13,18,6,7,11,15,3,7,2,2,0,1,0,0,0,4,31,13,26,10,4,1
"20230211MANGIL",2023-02-11,"England League Two","Mansfield","Gillingham",2,0,"H",17,8,6,3,12,11,5,5,2,3,0,0,0,0,0,2,25,9,23,10,5,0
"20230211ROCNOR",2023-02-11,"England League Two","Rochdale","Northampton",1,1,"D",11,12,4,5,15,14,4,4,3,0,0,0,0,0,0,2,23,9,29,8,3,0
"20230211STEBRA",2023-02-11,"England League Two","Stevenage","Bradford",2,3,"A",15,6,5,3,15,14,7,3,1,5,0,0,0,0,0,5,21,8,29,10,6,0
"20230211SWIDON",2023-02-11,"England League Two","Swindon","Doncaster",0,2,"A",9,10,1,5,5,13,5,5,2,3,0,0,0,0,0,2,19,6,18,10,5,0
"20230211TRASAL",2023-02-11,"England League Two","Tranmere","Salford",1,0,"H",12,11,6,2,9,9,7,5,2,2,0,0,0,0,0,1,23,8,18,12,4,0
"20230211WALLEY",2023-02-11,"England League Two","Walsall","Leyton Orient",1,1,"D",8,16,2,5,8,4,4,4,3,1,0,0,0,0,0,2,24,7,12,8,4,0
"20230214BRATRA",2023-02-14,"England League Two","Bradford","Tranmere",2,0,"H",10,11,4,0,10,9,6,0,2,1,0,0,0,0,0,2,21,4,19,6,3,0
"20230214CARMAN",2023-02-14,"England League Two","Carlisle","Mansfield",0,4,"A",12,16,3,6,8,13,5,4,3,1,0,0,0,0,0,4,28,9,21,9,4,0
"20230214COLWAL",2023-02-14,"England League Two","Colchester","Walsall",0,0,"D",6,7,2,1,10,12,0,7,2,1,0,0,0,0,0,0,13,3,22,7,3,0
"20230214CREHAR",2023-02-14,"England League Two","Crewe","Hartlepool",2,0,"H",13,11,2,2,7,12,4,3,0,2,0,1,0,0,0,2,24,4,19,7,2,1
"20230214DONBAR",2023-02-14,"England League Two","Doncaster","Barrow",1,0,"H",7,9,4,2,8,14,1,3,1,2,0,0,0,0,0,1,16,6,22,4,3,0
"20230214GILGRI",2023-02-14,"England League Two","Gillingham","Grimsby",2,1,"H",9,7,4,3,9,19,5,3,1,3,0,0,0,0,0,3,16,7,28,8,4,0
"20230214LEYROC",2023-02-14,"England League Two","Leyton Orient","Rochdale",2,1,"H",22,7,8,4,10,12,6,3,1,4,0,0,0,0,0,3,29,12,22,9,5,0
"20230214NEWSTE",2023-02-14,"England League Two","Newport County","Stevenage",2,2,"D",12,13,4,5,12,13,3,2,1,3,0,0,0,0,0,4,25,9,25,5,4,0
"20230214NORAFC",2023-02-14,"England League Two","Northampton","AFC Wimbledon",0,0,"D",16,8,5,2,14,16,6,4,1,4,0,0,1,0,1,0,24,7,30,10,5,0
"20230214SALHAR",2023-02-14,"England League Two","Salford","Harrogate",1,1,"D",18,11,6,3,4,10,10,2,0,2,0,0,0,0,0,2,29,9,14,12,2,0
"20230214STOCRA",2023-02-14,"England League Two","Stockport","Crawley Town",2,1,"H",7,9,3,2,10,12,8,5,2,1,0,0,0,0,0,3,16,5,22,13,3,0
"20230214SUTSWI",2023-02-14,"England League Two","Sutton","Swindon",2,1,"H",22,11,3,5,19,9,8,5,2,3,0,0,0,0,0,3,33,8,28,13,5,0
"20230218NORGRI",2023-02-18,"England League Two","Northampton","Grimsby",1,2,"A",12,9,6,4,8,15,6,4,1,4,0,0,0,0,0,3,21,10,23,10,5,0
"20230218AFCHAR",2023-02-18,"England League Two","AFC Wimbledon","Hartlepool",2,2,"D",20,10,6,4,11,15,3,2,3,1,0,0,0,0,0,4,30,10,26,5,4,0
"20230218BRABAR",2023-02-18,"England League Two","Bradford","Barrow",0,1,"A",10,8,0,2,11,9,8,1,2,4,0,0,0,0,0,1,18,2,20,9,6,0
"20230218CARCOL",2023-02-18,"England League Two","Carlisle","Colchester",1,0,"H",12,8,3,0,7,7,1,5,0,0,0,0,0,0,0,1,20,3,14,6,0,0
"20230218HARCRE",2023-02-18,"England League Two","Harrogate","Crewe",2,2,"D",16,12,6,3,9,8,11,5,0,2,0,0,0,0,0,4,28,9,17,16,2,0
"20230218LEYCRA",2023-02-18,"England League Two","Leyton Orient","Crawley Town",1,0,"H",16,2,1,0,9,8,9,4,2,1,0,0,0,0,0,1,18,1,17,13,3,0
"20230218ROCGIL",2023-02-18,"England League Two","Rochdale","Gillingham",0,2,"A",16,15,6,5,8,12,5,1,2,0,0,0,0,0,0,2,31,11,20,6,2,0
"20230218SALSWI",2023-02-18,"England League Two","Salford","Swindon",1,2,"A",12,3,3,1,11,15,6,1,2,2,0,0,0,0,0,3,15,4,26,7,4,0
"20230218STOSTE",2023-02-18,"England League Two","Stockport","Stevenage",2,0,"H",8,10,3,4,10,13,1,1,0,3,0,0,0,0,0,2,18,7,23,2,3,0
"20230218SUTDON",2023-02-18,"England League Two","Sutton","Doncaster",2,0,"H",14,12,6,2,10,7,4,7,1,1,0,0,0,0,0,2,26,8,17,11,2,0
"20230218TRAMAN",2023-02-18,"England League Two","Tranmere","Mansfield",0,2,"A",11,12,0,7,9,8,4,5,0,1,0,0,0,0,0,2,23,7,17,9,1,0
"20230218WALNEW",2023-02-18,"England League Two","Walsall","Newport County",1,1,"D",9,9,5,2,14,14,4,2,2,4,0,0,0,0,0,2,18,7,28,6,6,0
"20230221GRIHAR",2023-02-21,"England League Two","Grimsby","Harrogate",0,0,"D",15,4,8,1,9,7,7,1,0,0,0,0,0,0,0,0,19,9,16,8,0,0
"20230221HARNEW",2023-02-21,"England League Two","Hartlepool","Newport County",0,1,"A",7,14,0,5,11,10,7,9,2,2,0,0,0,0,0,1,21,5,21,16,4,0
"20230221ROCSTO",2023-02-21,"England League Two","Rochdale","Stockport",1,2,"A",11,12,2,4,12,13,5,3,1,1,0,0,0,0,0,3,23,6,25,8,2,0
"20230221WALCRE",2023-02-21,"England League Two","Walsall","Crewe",0,0,"D",16,6,7,2,13,14,4,3,2,3,0,0,0,0,0,0,22,9,27,7,5,0
"20230225BARSTO",2023-02-25,"England League Two","Barrow","Stockport",1,0,"H",8,7,2,1,9,10,3,3,1,1,0,0,0,0,0,1,15,3,19,6,2,0
"20230225COLNOR",2023-02-25,"England League Two","Colchester","Northampton",0,1,"A",9,13,4,5,6,14,9,5,3,5,0,0,0,0,0,1,22,9,20,14,8,0
"20230225CRACAR",2023-02-25,"England League Two","Crawley Town","Carlisle",2,5,"A",15,20,4,9,8,11,3,9,1,1,0,0,0,0,0,7,35,13,19,12,2,0
"20230225CREROC",2023-02-25,"England League Two","Crewe","Rochdale",1,1,"D",17,13,5,5,8,10,3,7,1,1,1,0,0,0,0,2,30,10,18,10,2,1
"20230225DONBRA",2023-02-25,"England League Two","Doncaster","Bradford",0,1,"A",6,12,2,6,14,7,3,1,2,4,0,0,0,0,0,1,18,8,21,4,6,0
"20230225GILAFC",2023-02-25,"England League Two","Gillingham","AFC Wimbledon",2,1,"H",10,15,5,3,16,18,6,6,1,5,0,0,0,0,0,3,25,8,34,12,6,0
"20230225GRILEY",2023-02-25,"England League Two","Grimsby","Leyton Orient",2,2,"D",11,5,6,3,6,7,1,1,1,3,0,0,0,0,0,4,16,9,13,2,4,0
"20230225HARWAL",2023-02-25,"England League Two","Hartlepool","Walsall",3,3,"D",8,11,4,6,6,15,5,5,1,2,0,0,0,0,0,6,19,10,21,10,3,0
"20230225MANSAL",2023-02-25,"England League Two","Mansfield","Salford",2,5,"A",19,14,5,8,12,4,6,6,4,1,0,0,0,0,0,7,33,13,16,12,5,0
"20230225NEWSUT",2023-02-25,"England League Two","Newport County","Sutton",0,2,"A",15,12,5,4,8,15,6,2,0,1,0,0,0,0,0,2,27,9,23,8,1,0
"20230225STETRA",2023-02-25,"England League Two","Stevenage","Tranmere",0,1,"A",13,7,5,4,13,18,5,3,2,4,0,0,0,0,0,1,20,9,31,8,6,0
"20230225SWIHAR",2023-02-25,"England League Two","Swindon","Harrogate",3,0,"H",13,4,7,3,5,13,4,1,1,3,0,0,0,0,0,3,17,10,18,5,4,0
"20230228AFCSTE",2023-02-28,"England League Two","AFC Wimbledon","Stevenage",2,3,"A",16,14,7,5,13,12,3,3,2,4,0,0,0,0,0,5,30,12,25,6,6,0
"20230228BARSAL",2023-02-28,"England League Two","Barrow","Salford",1,1,"D",13,13,5,5,11,8,4,4,1,3,0,0,0,0,0,2,26,10,19,8,4,0
"20230228GILBRA",2023-02-28,"England League Two","Gillingham","Bradford",0,2,"A",9,13,2,7,11,16,3,4,2,1,0,0,0,0,0,2,22,9,27,7,3,0
"20230228HARNOR",2023-02-28,"England League Two","Harrogate","Northampton",1,1,"D",5,10,2,1,16,12,5,2,1,1,0,0,0,0,0,2,15,3,28,7,2,0
"20230228TRACRA",2023-02-28,"England League Two","Tranmere","Crawley Town",1,0,"H",9,13,4,4,16,14,7,8,1,0,0,0,0,0,0,1,22,8,30,15,1,0
"20230304AFCMAN",2023-03-04,"England League Two","AFC Wimbledon","Mansfield",1,3,"A",12,11,2,4,13,11,2,4,1,4,0,0,1,0,1,4,23,6,24,6,5,0
"20230304BRACOL",2023-03-04,"England League Two","Bradford","Colchester",2,0,"H",16,9,3,4,12,12,5,5,3,1,0,0,2,1,1,2,25,7,24,10,4,0
"20230304CARGRI",2023-03-04,"England League Two","Carlisle","Grimsby",2,0,"H",13,3,5,1,9,17,2,1,1,2,0,0,0,0,0,2,16,6,26,3,3,0
"20230304HARGIL",2023-03-04,"England League Two","Harrogate","Gillingham",0,0,"D",15,10,8,2,15,10,4,6,0,2,0,0,0,0,0,0,25,10,25,10,2,0
"20230304LEYSWI",2023-03-04,"England League Two","Leyton Orient","Swindon",1,1,"D",11,8,4,4,11,8,12,2,1,1,0,0,0,0,0,2,19,8,19,14,2,0
"20230304NORCRA",2023-03-04,"England League Two","Northampton","Crawley Town",1,0,"H",14,9,6,1,9,15,7,5,3,5,1,0,1,0,1,1,23,7,24,12,8,1
"20230304ROCSTE",2023-03-04,"England League Two","Rochdale","Stevenage",2,0,"H",9,28,2,4,17,11,0,10,0,2,0,0,1,1,0,2,37,6,28,10,2,0
"20230304SALNEW",2023-03-04,"England League Two","Salford","Newport County",3,1,"H",22,12,7,3,7,16,6,1,0,1,0,0,0,0,0,4,34,10,23,7,1,0
"20230304STODON",2023-03-04,"England League Two","Stockport","Doncaster",0,0,"D",12,6,5,2,13,13,8,0,2,2,0,0,0,0,0,0,18,7,26,8,4,0
"20230304SUTCRE",2023-03-04,"England League Two","Sutton","Crewe",1,1,"D",22,8,5,4,14,17,11,1,1,2,0,1,0,0,0,2,30,9,31,12,3,1
"20230304TRAHAR",2023-03-04,"England League Two","Tranmere","Hartlepool",1,1,"D",15,10,5,5,12,16,7,6,0,1,0,0,0,0,0,2,25,10,28,13,1,0
"20230304WALBAR",2023-03-04,"England League Two","Walsall","Barrow",0,1,"A",11,9,4,5,13,11,2,1,2,2,0,0,0,0,0,1,20,9,24,3,4,0
"20230307DONHAR",2023-03-07,"England League Two","Doncaster","Harrogate",0,2,"A",14,14,1,8,7,8,4,5,1,0,0,0,0,0,0,2,28,9,15,9,1,0
"20230307GRINEW",2023-03-07,"England League Two","Grimsby","Newport County",1,1,"D",11,11,2,5,11,8,5,4,1,0,0,0,0,0,0,2,22,7,19,9,1,0
"20230307STOGIL",2023-03-07,"England League Two","Stockport","Gillingham",0,0,"D",17,2,3,0,7,13,7,0,0,2,0,0,1,0,1,0,19,3,20,7,2,0
"20230307SUTCRA",2023-03-07,"England League Two","Sutton","Crawley Town",3,0,"H",10,12,5,3,10,16,9,5,0,2,0,1,0,0,0,3,22,8,26,14,2,1
"20230307WALBRA",2023-03-07,"England League Two","Walsall","Bradford",0,0,"D",12,10,5,0,9,9,5,1,1,3,0,0,0,0,0,0,22,5,18,6,4,0
"20230310CRESAL",2023-03-10,"England League Two","Crewe","Salford",4,3,"H",12,16,7,6,11,7,2,4,2,0,0,0,0,0,0,7,28,13,18,6,2,0
"20230311BARSUT",2023-03-11,"England League Two","Barrow","Sutton",0,0,"D",10,9,1,0,10,10,4,4,1,0,0,0,0,0,0,0,19,1,20,8,1,0
"20230311COLSTO",2023-03-11,"England League Two","Colchester","Stockport",0,1,"A",10,13,0,5,9,14,7,7,2,2,0,0,0,0,0,1,23,5,23,14,4,0
"20230311CRAHAR",2023-03-11,"England League Two","Crawley Town","Harrogate",3,1,"H",18,11,6,3,9,15,6,2,4,2,0,1,0,0,0,4,29,9,24,8,6,1
"20230311DONAFC",2023-03-11,"England League Two","Doncaster","AFC Wimbledon",2,1,"H",10,13,3,6,9,10,9,2,2,0,0,0,0,0,0,3,23,9,19,11,2,0
"20230311GILTRA",2023-03-11,"England League Two","Gillingham","Tranmere",2,0,"H",14,7,6,2,9,13,8,3,0,1,0,0,0,0,0,2,21,8,22,11,1,0
"20230311GRIROC",2023-03-11,"England League Two","Grimsby","Rochdale",1,0,"H",10,8,3,1,14,13,5,3,4,1,0,0,0,0,0,1,18,4,27,8,5,0
"20230311HARNOR",2023-03-11,"England League Two","Hartlepool","Northampton",1,1,"D",8,13,4,6,10,9,6,4,1,0,0,0,0,0,0,2,21,10,19,10,1,0
"20230311NEWBRA",2023-03-11,"England League Two","Newport County","Bradford",1,1,"D",12,6,2,3,13,13,7,2,1,4,0,0,0,0,0,2,18,5,26,9,5,0
"20230311STEWAL",2023-03-11,"England League Two","Stevenage","Walsall",3,1,"H",17,12,7,3,13,19,6,4,3,1,0,0,0,0,0,4,29,10,32,10,4,0
"20230311SWICAR",2023-03-11,"England League Two","Swindon","Carlisle",1,2,"A",10,7,2,3,10,12,3,6,4,3,0,0,0,0,0,3,17,5,22,9,7,0
"20230314NEWAFC",2023-03-14,"England League Two","Newport County","AFC Wimbledon",1,1,"D",11,3,4,1,13,11,7,2,3,3,0,0,0,0,0,2,14,5,24,9,6,0
"20230314NORMAN",2023-03-14,"England League Two","Northampton","Mansfield",1,0,"H",14,9,4,2,9,12,6,1,1,3,0,1,1,1,0,1,23,6,21,7,4,1
"20230314STECRE",2023-03-14,"England League Two","Stevenage","Crewe",1,0,"H",17,2,6,0,12,10,16,2,2,0,0,0,0,0,0,1,19,6,22,18,2,0
"20230314SUTGRI",2023-03-14,"England League Two","Sutton","Grimsby",0,1,"A",8,7,3,1,13,12,5,3,4,2,0,0,0,0,0,1,15,4,25,8,6,0
"20230314WALSWI",2023-03-14,"England League Two","Walsall","Swindon",0,0,"D",9,12,2,3,14,7,5,5,2,0,0,0,0,0,0,0,21,5,21,10,2,0
"20230318BRAHAR",2023-03-18,"England League Two","Bradford","Hartlepool",2,2,"D",18,9,7,4,9,11,2,7,1,2,0,0,0,0,0,4,27,11,20,9,3,0
"20230318AFCCRA",2023-03-18,"England League Two","AFC Wimbledon","Crawley Town",0,1,"A",6,7,0,1,16,12,1,5,3,4,0,0,0,0,0,1,13,1,28,6,7,0
"20230318CARSTE",2023-03-18,"England League Two","Carlisle","Stevenage",0,0,"D",10,9,1,0,11,12,4,3,2,3,0,0,0,0,0,0,19,1,23,7,5,0
"20230318HARBAR",2023-03-18,"England League Two","Harrogate","Barrow",1,0,"H",15,14,5,3,14,13,5,5,1,1,0,0,0,0,0,1,29,8,27,10,2,0
"20230318LEYCOL",2023-03-18,"England League Two","Leyton Orient","Colchester",2,2,"D",12,12,4,6,11,10,1,3,3,2,0,0,0,0,0,4,24,10,21,4,5,0
"20230318NORCRE",2023-03-18,"England League Two","Northampton","Crewe",1,0,"H",15,7,8,1,10,7,8,0,1,0,0,0,0,0,0,1,22,9,17,8,1,0
"20230318ROCSWI",2023-03-18,"England League Two","Rochdale","Swindon",4,4,"D",18,16,8,7,11,7,6,5,2,1,0,0,0,0,0,8,34,15,18,11,3,0
"20230318SALDON",2023-03-18,"England League Two","Salford","Doncaster",3,1,"H",20,6,7,1,9,12,9,5,2,1,0,0,0,0,0,4,26,8,21,14,3,0
"20230318STOMAN",2023-03-18,"England League Two","Stockport","Mansfield",1,1,"D",12,8,7,1,13,13,6,9,2,0,0,0,0,0,0,2,20,8,26,15,2,0
"20230318TRANEW",2023-03-18,"England League Two","Tranmere","Newport County",1,3,"A",18,13,5,4,7,11,10,1,1,1,0,0,0,0,0,4,31,9,18,11,2,0
"20230318WALGIL",2023-03-18,"England League Two","Walsall","Gillingham",2,0,"H",12,13,6,0,10,14,7,4,2,1,0,0,0,0,0,2,25,6,24,11,3,0
"20230321BRACAR",2023-03-21,"England League Two","Bradford","Carlisle",0,0,"D",8,10,1,1,7,11,3,4,1,3,0,0,0,0,0,0,18,2,18,7,4,0
"20230321CRADON",2023-03-21,"England League Two","Crawley Town","Doncaster",1,1,"D",15,2,6,1,4,10,9,0,1,4,0,0,0,0,0,2,17,7,14,9,5,0
"20230321GILCRE",2023-03-21,"England League Two","Gillingham","Crewe",2,1,"H",8,13,4,3,11,13,3,3,2,1,0,0,0,0,0,3,21,7,24,6,3,0
"20230322MANGRI",2023-03-22,"England League Two","Mansfield","Grimsby",0,0,"D",12,13,1,3,8,9,9,8,0,1,0,0,0,0,0,0,25,4,17,17,1,0
"20230325BARAFC",2023-03-25,"England League Two","Barrow","AFC Wimbledon",2,1,"H",9,11,4,4,11,18,4,5,2,3,0,0,1,0,1,3,20,8,29,9,5,0
"20230325COLTRA",2023-03-25,"England League Two","Colchester","Tranmere",1,1,"D",14,13,5,5,14,13,7,3,5,8,0,0,0,0,0,2,27,10,27,10,13,0
"20230325CRAROC",2023-03-25,"England League Two","Crawley Town","Rochdale",2,0,"H",16,8,6,1,7,9,9,5,1,2,0,0,0,0,0,2,24,7,16,14,3,0
"20230325DONNOR",2023-03-25,"England League Two","Doncaster","Northampton",0,2,"A",10,10,2,5,11,14,3,4,2,3,0,0,0,0,0,2,20,7,25,7,5,0
"20230325GILCAR",2023-03-25,"England League Two","Gillingham","Carlisle",1,0,"H",9,3,3,1,12,17,6,3,2,5,0,0,0,0,0,1,12,4,29,9,7,0
"20230325GRIWAL",2023-03-25,"England League Two","Grimsby","Walsall",1,1,"D",22,10,4,1,17,14,2,8,5,4,0,0,0,0,0,2,32,5,31,10,9,0
"20230325HARLEY",2023-03-25,"England League Two","Hartlepool","Leyton Orient",1,1,"D",11,8,4,2,5,18,3,6,0,3,0,0,0,0,0,2,19,6,23,9,3,0
"20230325MANSUT",2023-03-25,"England League Two","Mansfield","Sutton",0,0,"D",5,7,1,2,8,21,4,5,1,4,0,0,0,0,0,0,12,3,29,9,5,0
"20230325STESAL",2023-03-25,"England League Two","Stevenage","Salford",1,3,"A",16,6,7,4,14,12,8,3,2,2,0,0,0,0,0,4,22,11,26,11,4,0
"20230325SWISTO",2023-03-25,"England League Two","Swindon","Stockport",0,1,"A",0,13,0,5,12,17,1,2,3,5,1,0,0,0,0,1,13,5,29,3,8,1
"20230328AFCWAL",2023-03-28,"England League Two","AFC Wimbledon","Walsall",2,0,"H",9,11,4,3,12,13,7,3,1,4,0,0,0,0,0,2,20,7,25,10,5,0
"20230328CRAGRI",2023-03-28,"England League Two","Crawley Town","Grimsby",1,1,"D",5,15,3,3,10,11,5,4,2,2,0,0,0,0,0,2,20,6,21,9,4,0
"20230331STOSAL",2023-03-31,"England League Two","Stockport","Salford",1,1,"D",7,8,2,3,14,14,7,2,1,1,0,0,0,0,0,2,15,5,28,9,2,0
"20230331TRAHAR",2023-03-31,"England League Two","Tranmere","Harrogate",1,1,"D",12,16,1,9,10,10,3,4,3,3,0,0,0,0,0,2,28,10,20,7,6,0
"20230401BRAGRI",2023-04-01,"England League Two","Bradford","Grimsby",3,2,"H",15,6,10,4,12,10,4,4,3,1,0,0,1,0,1,5,21,14,22,8,4,0
"20230401AFCROC",2023-04-01,"England League Two","AFC Wimbledon","Rochdale",0,1,"A",15,2,3,1,10,6,6,2,2,2,0,0,0,0,0,1,17,4,16,8,4,0
"20230401BARGIL",2023-04-01,"England League Two","Barrow","Gillingham",2,1,"H",12,6,7,1,16,14,3,1,2,2,0,0,0,0,0,3,18,8,30,4,4,0
"20230401COLNEW",2023-04-01,"England League Two","Colchester","Newport County",0,0,"D",10,5,2,2,18,11,10,7,2,2,0,0,0,0,0,0,15,4,29,17,4,0
"20230401DONCRE",2023-04-01,"England League Two","Doncaster","Crewe",0,2,"A",6,11,3,5,11,10,3,9,0,0,0,0,0,0,0,2,17,8,21,12,0,0
"20230401HARSWI",2023-04-01,"England League Two","Hartlepool","Swindon",2,1,"H",16,19,4,5,15,13,10,5,4,3,0,0,0,0,0,3,35,9,28,15,7,0
"20230401LEYCAR",2023-04-01,"England League Two","Leyton Orient","Carlisle",1,0,"H",12,7,3,2,10,16,5,7,4,1,1,0,0,0,0,1,19,5,26,12,5,1
"20230401MANCRA",2023-04-01,"England League Two","Mansfield","Crawley Town",4,1,"H",27,11,11,5,12,7,5,5,1,2,0,0,0,0,0,5,38,16,19,10,3,0
"20230401NORSTE",2023-04-01,"England League Two","Northampton","Stevenage",1,1,"D",9,13,3,5,18,15,3,5,5,3,0,0,0,0,0,2,22,8,33,8,8,0
"20230401WALSUT",2023-04-01,"England League Two","Walsall","Sutton",1,1,"D",12,12,6,3,17,17,5,10,2,2,0,0,0,0,0,2,24,9,34,15,4,0
"20230407CARTRA",2023-04-07,"England League Two","Carlisle","Tranmere",2,0,"H",15,8,8,1,15,10,7,4,2,1,0,0,0,0,0,2,23,9,25,11,3,0
"20230407CRABRA",2023-04-07,"England League Two","Crawley Town","Bradford",0,0,"D",12,11,1,3,11,8,12,4,3,2,0,1,0,0,0,0,23,4,19,16,5,1
"20230407CREBAR",2023-04-07,"England League Two","Crewe","Barrow",3,0,"H",8,11,6,0,15,11,2,5,5,2,0,0,0,0,0,3,19,6,26,7,7,0
"20230407GILDON",2023-04-07,"England League Two","Gillingham","Doncaster",1,0,"H",14,10,4,3,7,6,5,2,0,1,0,0,0,0,0,1,24,7,13,7,1,0
"20230407GRIHAR",2023-04-07,"England League Two","Grimsby","Hartlepool",1,4,"A",17,5,4,4,10,14,3,1,1,0,0,0,0,0,0,5,22,8,24,4,1,0
"20230407HARAFC",2023-04-07,"England League Two","Harrogate","AFC Wimbledon",2,2,"D",11,15,5,4,7,10,6,5,2,3,0,0,0,0,0,4,26,9,17,11,5,0
"20230407NEWNOR",2023-04-07,"England League Two","Newport County","Northampton",3,0,"H",13,11,6,2,11,12,1,5,3,3,0,0,0,0,0,3,24,8,23,6,6,0
"20230407ROCWAL",2023-04-07,"England League Two","Rochdale","Walsall",4,2,"H",13,14,5,4,4,6,4,5,0,2,0,0,1,0,1,6,27,9,10,9,2,0
"20230407SALLEY",2023-04-07,"England League Two","Salford","Leyton Orient",0,2,"A",10,9,5,5,9,13,5,1,4,4,0,0,0,0,0,2,19,10,22,6,8,0
"20230407STECOL",2023-04-07,"England League Two","Stevenage","Colchester",1,1,"D",13,7,6,4,11,14,8,3,2,2,0,0,0,0,0,2,20,10,25,11,4,0
"20230407SUTSTO",2023-04-07,"England League Two","Sutton","Stockport",0,1,"A",12,12,7,5,11,13,2,4,2,3,0,0,0,0,0,1,24,12,24,6,5,0
"20230407SWIMAN",2023-04-07,"England League Two","Swindon","Mansfield",2,4,"A",5,9,3,6,8,16,0,2,2,2,0,0,0,0,0,6,14,9,24,2,4,0
"20230410AFCSAL",2023-04-10,"England League Two","AFC Wimbledon","Salford",2,3,"A",16,13,5,4,15,9,4,4,3,3,0,0,0,0,0,5,29,9,24,8,6,0
"20230410BARCRA",2023-04-10,"England League Two","Barrow","Crawley Town",4,0,"H",13,3,7,0,15,21,3,3,4,2,0,0,0,0,0,4,16,7,36,6,6,0
"20230410BRASUT",2023-04-10,"England League Two","Bradford","Sutton",3,1,"H",16,8,7,1,12,18,7,3,2,2,0,0,0,0,0,4,24,8,30,10,4,0
"20230410COLCRE",2023-04-10,"England League Two","Colchester","Crewe",4,0,"H",19,2,9,1,10,12,6,5,1,2,0,0,0,0,0,4,21,10,22,11,3,0
"20230410DONGRI",2023-04-10,"England League Two","Doncaster","Grimsby",1,2,"A",7,16,2,7,7,13,3,5,1,5,0,0,0,0,0,3,23,9,20,8,6,0
"20230410HARSTE",2023-04-10,"England League Two","Hartlepool","Stevenage",1,1,"D",6,16,2,4,10,8,4,6,1,3,0,0,0,0,0,2,22,6,18,10,4,0
"20230410LEYHAR",2023-04-10,"England League Two","Leyton Orient","Harrogate",2,2,"D",14,7,7,3,11,9,7,4,0,2,0,0,0,0,0,4,21,10,20,11,2,0
"20230410MANROC",2023-04-10,"England League Two","Mansfield","Rochdale",1,1,"D",20,6,7,1,10,8,12,1,1,2,0,0,0,0,0,2,26,8,18,13,3,0
"20230410NORGIL",2023-04-10,"England League Two","Northampton","Gillingham",2,1,"H",9,5,3,2,10,11,4,0,1,1,0,0,0,0,0,3,14,5,21,4,2,0
"20230410STONEW",2023-04-10,"England League Two","Stockport","Newport County",4,0,"H",16,7,7,3,13,12,6,3,0,1,0,0,0,0,0,4,23,10,25,9,1,0
"20230410TRASWI",2023-04-10,"England League Two","Tranmere","Swindon",1,0,"H",7,11,2,2,14,12,3,7,0,2,0,0,0,0,0,1,18,4,26,10,2,0
"20230410WALCAR",2023-04-10,"England League Two","Walsall","Carlisle",0,0,"D",7,12,2,3,11,14,4,8,1,2,1,0,0,0,0,0,19,5,25,12,3,1
"20230415CARNOR",2023-04-15,"England League Two","Carlisle","Northampton",0,0,"D",11,15,7,3,4,11,3,4,1,3,0,0,0,0,0,0,26,10,15,7,4,0
"20230415CRATRA",2023-04-15,"England League Two","Crawley Town","Tranmere",2,1,"H",21,13,6,5,13,9,8,4,2,3,0,0,0,0,0,3,34,11,22,12,5,0
"20230415CREWAL",2023-04-15,"England League Two","Crewe","Walsall",2,0,"H",12,9,4,0,13,17,7,3,2,2,0,1,0,0,0,2,21,4,30,10,4,1
"20230415GILSTO",2023-04-15,"England League Two","Gillingham","Stockport",1,1,"D",10,14,4,4,17,15,2,6,4,1,0,0,0,0,0,2,24,8,32,8,5,0
"20230415GRIMAN",2023-04-15,"England League Two","Grimsby","Mansfield",1,1,"D",15,18,5,3,12,7,3,6,2,3,0,0,0,0,0,2,33,8,19,9,5,0
"20230415HARDON",2023-04-15,"England League Two","Harrogate","Doncaster",2,2,"D",18,11,7,3,12,4,11,4,1,1,0,0,0,0,0,4,29,10,16,15,2,0
"20230415NEWHAR",2023-04-15,"England League Two","Newport County","Hartlepool",2,0,"H",27,6,7,2,10,14,7,5,2,1,0,0,0,0,0,2,33,9,24,12,3,0
"20230415ROCBRA",2023-04-15,"England League Two","Rochdale","Bradford",0,3,"A",9,13,1,5,12,8,1,4,0,1,0,0,0,0,0,3,22,6,20,5,1,0
"20230415SALCOL",2023-04-15,"England League Two","Salford","Colchester",0,1,"A",26,5,3,2,6,12,9,4,3,3,0,0,0,0,0,1,31,5,18,13,6,0
"20230415STEAFC",2023-04-15,"England League Two","Stevenage","AFC Wimbledon",2,1,"H",4,9,2,2,12,15,1,1,2,1,0,0,0,0,0,3,13,4,27,2,3,0
"20230415SUTLEY",2023-04-15,"England League Two","Sutton","Leyton Orient",0,2,"A",7,14,0,5,10,13,2,3,1,2,0,0,0,0,0,2,21,5,23,5,3,0
"20230415SWIBAR",2023-04-15,"England League Two","Swindon","Barrow",0,0,"D",10,7,1,4,7,15,6,3,0,2,0,0,0,0,0,0,17,5,22,9,2,0
"20230418CARSTO",2023-04-18,"England League Two","Carlisle","Stockport",2,2,"D",12,13,6,3,11,11,12,6,3,1,0,0,0,0,0,4,25,9,22,18,4,0
"20230418CRACOL",2023-04-18,"England League Two","Crawley Town","Colchester",0,0,"D",8,19,1,5,11,11,2,7,0,0,0,0,0,0,0,0,27,6,22,9,0,0
"20230418GILLEY",2023-04-18,"England League Two","Gillingham","Leyton Orient",2,0,"H",6,4,3,1,9,10,2,2,1,4,0,1,0,0,0,2,10,4,19,4,5,1
"20230418GRIBAR",2023-04-18,"England League Two","Grimsby","Barrow",1,0,"H",6,13,2,3,18,5,3,8,1,2,0,0,0,0,0,1,19,5,23,11,3,0
"20230418HARWAL",2023-04-18,"England League Two","Harrogate","Walsall",3,0,"H",7,11,4,2,14,4,2,2,0,0,0,0,0,0,0,3,18,6,18,4,0,0
"20230418NEWMAN",2023-04-18,"England League Two","Newport County","Mansfield",1,2,"A",13,8,4,4,10,14,3,4,3,4,0,0,0,0,0,3,21,8,24,7,7,0
"20230418ROCTRA",2023-04-18,"England League Two","Rochdale","Tranmere",2,2,"D",14,10,4,5,8,11,6,5,1,1,0,0,0,0,0,4,24,9,19,11,2,0
"20230418SALHAR",2023-04-18,"England League Two","Salford","Hartlepool",2,0,"H",13,13,6,5,8,10,5,3,0,2,0,0,0,0,0,2,26,11,18,8,2,0
"20230418STEDON",2023-04-18,"England League Two","Stevenage","Doncaster",1,0,"H",12,2,3,1,10,12,3,0,3,1,0,0,0,0,0,1,14,4,22,3,4,0
"20230418SUTNOR",2023-04-18,"England League Two","Sutton","Northampton",1,2,"A",12,8,2,4,12,15,5,3,3,2,0,0,0,0,0,3,20,6,27,8,5,0
"20230418SWIBRA",2023-04-18,"England League Two","Swindon","Bradford",1,0,"H",12,17,3,3,7,7,5,3,0,2,0,0,0,0,0,1,29,6,14,8,2,0
"20230422AFCSWI",2023-04-22,"England League Two","AFC Wimbledon","Swindon",1,5,"A",16,17,5,8,12,14,7,2,3,4,1,0,0,0,0,6,33,13,26,9,7,1
"20230422BARCAR",2023-04-22,"England League Two","Barrow","Carlisle",0,1,"A",15,14,5,2,13,15,5,4,4,2,0,0,0,0,0,1,29,7,28,9,6,0
"20230422BRAGIL",2023-04-22,"England League Two","Bradford","Gillingham",2,2,"D",14,15,4,6,9,13,6,8,1,3,0,0,0,0,0,4,29,10,22,14,4,0
"20230422COLSUT",2023-04-22,"England League Two","Colchester","Sutton",4,1,"H",11,10,7,3,13,10,5,6,0,1,0,0,0,0,0,5,21,10,23,11,1,0
"20230422DONNEW",2023-04-22,"England League Two","Doncaster","Newport County",1,3,"A",6,11,2,3,8,12,2,4,2,4,0,0,0,0,0,4,17,5,20,6,6,0
"20230422HARCRA",2023-04-22,"England League Two","Hartlepool","Crawley Town",0,2,"A",15,12,5,3,10,13,3,2,2,4,0,0,0,0,0,2,27,8,23,5,6,0
"20230422LEYCRE",2023-04-22,"England League Two","Leyton Orient","Crewe",2,0,"H",13,4,7,2,14,12,6,8,1,2,0,0,0,0,0,2,17,9,26,14,3,0
"20230422MANSTE",2023-04-22,"England League Two","Mansfield","Stevenage",1,0,"H",12,6,1,3,13,7,2,4,1,1,0,0,0,0,0,1,18,4,20,6,2,0
"20230422NORHAR",2023-04-22,"England League Two","Northampton","Harrogate",3,1,"H",11,12,4,3,12,11,7,7,2,0,0,0,0,0,0,4,23,7,23,14,2,0
"20230422STOROC",2023-04-22,"England League Two","Stockport","Rochdale",1,0,"H",17,1,1,0,10,7,8,0,2,1,0,0,1,1,0,1,18,1,17,8,3,0
"20230422TRAGRI",2023-04-22,"England League Two","Tranmere","Grimsby",2,0,"H",6,17,5,5,7,15,5,8,1,2,0,0,0,0,0,2,23,10,22,13,3,0
"20230422WALSAL",2023-04-22,"England League Two","Walsall","Salford",2,3,"A",6,14,3,5,10,9,2,4,3,1,0,1,0,0,0,5,20,8,19,6,4,1
"20230425GRICRE",2023-04-25,"England League Two","Grimsby","Crewe",2,0,"H",15,16,7,5,13,12,2,8,1,1,0,0,0,0,0,2,31,12,25,10,2,0
"20230425MANLEY",2023-04-25,"England League Two","Mansfield","Leyton Orient",1,2,"A",16,9,4,2,16,7,7,1,2,3,0,1,0,0,0,3,25,6,23,8,5,1
"20230425NEWHAR",2023-04-25,"England League Two","Newport County","Harrogate",2,3,"A",19,6,4,4,8,15,8,1,3,1,0,0,0,0,0,5,25,8,23,9,4,0
"20230425SWISTE",2023-04-25,"England League Two","Swindon","Stevenage",0,1,"A",9,14,3,1,7,13,6,4,0,1,0,0,0,0,0,1,23,4,20,10,1,0
"20230429AFCTRA",2023-04-29,"England League Two","AFC Wimbledon","Tranmere",1,1,"D",10,6,2,3,11,11,4,4,0,0,0,0,0,0,0,2,16,5,22,8,0,0
"20230429CARSAL",2023-04-29,"England League Two","Carlisle","Salford",2,3,"A",10,13,2,4,11,11,3,3,4,3,1,0,0,0,0,5,23,6,22,6,7,1
"20230429CRAWAL",2023-04-29,"England League Two","Crawley Town","Walsall",0,0,"D",10,13,5,4,12,12,5,3,1,1,0,0,0,0,0,0,23,9,24,8,2,0
"20230429CRESWI",2023-04-29,"England League Two","Crewe","Swindon",2,1,"H",15,12,8,6,12,13,3,2,2,1,0,0,0,0,0,3,27,14,25,5,3,0
"20230429DONCOL",2023-04-29,"England League Two","Doncaster","Colchester",1,0,"H",8,17,1,6,6,9,3,7,1,3,0,0,0,0,0,1,25,7,15,10,4,0
"20230429GILNEW",2023-04-29,"England League Two","Gillingham","Newport County",1,2,"A",7,9,4,3,20,10,3,7,0,0,0,0,0,0,0,3,16,7,30,10,0,0
"20230429HARBAR",2023-04-29,"England League Two","Hartlepool","Barrow",3,1,"H",13,7,5,2,9,9,10,3,2,2,0,2,0,0,0,4,20,7,18,13,4,2
"20230429LEYSTO",2023-04-29,"England League Two","Leyton Orient","Stockport",0,3,"A",8,8,1,4,10,14,5,3,2,2,0,0,0,0,0,3,16,5,24,8,4,0
"20230429MANHAR",2023-04-29,"England League Two","Mansfield","Harrogate",1,2,"A",31,9,5,2,10,5,7,1,1,1,0,0,0,0,0,3,40,7,15,8,2,0
"20230429NORBRA",2023-04-29,"England League Two","Northampton","Bradford",1,2,"A",15,7,6,3,11,12,10,1,2,1,0,0,0,0,0,3,22,9,23,11,3,0
"20230429ROCSUT",2023-04-29,"England League Two","Rochdale","Sutton",4,1,"H",16,7,6,1,8,14,6,4,1,2,0,1,0,0,0,5,23,7,22,10,3,1
"20230429STEGRI",2023-04-29,"England League Two","Stevenage","Grimsby",2,0,"H",15,6,7,1,7,17,5,7,0,1,0,0,0,0,0,2,21,8,24,12,1,0
"20230503CREBRA",2023-05-03,"England League Two","Crewe","Bradford",3,2,"H",13,18,5,8,15,16,1,8,3,2,0,0,0,0,0,5,31,13,31,9,5,0
"20230508BARSTE",2023-05-08,"England League Two","Barrow","Stevenage",0,1,"A",10,10,4,2,8,14,2,2,1,1,0,0,0,0,0,1,20,6,22,4,2,0
"20230508BRALEY",2023-05-08,"England League Two","Bradford","Leyton Orient",1,1,"D",9,15,4,5,13,10,3,5,2,2,0,0,0,0,0,2,24,9,23,8,4,0
"20230508COLMAN",2023-05-08,"England League Two","Colchester","Mansfield",0,2,"A",17,16,4,5,5,17,3,8,2,1,0,0,0,0,0,2,33,9,22,11,3,0
"20230508GRIAFC",2023-05-08,"England League Two","Grimsby","AFC Wimbledon",1,0,"H",7,5,2,2,13,13,4,7,1,3,0,0,0,0,0,1,12,4,26,11,4,0
"20230508HARROC",2023-05-08,"England League Two","Harrogate","Rochdale",1,1,"D",13,6,5,1,11,13,6,3,0,0,0,0,0,0,0,2,19,6,24,9,0,0
"20230508NEWCRE",2023-05-08,"England League Two","Newport County","Crewe",2,2,"D",23,12,7,6,11,7,12,1,1,1,0,0,0,0,0,4,35,13,18,13,2,0
"20230508SALGIL",2023-05-08,"England League Two","Salford","Gillingham",0,1,"A",13,6,6,2,11,12,6,2,2,2,0,0,0,0,0,1,19,8,23,8,4,0
"20230508STOHAR",2023-05-08,"England League Two","Stockport","Hartlepool",1,1,"D",16,5,10,3,11,16,9,1,0,1,0,0,0,0,0,2,21,13,27,10,1,0
"20230508SUTCAR",2023-05-08,"England League Two","Sutton","Carlisle",1,1,"D",12,11,2,2,9,11,5,2,0,1,0,0,0,0,0,2,23,4,20,7,1,0
"20230508SWICRA",2023-05-08,"England League Two","Swindon","Crawley Town",2,1,"H",15,6,8,4,11,13,7,3,1,2,0,0,0,0,0,3,21,12,24,10,3,0
"20230508TRANOR",2023-05-08,"England League Two","Tranmere","Northampton",0,1,"A",10,12,0,1,8,5,9,8,1,1,0,0,0,0,0,1,22,1,13,17,2,0
"20230508WALDON",2023-05-08,"England League Two","Walsall","Doncaster",2,1,"H",15,13,6,4,12,4,3,5,0,1,0,0,0,0,0,3,28,10,16,8,1,0
"20230805ACCNEW",2023-08-05,"England League Two","Accrington","Newport County",3,0,"H",16,17,8,2,11,13,7,4,2,0,0,0,0,0,0,3,33,10,24,11,2,0
"20230805CRABRA",2023-08-05,"England League Two","Crawley Town","Bradford",1,0,"H",21,14,3,7,14,14,2,4,6,3,0,1,0,0,0,1,35,10,28,6,9,1
"20230805CREMAN",2023-08-05,"England League Two","Crewe","Mansfield",2,2,"D",13,21,3,9,8,16,10,5,2,4,0,1,0,0,0,4,34,12,24,15,6,1
"20230805DONHAR",2023-08-05,"England League Two","Doncaster","Harrogate",0,1,"A",12,7,3,6,7,20,6,5,1,4,0,0,0,0,0,1,19,9,27,11,5,0
"20230805FORSAL",2023-08-05,"England League Two","Forest Green","Salford",0,2,"A",19,7,4,3,17,9,10,4,3,3,0,0,0,0,0,2,26,7,26,14,6,0
"20230805GRIAFC",2023-08-05,"England League Two","Grimsby","AFC Wimbledon",0,0,"D",15,10,5,4,10,12,8,5,4,3,0,0,0,0,0,0,25,9,22,13,7,0
"20230805MORWAL",2023-08-05,"England League Two","Morecambe","Walsall",2,1,"H",7,11,5,1,12,7,5,3,6,4,0,0,0,0,0,3,18,6,19,8,10,0
"20230805STOGIL",2023-08-05,"England League Two","Stockport","Gillingham",0,1,"A",16,6,3,3,11,11,6,1,0,5,0,0,0,0,0,1,22,6,22,7,5,0
"20230805SUTNOT",2023-08-05,"England League Two","Sutton","Notts County",5,1,"H",12,14,6,3,16,8,4,5,3,3,0,1,0,0,0,6,26,9,24,9,6,1
"20230805TRABAR",2023-08-05,"England League Two","Tranmere","Barrow",1,2,"A",17,7,3,3,9,8,7,4,2,2,0,0,0,0,0,3,24,6,17,11,4,0
"20230805WREMIL",2023-08-05,"England League Two","Wrexham","Milton Keynes Dons",3,5,"A",23,8,5,6,15,9,5,4,2,3,0,0,0,0,0,8,31,11,24,9,5,0
"20230812AFCWRE",2023-08-12,"England League Two","AFC Wimbledon","Wrexham",1,1,"D",13,10,3,6,12,12,6,4,3,2,0,0,0,0,0,2,23,9,24,10,5,0
"20230812BARSUT",2023-08-12,"England League Two","Barrow","Sutton",2,1,"H",17,9,7,3,8,7,9,1,0,1,0,1,0,0,0,3,26,10,15,10,1,1
"20230812BRACOL",2023-08-12,"England League Two","Bradford","Colchester",2,1,"H",19,11,7,2,3,9,4,11,2,2,0,0,0,0,0,3,30,9,12,15,4,0
"20230812GILACC",2023-08-12,"England League Two","Gillingham","Accrington",1,0,"H",17,9,4,1,14,13,9,1,3,2,0,0,0,0,0,1,26,5,27,10,5,0
"20230812HARFOR",2023-08-12,"England League Two","Harrogate","Forest Green",0,1,"A",10,15,3,2,7,11,8,5,1,3,0,0,0,0,0,1,25,5,18,13,4,0
"20230812MANMOR",2023-08-12,"England League Two","Mansfield","Morecambe",3,0,"H",27,5,6,0,9,11,5,4,2,2,0,0,0,0,0,3,32,6,20,9,4,0
"20230812MILTRA",2023-08-12,"England League Two","Milton Keynes Dons","Tranmere",1,0,"H",7,16,2,3,8,12,3,11,2,1,0,0,1,1,0,1,23,5,20,14,3,0
"20230812NEWDON",2023-08-12,"England League Two","Newport County","Doncaster",4,0,"H",14,8,6,2,10,18,2,5,4,6,0,0,0,0,0,4,22,8,28,7,10,0
"20230812NOTGRI",2023-08-12,"England League Two","Notts County","Grimsby",3,2,"H",12,10,8,3,6,16,7,6,4,4,0,0,0,0,0,5,22,11,22,13,8,0
"20230812SALCRA",2023-08-12,"England League Two","Salford","Crawley Town",1,1,"D",7,16,3,2,13,10,2,3,1,4,0,0,0,0,0,2,23,5,23,5,5,0
"20230812SWICRE",2023-08-12,"England League Two","Swindon","Crewe",2,2,"D",20,16,6,5,13,13,7,2,4,6,0,0,0,0,0,4,36,11,26,9,10,0
"20230812WALSTO",2023-08-12,"England League Two","Walsall","Stockport",2,1,"H",9,18,2,3,8,9,4,11,3,5,0,0,0,0,0,3,27,5,17,15,8,0
"20230815ACCBAR",2023-08-15,"England League Two","Accrington","Barrow",1,1,"D",7,13,2,1,10,5,1,10,2,1,0,0,0,0,0,2,20,3,15,11,3,0
"20230815COLAFC",2023-08-15,"England League Two","Colchester","AFC Wimbledon",0,2,"A",9,21,4,7,8,12,7,9,3,3,0,0,0,0,0,2,30,11,20,16,6,0
"20230815CRAMIL",2023-08-15,"England League Two","Crawley Town","Milton Keynes Dons",2,1,"H",14,8,5,2,8,11,7,5,1,2,0,0,0,0,0,3,22,7,19,12,3,0
"20230815CRENEW",2023-08-15,"England League Two","Crewe","Newport County",4,2,"H",10,14,6,7,4,12,1,5,0,2,0,0,0,0,0,6,24,13,16,6,2,0
"20230815DONMAN",2023-08-15,"England League Two","Doncaster","Mansfield",2,2,"D",11,21,5,8,8,10,3,7,1,3,0,0,0,0,0,4,32,13,18,10,4,0
"20230815FORSWI",2023-08-15,"England League Two","Forest Green","Swindon",1,2,"A",13,21,5,8,12,11,6,5,4,3,1,0,0,0,0,3,34,13,23,11,7,1
"20230815GRISAL",2023-08-15,"England League Two","Grimsby","Salford",2,0,"H",10,7,2,1,16,16,2,7,0,3,0,1,0,0,0,2,17,3,32,9,3,1
"20230815MORNOT",2023-08-15,"England League Two","Morecambe","Notts County",0,0,"D",13,9,1,1,7,4,4,5,1,1,0,0,0,0,0,0,22,2,11,9,2,0
"20230815STOBRA",2023-08-15,"England League Two","Stockport","Bradford",1,1,"D",15,10,5,6,8,16,7,4,2,3,0,0,0,0,0,2,25,11,24,11,5,0
"20230815SUTGIL",2023-08-15,"England League Two","Sutton","Gillingham",0,1,"A",6,5,2,1,6,10,2,9,2,1,0,0,0,0,0,1,11,3,16,11,3,0
"20230815TRAHAR",2023-08-15,"England League Two","Tranmere","Harrogate",3,0,"H",11,11,5,2,10,17,6,3,2,1,0,0,0,0,0,3,22,7,27,9,3,0
"20230815WREWAL",2023-08-15,"England League Two","Wrexham","Walsall",4,2,"H",20,12,11,5,3,9,6,3,1,3,0,0,0,0,0,6,32,16,12,9,4,0
"20230819ACCHAR",2023-08-19,"England League Two","Accrington","Harrogate",2,1,"H",23,11,7,2,14,15,5,3,4,4,1,0,0,0,0,3,34,9,29,8,8,1
"20230819COLMIL",2023-08-19,"England League Two","Colchester","Milton Keynes Dons",2,3,"A",12,18,4,6,16,8,3,6,5,4,0,0,0,0,0,5,30,10,24,9,9,0
"20230819CRAGIL",2023-08-19,"England League Two","Crawley Town","Gillingham",0,1,"A",17,7,7,2,8,10,9,4,3,3,0,0,0,0,0,1,24,9,18,13,6,0
"20230819CREWAL",2023-08-19,"England League Two","Crewe","Walsall",2,2,"D",11,19,3,7,6,10,8,5,1,1,0,0,0,0,0,4,30,10,16,13,2,0
"20230819DONNOT",2023-08-19,"England League Two","Doncaster","Notts County",1,3,"A",10,8,6,5,10,8,4,3,0,3,0,0,0,0,0,4,18,11,18,7,3,0
"20230819FORNEW",2023-08-19,"England League Two","Forest Green","Newport County",0,3,"A",12,10,1,7,6,7,7,4,2,0,1,0,0,0,0,3,22,8,13,11,2,1
"20230819GRIMAN",2023-08-19,"England League Two","Grimsby","Mansfield",1,1,"D",8,20,3,4,7,11,4,6,0,0,0,0,0,0,0,2,28,7,18,10,0,0
"20230819MORBRA",2023-08-19,"England League Two","Morecambe","Bradford",3,0,"H",11,12,3,5,15,11,6,3,3,3,0,0,0,0,0,3,23,8,26,9,6,0
"20230819STOBAR",2023-08-19,"England League Two","Stockport","Barrow",1,0,"H",11,10,5,3,10,5,4,3,2,1,0,0,0,0,0,1,21,8,15,7,3,0
"20230819SUTAFC",2023-08-19,"England League Two","Sutton","AFC Wimbledon",0,3,"A",10,15,4,5,7,18,4,5,2,1,0,0,0,0,0,3,25,9,25,9,3,0
"20230819TRASAL",2023-08-19,"England League Two","Tranmere","Salford",3,4,"A",13,15,6,6,14,10,4,5,1,2,0,0,0,0,0,7,28,12,24,9,3,0
"20230819WRESWI",2023-08-19,"England League Two","Wrexham","Swindon",5,5,"D",28,8,12,6,12,17,9,2,1,3,0,0,0,0,0,10,36,18,29,11,4,0
"20230826AFCFOR",2023-08-26,"England League Two","AFC Wimbledon","Forest Green",1,1,"D",22,8,6,3,12,4,9,2,2,1,0,0,0,0,0,2,30,9,16,11,3,0
"20230826BARWRE",2023-08-26,"England League Two","Barrow","Wrexham",1,1,"D",5,12,2,4,9,9,3,10,3,2,0,0,0,0,0,2,17,6,18,13,5,0
"20230826BRACRE",2023-08-26,"England League Two","Bradford","Crewe",1,0,"H",12,10,2,3,10,8,4,11,2,0,0,0,0,0,0,1,22,5,18,15,2,0
"20230826GILCOL",2023-08-26,"England League Two","Gillingham","Colchester",0,3,"A",10,12,4,5,14,18,3,4,2,4,1,0,0,0,0,3,22,9,32,7,6,1
"20230826HARMOR",2023-08-26,"England League Two","Harrogate","Morecambe",2,0,"H",16,9,6,1,13,11,1,4,3,3,0,1,0,0,0,2,25,7,24,5,6,1
"20230826MANSTO",2023-08-26,"England League Two","Mansfield","Stockport",3,2,"H",28,10,11,3,5,7,11,1,1,0,0,0,0,0,0,5,38,14,12,12,1,0
"20230826MILDON",2023-08-26,"England League Two","Milton Keynes Dons","Doncaster",2,1,"H",9,17,5,6,8,17,2,8,1,1,0,0,0,0,0,3,26,11,25,10,2,0
"20230826NEWSUT",2023-08-26,"England League Two","Newport County","Sutton",3,1,"H",13,15,5,5,8,10,1,6,1,3,0,0,0,0,0,4,28,10,18,7,4,0
"20230826NOTTRA",2023-08-26,"England League Two","Notts County","Tranmere",2,1,"H",17,12,6,4,6,8,11,3,3,3,0,0,0,0,0,3,29,10,14,14,6,0
"20230826SALACC",2023-08-26,"England League Two","Salford","Accrington",1,2,"A",16,16,2,6,20,10,1,6,3,3,0,0,0,0,0,3,32,8,30,7,6,0
"20230826SWICRA",2023-08-26,"England League Two","Swindon","Crawley Town",6,0,"H",17,14,10,3,10,10,5,6,0,1,0,0,0,0,0,6,31,13,20,11,1,0
"20230826WALGRI",2023-08-26,"England League Two","Walsall","Grimsby",1,1,"D",16,11,6,2,13,11,8,10,2,3,1,0,0,0,0,2,27,8,24,18,5,1
"20230902TRAWRE",2023-09-02,"England League Two","Tranmere","Wrexham",0,1,"A",11,23,2,5,7,11,7,17,1,1,0,0,0,0,0,1,34,7,18,24,2,0
"20230902CREMIL",2023-09-02,"England League Two","Crewe","Milton Keynes Dons",3,1,"H",15,12,7,4,12,8,8,2,4,1,0,0,0,0,0,4,27,11,20,10,5,0
"20230902DONSWI",2023-09-02,"England League Two","Doncaster","Swindon",0,0,"D",6,13,3,2,9,15,1,11,4,4,1,0,0,0,0,0,19,5,24,12,8,1
"20230902GRIGIL",2023-09-02,"England League Two","Grimsby","Gillingham",2,0,"H",12,6,4,3,6,12,6,4,1,0,0,0,0,0,0,2,18,7,18,10,1,0
"20230902HARBAR",2023-09-02,"England League Two","Harrogate","Barrow",0,1,"A",12,10,5,2,11,10,8,6,2,2,0,0,0,0,0,1,22,7,21,14,4,0
"20230902MANBRA",2023-09-02,"England League Two","Mansfield","Bradford",0,0,"D",11,9,1,2,10,12,8,2,2,4,0,0,0,0,0,0,20,3,22,10,6,0
"20230902MORSAL",2023-09-02,"England League Two","Morecambe","Salford",1,0,"H",11,7,5,2,14,11,9,3,0,0,0,1,0,0,0,1,18,7,25,12,0,1
"20230902NEWAFC",2023-09-02,"England League Two","Newport County","AFC Wimbledon",2,2,"D",11,14,4,4,6,8,6,3,1,1,0,0,0,0,0,4,25,8,14,9,2,0
"20230902NOTACC",2023-09-02,"England League Two","Notts County","Accrington",3,1,"H",10,16,5,6,11,11,2,7,4,2,0,0,0,0,0,4,26,11,22,9,6,0
"20230902STOCRA",2023-09-02,"England League Two","Stockport","Crawley Town",3,3,"D",17,8,5,5,7,12,2,3,1,5,0,0,0,0,0,6,25,10,19,5,6,0
"20230902SUTFOR",2023-09-02,"England League Two","Sutton","Forest Green",0,1,"A",12,17,2,6,13,14,7,3,1,2,0,0,0,0,0,1,29,8,27,10,3,0
"20230902WALCOL",2023-09-02,"England League Two","Walsall","Colchester",1,0,"H",16,10,7,3,17,9,6,4,4,1,0,0,0,0,0,1,26,10,26,10,5,0
"20230909BRAGRI",2023-09-09,"England League Two","Bradford","Grimsby",1,1,"D",9,7,1,3,10,10,7,2,2,4,0,0,0,0,0,2,16,4,20,9,6,0
"20230909ACCMAN",2023-09-09,"England League Two","Accrington","Mansfield",0,3,"A",13,12,2,5,13,17,5,4,1,1,0,0,0,0,0,3,25,7,30,9,2,0
"20230909AFCSTO",2023-09-09,"England League Two","AFC Wimbledon","Stockport",1,2,"A",9,12,4,3,13,7,3,5,2,2,0,0,0,0,0,3,21,7,20,8,4,0
"20230909COLTRA",2023-09-09,"England League Two","Colchester","Tranmere",2,0,"H",27,10,12,4,10,8,11,5,2,4,0,0,0,0,0,2,37,16,18,16,6,0
"20230909CRANEW",2023-09-09,"England League Two","Crawley Town","Newport County",4,1,"H",13,9,8,5,8,9,4,0,2,1,0,0,0,0,0,5,22,13,17,4,3,0
"20230909FORCRE",2023-09-09,"England League Two","Forest Green","Crewe",1,4,"A",9,18,4,5,12,10,3,7,4,3,0,0,0,0,0,5,27,9,22,10,7,0
"20230909GILHAR",2023-09-09,"England League Two","Gillingham","Harrogate",1,0,"H",15,5,4,2,12,7,10,2,3,1,0,0,0,0,0,1,20,6,19,12,4,0
"20230909MILNOT",2023-09-09,"England League Two","Milton Keynes Dons","Notts County",1,1,"D",11,9,3,3,12,5,3,6,1,0,0,0,0,0,0,2,20,6,17,9,1,0
"20230909SALWAL",2023-09-09,"England League Two","Salford","Walsall",1,2,"A",20,10,7,5,12,12,12,1,2,1,0,0,0,0,0,3,30,12,24,13,3,0
"20230909SWISUT",2023-09-09,"England League Two","Swindon","Sutton",5,3,"H",15,13,7,5,4,6,5,3,1,2,0,0,0,0,0,8,28,12,10,8,3,0
"20230909WREDON",2023-09-09,"England League Two","Wrexham","Doncaster",2,1,"H",16,8,8,2,9,13,6,4,2,3,0,0,0,0,0,3,24,10,22,10,5,0
"20230915SALNOT",2023-09-15,"England League Two","Salford","Notts County",0,2,"A",12,14,2,4,11,11,1,8,3,2,1,1,0,0,0,2,26,6,22,9,5,2
"20230916ACCSUT",2023-09-16,"England League Two","Accrington","Sutton",4,1,"H",15,12,5,1,10,12,2,3,3,1,0,0,1,0,1,5,27,6,22,5,4,0
"20230916AFCCRE",2023-09-16,"England League Two","AFC Wimbledon","Crewe",2,2,"D",21,9,6,4,11,9,13,7,2,2,0,0,0,0,0,4,30,10,20,20,4,0
"20230916BRAHAR",2023-09-16,"England League Two","Bradford","Harrogate",1,1,"D",9,8,3,1,8,10,3,5,0,2,0,0,0,0,0,2,17,4,18,8,2,0
"20230916COLMAN",2023-09-16,"England League Two","Colchester","Mansfield",1,1,"D",12,10,4,5,9,4,3,4,4,3,0,0,0,0,0,2,22,9,13,7,7,0
"20230916CRATRA",2023-09-16,"England League Two","Crawley Town","Tranmere",3,2,"H",16,7,7,4,7,9,9,0,4,5,0,0,0,0,0,5,23,11,16,9,9,0
"20230916FORDON",2023-09-16,"England League Two","Forest Green","Doncaster",1,2,"A",28,15,3,7,8,10,10,12,4,2,0,0,0,0,0,3,43,10,18,22,6,0
"20230916GILMOR",2023-09-16,"England League Two","Gillingham","Morecambe",2,1,"H",11,5,5,3,8,16,4,3,2,3,0,1,0,0,0,3,16,8,24,7,5,1
"20230916MILSTO",2023-09-16,"England League Two","Milton Keynes Dons","Stockport",1,2,"A",20,10,3,5,11,10,9,4,4,2,0,0,0,0,0,3,30,8,21,13,6,0
"20230916NEWBAR",2023-09-16,"England League Two","Newport County","Barrow",1,1,"D",8,6,2,3,13,17,3,10,2,2,1,0,0,0,0,2,14,5,30,13,4,1
"20230916SWIWAL",2023-09-16,"England League Two","Swindon","Walsall",2,0,"H",12,7,6,2,5,10,4,2,2,2,0,1,0,0,0,2,19,8,15,6,4,1
"20230916WREGRI",2023-09-16,"England League Two","Wrexham","Grimsby",3,0,"H",17,9,9,1,7,6,3,1,2,2,0,0,0,0,0,3,26,10,13,4,4,0
"20230923CRECOL",2023-09-23,"England League Two","Crewe","Colchester",2,1,"H",10,21,3,6,15,11,6,10,1,0,0,0,0,0,0,3,31,9,26,16,1,0
"20230923DONGIL",2023-09-23,"England League Two","Doncaster","Gillingham",2,1,"H",13,15,6,5,9,10,7,6,2,2,0,0,0,0,0,3,28,11,19,13,4,0
"20230923GRICRA",2023-09-23,"England League Two","Grimsby","Crawley Town",2,3,"A",18,13,7,3,14,8,5,5,1,1,0,0,0,0,0,5,31,10,22,10,2,0
"20230923HARSAL",2023-09-23,"England League Two","Harrogate","Salford",3,2,"H",16,18,7,5,6,10,7,5,2,2,0,0,0,0,0,5,34,12,16,12,4,0
"20230923MANBAR",2023-09-23,"England League Two","Mansfield","Barrow",1,0,"H",14,9,2,2,9,11,6,2,2,1,0,1,0,0,0,1,23,4,20,8,3,1
"20230923MORSWI",2023-09-23,"England League Two","Morecambe","Swindon",2,2,"D",16,13,4,5,11,6,9,4,1,2,1,0,0,0,0,4,29,9,17,13,3,1
"20230923NEWBRA",2023-09-23,"England League Two","Newport County","Bradford",1,4,"A",7,17,1,7,9,8,6,7,2,1,0,0,0,0,0,5,24,8,17,13,3,0
"20230923NOTFOR",2023-09-23,"England League Two","Notts County","Forest Green",4,3,"H",11,14,6,4,10,11,7,10,3,5,0,0,0,0,0,7,25,10,21,17,8,0
"20230923STOWRE",2023-09-23,"England League Two","Stockport","Wrexham",5,0,"H",10,20,5,5,10,13,1,5,1,1,0,0,0,0,0,5,30,10,23,6,2,0
"20230923SUTMIL",2023-09-23,"England League Two","Sutton","Milton Keynes Dons",1,1,"D",10,12,5,2,10,13,7,10,0,1,0,0,0,0,0,2,22,7,23,17,1,0
"20230923TRAACC",2023-09-23,"England League Two","Tranmere","Accrington",2,0,"H",17,9,7,3,11,16,8,6,0,3,0,1,0,0,0,2,26,10,27,14,3,1
"20230923WALAFC",2023-09-23,"England League Two","Walsall","AFC Wimbledon",1,3,"A",5,15,1,6,9,13,0,5,0,2,1,0,0,0,0,4,20,7,22,5,2,1
"20230930ACCSTO",2023-09-30,"England League Two","Accrington","Stockport",1,3,"A",14,6,4,4,16,10,9,4,1,1,0,0,0,0,0,4,20,8,26,13,2,0
"20230930AFCTRA",2023-09-30,"England League Two","AFC Wimbledon","Tranmere",4,1,"H",19,8,8,2,9,10,4,4,1,2,0,1,0,0,0,5,27,10,19,8,3,1
"20230930BARDON",2023-09-30,"England League Two","Barrow","Doncaster",3,2,"H",7,12,4,4,12,16,1,8,4,3,0,0,0,0,0,5,19,8,28,9,7,0
"20230930BRAWAL",2023-09-30,"England League Two","Bradford","Walsall",1,3,"A",10,7,2,4,8,9,10,5,1,4,0,0,0,0,0,4,17,6,17,15,5,0
"20230930COLNOT",2023-09-30,"England League Two","Colchester","Notts County",5,4,"H",15,21,8,7,8,9,3,8,3,3,1,0,0,0,0,9,36,15,17,11,6,1
"20230930CRASUT",2023-09-30,"England League Two","Crawley Town","Sutton",3,0,"H",18,7,7,2,8,12,5,4,1,3,0,0,0,0,0,3,25,9,20,9,4,0
"20230930FORMOR",2023-09-30,"England League Two","Forest Green","Morecambe",1,2,"A",13,14,2,11,8,6,7,7,3,2,0,0,0,0,0,3,27,13,14,14,5,0
"20230930GILMAN",2023-09-30,"England League Two","Gillingham","Mansfield",1,1,"D",20,17,4,3,11,13,5,11,4,2,0,0,0,0,0,2,37,7,24,16,6,0
"20230930MILHAR",2023-09-30,"England League Two","Milton Keynes Dons","Harrogate",0,1,"A",27,3,4,3,12,5,11,3,3,1,0,0,0,0,0,1,30,7,17,14,4,0
"20230930SALNEW",2023-09-30,"England League Two","Salford","Newport County",2,1,"H",10,15,2,4,11,12,2,6,1,3,0,0,0,0,0,3,25,6,23,8,4,0
"20230930SWIGRI",2023-09-30,"England League Two","Swindon","Grimsby",2,1,"H",8,13,3,4,5,10,9,7,2,2,0,0,0,0,0,3,21,7,15,16,4,0
"20230930WRECRE",2023-09-30,"England League Two","Wrexham","Crewe",3,3,"D",12,11,6,7,12,12,7,6,4,4,1,0,0,0,0,6,23,13,24,13,8,1
"20231003CREGIL",2023-10-03,"England League Two","Crewe","Gillingham",2,0,"H",9,13,4,5,7,9,6,4,1,0,0,0,0,0,0,2,22,9,16,10,1,0
"20231003DONCRA",2023-10-03,"England League Two","Doncaster","Crawley Town",2,0,"H",17,15,8,4,15,12,5,5,3,3,0,0,0,0,0,2,32,12,27,10,6,0
"20231003GRIBAR",2023-10-03,"England League Two","Grimsby","Barrow",2,1,"H",9,24,6,7,13,11,4,7,1,1,0,0,0,0,0,3,33,13,24,11,2,0
"20231003HARAFC",2023-10-03,"England League Two","Harrogate","AFC Wimbledon",0,1,"A",4,16,2,4,10,15,2,4,2,2,0,0,0,0,0,1,20,6,25,6,4,0
"20231003MANWRE",2023-10-03,"England League Two","Mansfield","Wrexham",0,0,"D",19,7,5,1,10,5,10,6,2,1,0,0,0,0,0,0,26,6,15,16,3,0
"20231003MORACC",2023-10-03,"England League Two","Morecambe","Accrington",1,1,"D",15,15,6,3,17,9,4,9,3,3,0,0,0,0,0,2,30,9,26,13,6,0
"20231003NEWCOL",2023-10-03,"England League Two","Newport County","Colchester",2,1,"H",18,14,7,4,12,11,8,5,2,2,0,1,0,0,0,3,32,11,23,13,4,1
"20231003NOTSWI",2023-10-03,"England League Two","Notts County","Swindon",3,1,"H",10,19,6,4,13,14,3,5,3,2,0,0,0,0,0,4,29,10,27,8,5,0
"20231003STOFOR",2023-10-03,"England League Two","Stockport","Forest Green",2,0,"H",15,6,6,1,8,15,4,3,1,0,0,1,0,0,0,2,21,7,23,7,1,1
"20231003SUTSAL",2023-10-03,"England League Two","Sutton","Salford",0,2,"A",8,11,2,5,15,10,4,3,1,3,0,0,0,0,0,2,19,7,25,7,4,0
"20231003TRABRA",2023-10-03,"England League Two","Tranmere","Bradford",2,1,"H",9,10,5,5,6,15,5,6,3,3,0,0,0,0,0,3,19,10,21,11,6,0
"20231003WALMIL",2023-10-03,"England League Two","Walsall","Milton Keynes Dons",0,0,"D",12,18,4,5,17,8,5,3,3,3,0,0,0,0,0,0,30,9,25,8,6,0
"20231007ACCFOR",2023-10-07,"England League Two","Accrington","Forest Green",2,1,"H",16,15,4,5,13,12,4,5,1,1,0,0,0,0,0,3,31,9,25,9,2,0
"20231007BARNOT",2023-10-07,"England League Two","Barrow","Notts County",1,1,"D",14,5,6,1,7,11,2,5,1,3,0,0,0,0,0,2,19,7,18,7,4,0
"20231007BRASWI",2023-10-07,"England League Two","Bradford","Swindon",1,0,"H",19,11,4,2,11,7,6,3,3,3,0,0,1,0,1,1,30,6,18,9,6,0
"20231007COLMOR",2023-10-07,"England League Two","Colchester","Morecambe",1,3,"A",21,15,5,7,7,12,5,4,2,4,0,1,0,0,0,4,36,12,19,9,6,1
"20231007CRAWRE",2023-10-07,"England League Two","Crawley Town","Wrexham",0,1,"A",25,10,5,5,8,9,6,8,2,6,0,1,0,0,0,1,35,10,17,14,8,1
"20231007GILMIL",2023-10-07,"England League Two","Gillingham","Milton Keynes Dons",2,1,"H",16,27,6,8,11,10,6,4,2,3,0,1,0,0,0,3,43,14,21,10,5,1
"20231007MANAFC",2023-10-07,"England League Two","Mansfield","AFC Wimbledon",0,0,"D",20,8,4,4,13,13,6,3,2,2,0,0,0,0,0,0,28,8,26,9,4,0
"20231007NEWHAR",2023-10-07,"England League Two","Newport County","Harrogate",1,2,"A",11,7,4,3,16,6,5,4,2,2,0,0,0,0,0,3,18,7,22,9,4,0
"20231007SALCRE",2023-10-07,"England League Two","Salford","Crewe",4,2,"H",14,14,7,3,13,14,5,1,2,2,0,0,0,0,0,6,28,10,27,6,4,0
"20231007STODON",2023-10-07,"England League Two","Stockport","Doncaster",1,0,"H",10,6,4,4,6,11,6,6,2,1,0,0,0,0,0,1,16,8,17,12,3,0
"20231007SUTWAL",2023-10-07,"England League Two","Sutton","Walsall",4,0,"H",12,13,6,5,15,8,4,5,0,0,0,0,0,0,0,4,25,11,23,9,0,0
"20231007TRAGRI",2023-10-07,"England League Two","Tranmere","Grimsby",2,2,"D",8,13,3,5,10,9,1,5,1,1,0,0,0,0,0,4,21,8,19,6,2,0
"20231014NOTMAN",2023-10-14,"England League Two","Notts County","Mansfield",1,4,"A",9,21,2,9,4,10,5,6,1,1,0,0,0,0,0,5,30,11,14,11,2,0
"20231014AFCBRA",2023-10-14,"England League Two","AFC Wimbledon","Bradford",0,1,"A",11,7,5,2,13,13,10,4,3,2,0,0,0,0,0,1,18,7,26,14,5,0
"20231014CRETRA",2023-10-14,"England League Two","Crewe","Tranmere",2,0,"H",16,13,4,3,7,10,10,4,3,1,0,2,0,0,0,2,29,7,17,14,4,2
"20231014DONSUT",2023-10-14,"England League Two","Doncaster","Sutton",4,1,"H",12,6,5,3,15,10,2,1,2,3,0,0,0,0,0,5,18,8,25,3,5,0
"20231014FORCOL",2023-10-14,"England League Two","Forest Green","Colchester",5,0,"H",14,6,10,1,11,12,5,3,1,1,0,1,0,0,0,5,20,11,23,8,2,1
"20231014GRIACC",2023-10-14,"England League Two","Grimsby","Accrington",0,2,"A",11,12,2,2,17,14,9,4,0,2,1,0,0,0,0,2,23,4,31,13,2,1
"20231014HARSTO",2023-10-14,"England League Two","Harrogate","Stockport",1,3,"A",6,16,4,7,7,12,5,8,0,1,0,0,0,0,0,4,22,11,19,13,1,0
"20231014MILBAR",2023-10-14,"England League Two","Milton Keynes Dons","Barrow",2,2,"D",15,18,5,9,14,11,1,8,2,1,0,0,0,0,0,4,33,14,25,9,3,0
"20231014SWINEW",2023-10-14,"England League Two","Swindon","Newport County",2,0,"H",13,11,6,4,12,14,7,5,1,0,0,0,0,0,0,2,24,10,26,12,1,0
"20231014WALGIL",2023-10-14,"England League Two","Walsall","Gillingham",4,1,"H",13,14,7,5,14,6,0,4,3,3,0,0,0,0,0,5,27,12,20,4,6,0
"20231014WRESAL",2023-10-14,"England League Two","Wrexham","Salford",3,2,"H",21,10,7,4,13,8,11,3,3,4,0,0,0,0,0,5,31,11,21,14,7,0
"20231020NEWWAL",2023-10-20,"England League Two","Newport County","Walsall",3,3,"D",8,16,5,6,10,9,7,6,0,2,0,0,0,0,0,6,24,11,19,13,2,0
"20231020TRADON",2023-10-20,"England League Two","Tranmere","Doncaster",1,2,"A",12,11,3,5,9,6,5,3,3,2,0,0,0,0,0,3,23,8,15,8,5,0
"20231021ACCMIL",2023-10-21,"England League Two","Accrington","Milton Keynes Dons",1,0,"H",13,10,4,1,24,7,6,4,2,1,0,0,0,0,0,1,23,5,31,10,3,0
"20231021BARAFC",2023-10-21,"England League Two","Barrow","AFC Wimbledon",0,0,"D",13,10,3,4,12,9,6,4,0,2,0,0,0,0,0,0,23,7,21,10,2,0
"20231021BRAWRE",2023-10-21,"England League Two","Bradford","Wrexham",1,1,"D",21,8,5,1,10,8,11,3,3,2,0,0,0,0,0,2,29,6,18,14,5,0
"20231021COLHAR",2023-10-21,"England League Two","Colchester","Harrogate",1,2,"A",20,8,5,2,6,3,10,3,1,0,0,0,0,0,0,3,28,7,9,13,1,0
"20231021CRACRE",2023-10-21,"England League Two","Crawley Town","Crewe",2,4,"A",14,12,5,8,9,10,6,7,4,2,0,0,0,0,0,6,26,13,19,13,6,0
"20231021GILNOT",2023-10-21,"England League Two","Gillingham","Notts County",1,2,"A",11,10,2,7,8,5,3,5,2,3,0,0,0,0,0,3,21,9,13,8,5,0
"20231021SALSWI",2023-10-21,"England League Two","Salford","Swindon",2,2,"D",15,15,7,7,8,6,2,11,3,1,1,0,0,0,0,4,30,14,14,13,4,1
"20231021STOGRI",2023-10-21,"England League Two","Stockport","Grimsby",3,2,"H",11,10,6,4,14,22,3,0,2,3,0,0,0,0,0,5,21,10,36,3,5,0
"20231021SUTMOR",2023-10-21,"England League Two","Sutton","Morecambe",2,3,"A",7,7,2,5,5,10,11,4,1,2,0,0,0,0,0,5,14,7,15,15,3,0
"20231024AFCACC",2023-10-24,"England League Two","AFC Wimbledon","Accrington",2,4,"A",14,17,7,9,16,17,4,2,3,3,0,0,0,0,0,6,31,16,33,6,6,0
"20231024CRESTO",2023-10-24,"England League Two","Crewe","Stockport",0,2,"A",5,7,0,3,9,12,6,4,2,1,0,0,0,0,0,2,12,3,21,10,3,0
"20231024DONSAL",2023-10-24,"England League Two","Doncaster","Salford",0,3,"A",20,11,4,4,5,10,8,3,0,2,0,0,0,0,0,3,31,8,15,11,2,0
"20231024FORBAR",2023-10-24,"England League Two","Forest Green","Barrow",0,2,"A",17,12,7,4,12,9,5,4,2,1,0,0,0,0,0,2,29,11,21,9,3,0
"20231024GRICOL",2023-10-24,"England League Two","Grimsby","Colchester",2,3,"A",18,9,6,4,11,7,3,3,1,3,0,0,0,0,0,5,27,10,18,6,4,0
"20231024HARMAN",2023-10-24,"England League Two","Harrogate","Mansfield",1,4,"A",11,34,3,11,9,13,2,7,1,3,0,0,0,0,0,5,45,14,22,9,4,0
"20231024MILBRA",2023-10-24,"England League Two","Milton Keynes Dons","Bradford",4,1,"H",18,7,11,2,11,11,4,1,0,4,0,0,0,0,0,5,25,13,22,5,4,0
"20231024MORTRA",2023-10-24,"England League Two","Morecambe","Tranmere",1,0,"H",15,13,5,5,9,9,10,5,2,2,0,0,0,0,0,1,28,10,18,15,4,0
"20231024NOTNEW",2023-10-24,"England League Two","Notts County","Newport County",3,0,"H",18,10,4,3,6,5,5,2,0,1,0,0,0,0,0,3,28,7,11,7,1,0
"20231024SWIGIL",2023-10-24,"England League Two","Swindon","Gillingham",0,1,"A",22,12,7,4,6,10,6,10,0,2,0,0,0,0,0,1,34,11,16,16,2,0
"20231024WALCRA",2023-10-24,"England League Two","Walsall","Crawley Town",1,1,"D",17,7,7,4,11,8,6,6,0,3,0,0,0,0,0,2,24,11,19,12,3,0
"20231024WRESUT",2023-10-24,"England League Two","Wrexham","Sutton",2,1,"H",15,12,5,1,10,6,10,2,3,0,0,0,0,0,0,3,27,6,16,12,3,0
"20231028ACCCOL",2023-10-28,"England League Two","Accrington","Colchester",0,1,"A",31,7,6,6,9,12,11,0,1,3,0,0,0,0,0,1,38,12,21,11,4,0
"20231028BARSAL",2023-10-28,"England League Two","Barrow","Salford",0,0,"D",13,9,2,0,11,5,6,4,2,0,0,0,0,0,0,0,22,2,16,10,2,0
"20231028DONGRI",2023-10-28,"England League Two","Doncaster","Grimsby",1,0,"H",9,6,2,1,7,11,8,4,3,2,0,0,0,0,0,1,15,3,18,12,5,0
"20231028FORCRA",2023-10-28,"England League Two","Forest Green","Crawley Town",2,1,"H",8,13,5,6,16,4,4,7,4,0,0,0,0,0,0,3,21,11,20,11,4,0
"20231028GILNEW",2023-10-28,"England League Two","Gillingham","Newport County",0,2,"A",15,12,3,5,7,14,4,4,1,3,0,0,0,0,0,2,27,8,21,8,4,0
"20231028HARCRE",2023-10-28,"England League Two","Harrogate","Crewe",0,1,"A",12,15,3,4,13,11,6,6,3,0,0,0,0,0,0,1,27,7,24,12,3,0
"20231028MANWAL",2023-10-28,"England League Two","Mansfield","Walsall",2,1,"H",22,7,7,1,12,11,6,5,3,2,0,0,0,0,0,3,29,8,23,11,5,0
"20231028MILSWI",2023-10-28,"England League Two","Milton Keynes Dons","Swindon",3,2,"H",10,7,6,3,13,11,3,0,3,4,0,0,0,0,0,5,17,9,24,3,7,0
"20231028MORAFC",2023-10-28,"England League Two","Morecambe","AFC Wimbledon",4,1,"H",11,22,6,5,7,13,2,8,2,1,0,0,0,0,0,5,33,11,20,10,3,0
"20231028NOTWRE",2023-10-28,"England League Two","Notts County","Wrexham",0,2,"A",16,15,6,8,6,15,10,7,2,3,0,0,0,0,0,2,31,14,21,17,5,0
"20231028STOTRA",2023-10-28,"England League Two","Stockport","Tranmere",2,0,"H",26,9,7,4,5,7,13,3,0,1,0,1,0,0,0,2,35,11,12,16,1,1
"20231028SUTBRA",2023-10-28,"England League Two","Sutton","Bradford",2,1,"H",11,10,2,1,13,13,6,8,2,1,0,0,0,0,0,3,21,3,26,14,3,0
"20231031BARMOR",2023-10-31,"England League Two","Barrow","Morecambe",1,0,"H",7,3,3,0,7,15,4,2,1,1,0,0,0,0,0,1,10,3,22,6,2,0
"20231107COLSWI",2023-11-07,"England League Two","Colchester","Swindon",3,1,"H",12,13,2,3,3,16,4,4,1,2,0,0,0,0,0,4,25,5,19,8,3,0
"20231111AFCDON",2023-11-11,"England League Two","AFC Wimbledon","Doncaster",2,0,"H",5,8,2,1,17,6,8,3,3,2,2,0,0,0,0,2,13,3,23,11,5,2
"20231111BRABAR",2023-11-11,"England League Two","Bradford","Barrow",1,2,"A",9,7,5,4,10,6,5,4,2,2,0,0,0,0,0,3,16,9,16,9,4,0
"20231111COLSUT",2023-11-11,"England League Two","Colchester","Sutton",1,1,"D",11,13,4,3,14,9,6,3,3,4,0,0,0,0,0,2,24,7,23,9,7,0
"20231111CRAACC",2023-11-11,"England League Two","Crawley Town","Accrington",3,1,"H",9,14,4,6,14,19,1,8,2,4,0,1,0,0,0,4,23,10,33,9,6,1
"20231111CRENOT",2023-11-11,"England League Two","Crewe","Notts County",1,0,"H",15,12,4,2,16,15,3,7,2,5,0,0,0,0,0,1,27,6,31,10,7,0
"20231111GRIMOR",2023-11-11,"England League Two","Grimsby","Morecambe",3,2,"H",20,16,10,6,9,9,9,6,3,1,0,0,0,0,0,5,36,16,18,15,4,0
"20231111NEWMIL",2023-11-11,"England League Two","Newport County","Milton Keynes Dons",0,0,"D",16,11,1,5,14,11,2,4,2,2,0,0,0,0,0,0,27,6,25,6,4,0
"20231111SALMAN",2023-11-11,"England League Two","Salford","Mansfield",1,2,"A",18,9,7,5,10,13,7,4,1,2,0,0,0,0,0,3,27,12,23,11,3,0
"20231111SWISTO",2023-11-11,"England League Two","Swindon","Stockport",2,4,"A",13,16,4,8,9,10,8,4,2,2,0,0,0,0,0,6,29,12,19,12,4,0
"20231111TRAFOR",2023-11-11,"England League Two","Tranmere","Forest Green",3,0,"H",16,15,7,8,8,11,12,11,1,2,0,1,0,0,0,3,31,15,19,23,3,1
"20231111WALHAR",2023-11-11,"England League Two","Walsall","Harrogate",0,1,"A",25,7,3,2,8,9,11,6,0,2,0,0,0,0,0,1,32,5,17,17,2,0
"20231111WREGIL",2023-11-11,"England League Two","Wrexham","Gillingham",2,0,"H",15,8,5,2,13,7,5,5,0,0,0,0,0,0,0,2,23,7,20,10,0,0
"20231118NOTBRA",2023-11-18,"England League Two","Notts County","Bradford",4,2,"H",15,24,8,6,3,12,6,4,3,0,0,0,0,0,0,6,39,14,15,10,3,0
"20231118ACCWRE",2023-11-18,"England League Two","Accrington","Wrexham",2,0,"H",14,10,6,4,20,12,7,6,1,0,0,0,0,0,0,2,24,10,32,13,1,0
"20231118BARCRA",2023-11-18,"England League Two","Barrow","Crawley Town",1,0,"H",11,10,3,2,8,13,4,5,2,3,0,0,0,0,0,1,21,5,21,9,5,0
"20231118FORGRI",2023-11-18,"England League Two","Forest Green","Grimsby",2,2,"D",15,16,5,5,8,5,6,7,1,2,0,0,0,0,0,4,31,10,13,13,3,0
"20231118GILSAL",2023-11-18,"England League Two","Gillingham","Salford",3,1,"H",10,15,5,4,7,7,3,2,2,1,0,0,0,0,0,4,25,9,14,5,3,0
"20231118HARSWI",2023-11-18,"England League Two","Harrogate","Swindon",1,1,"D",12,15,5,3,4,13,5,10,1,2,0,0,0,0,0,2,27,8,17,15,3,0
"20231118MANNEW",2023-11-18,"England League Two","Mansfield","Newport County",2,0,"H",19,14,8,2,7,18,5,8,0,4,0,0,0,0,0,2,33,10,25,13,4,0
"20231118STOCOL",2023-11-18,"England League Two","Stockport","Colchester",2,0,"H",13,12,4,5,18,9,6,1,3,1,0,0,0,0,0,2,25,9,27,7,4,0
"20231118SUTTRA",2023-11-18,"England League Two","Sutton","Tranmere",1,1,"D",13,10,2,3,9,8,4,2,2,1,0,0,0,0,0,2,23,5,17,6,3,0
"20231125AFCNOT",2023-11-25,"England League Two","AFC Wimbledon","Notts County",4,2,"H",13,10,8,5,20,8,2,6,2,1,0,0,0,0,0,6,23,13,28,8,3,0
"20231125BRAACC",2023-11-25,"England League Two","Bradford","Accrington",1,0,"H",12,12,2,3,15,16,5,3,3,4,0,0,0,0,0,1,24,5,31,8,7,0
"20231125COLBAR",2023-11-25,"England League Two","Colchester","Barrow",1,4,"A",12,16,8,6,8,8,6,5,2,3,1,0,0,0,0,5,28,14,16,11,5,1
"20231125CRAHAR",2023-11-25,"England League Two","Crawley Town","Harrogate",2,1,"H",13,15,6,3,8,14,5,8,3,3,0,0,0,0,0,3,28,9,22,13,6,0
"20231125CREDON",2023-11-25,"England League Two","Crewe","Doncaster",3,2,"H",19,22,9,6,10,14,8,8,1,2,0,0,0,0,0,5,41,15,24,16,3,0
"20231125GRISUT",2023-11-25,"England League Two","Grimsby","Sutton",1,1,"D",13,13,4,2,9,5,8,4,0,0,0,0,0,0,0,2,26,6,14,12,0,0
"20231125NEWSTO",2023-11-25,"England League Two","Newport County","Stockport",2,1,"H",6,13,2,4,12,13,2,8,0,1,0,0,0,0,0,3,19,6,25,10,1,0
"20231125SALMIL",2023-11-25,"England League Two","Salford","Milton Keynes Dons",2,4,"A",9,16,4,5,15,12,2,2,2,2,0,0,0,0,0,6,25,9,27,4,4,0
"20231125SWIMAN",2023-11-25,"England League Two","Swindon","Mansfield",2,1,"H",20,15,6,6,10,12,3,2,1,1,0,0,1,0,1,3,35,12,22,5,2,0
"20231125TRAGIL",2023-11-25,"England League Two","Tranmere","Gillingham",3,1,"H",8,11,3,5,8,7,0,10,3,2,0,0,0,0,0,4,19,8,15,10,5,0
"20231125WALFOR",2023-11-25,"England League Two","Walsall","Forest Green",0,0,"D",11,8,2,1,10,14,6,4,2,3,0,0,0,0,0,0,19,3,24,10,5,0
"20231125WREMOR",2023-11-25,"England League Two","Wrexham","Morecambe",6,0,"H",19,14,8,2,11,10,5,7,1,1,0,0,0,0,0,6,33,10,21,12,2,0
"20231128ACCSWI",2023-11-28,"England League Two","Accrington","Swindon",3,4,"A",29,12,8,5,15,9,11,3,6,2,0,0,1,0,1,7,41,13,24,14,8,0
"20231128BARWAL",2023-11-28,"England League Two","Barrow","Walsall",2,0,"H",11,11,4,4,15,15,7,3,1,2,0,0,0,0,0,2,22,8,30,10,3,0
"20231128DONCOL",2023-11-28,"England League Two","Doncaster","Colchester",3,1,"H",15,14,5,7,7,14,8,4,2,4,0,0,0,0,0,4,29,12,21,12,6,0
"20231128FORBRA",2023-11-28,"England League Two","Forest Green","Bradford",0,3,"A",13,13,2,4,7,7,8,4,2,1,0,1,0,0,0,3,26,6,14,12,3,1
"20231128GILAFC",2023-11-28,"England League Two","Gillingham","AFC Wimbledon",1,0,"H",8,9,4,3,8,9,3,4,0,1,0,0,0,0,0,1,17,7,17,7,1,0
"20231128HARWRE",2023-11-28,"England League Two","Harrogate","Wrexham",2,2,"D",10,22,4,7,6,11,4,7,2,2,0,0,0,0,0,4,32,11,17,11,4,0
"20231128MANTRA",2023-11-28,"England League Two","Mansfield","Tranmere",2,2,"D",21,15,5,7,9,16,5,1,2,2,0,1,0,0,0,4,36,12,25,6,4,1
"20231128MILGRI",2023-11-28,"England League Two","Milton Keynes Dons","Grimsby",1,1,"D",13,19,3,6,10,12,5,10,1,3,0,0,0,0,0,2,32,9,22,15,4,0
"20231128MORNEW",2023-11-28,"England League Two","Morecambe","Newport County",1,2,"A",12,15,3,3,11,6,8,7,1,1,0,0,0,0,0,3,27,6,17,15,2,0
"20231128NOTCRA",2023-11-28,"England League Two","Notts County","Crawley Town",3,1,"H",14,18,5,6,7,13,3,6,1,3,0,0,0,0,0,4,32,11,20,9,4,0
"20231128STOSAL",2023-11-28,"England League Two","Stockport","Salford",0,0,"D",19,9,5,2,13,5,7,3,2,2,0,0,0,0,0,0,28,7,18,10,4,0
"20231128SUTCRE",2023-11-28,"England League Two","Sutton","Crewe",1,1,"D",9,22,3,4,14,10,3,9,2,1,0,0,0,0,0,2,31,7,24,12,3,0
"20231209ACCDON",2023-12-09,"England League Two","Accrington","Doncaster",0,0,"D",12,4,3,0,8,16,5,3,2,0,0,0,0,0,0,0,16,3,24,8,2,0
"20231209AFCSWI",2023-12-09,"England League Two","AFC Wimbledon","Swindon",4,0,"H",16,10,9,1,11,10,7,3,2,1,0,0,0,0,0,4,26,10,21,10,3,0
"20231209COLCRA",2023-12-09,"England League Two","Colchester","Crawley Town",1,2,"A",11,12,2,4,10,9,4,5,3,2,0,0,0,0,0,3,23,6,19,9,5,0
"20231209GRICRE",2023-12-09,"England League Two","Grimsby","Crewe",2,1,"H",17,11,3,2,10,11,6,5,1,3,0,0,0,0,0,3,28,5,21,11,4,0
"20231209MORSTO",2023-12-09,"England League Two","Morecambe","Stockport",1,1,"D",4,11,3,5,6,5,3,5,1,0,0,0,0,0,0,2,15,8,11,8,1,0
"20231209NOTWAL",2023-12-09,"England League Two","Notts County","Walsall",1,2,"A",6,7,2,4,9,11,6,4,2,2,0,0,0,0,0,3,13,6,20,10,4,0
"20231209TRANEW",2023-12-09,"England League Two","Tranmere","Newport County",2,1,"H",14,10,3,3,12,11,8,2,3,3,0,0,0,0,0,3,24,6,23,10,6,0
"20231216CRAMAN",2023-12-16,"England League Two","Crawley Town","Mansfield",1,3,"A",11,14,2,6,12,14,2,3,4,3,1,0,0,0,0,4,25,8,26,5,7,1
"20231216CREACC",2023-12-16,"England League Two","Crewe","Accrington",3,3,"D",13,19,3,8,10,10,6,3,2,1,1,0,0,0,0,6,32,11,20,9,3,1
"20231216DONMOR",2023-12-16,"England League Two","Doncaster","Morecambe",0,5,"A",12,15,3,9,10,10,6,6,2,3,0,0,0,0,0,5,27,12,20,12,5,0
"20231216GILBRA",2023-12-16,"England League Two","Gillingham","Bradford",0,2,"A",7,12,1,2,11,19,6,2,3,5,0,0,0,0,0,2,19,3,30,8,8,0
"20231216HARNOT",2023-12-16,"England League Two","Harrogate","Notts County",3,1,"H",14,10,5,3,8,10,2,4,2,3,0,0,0,0,0,4,24,8,18,6,5,0
"20231216MILFOR",2023-12-16,"England League Two","Milton Keynes Dons","Forest Green",2,0,"H",14,8,6,0,11,18,4,4,4,4,0,0,0,0,0,2,22,6,29,8,8,0
"20231216NEWGRI",2023-12-16,"England League Two","Newport County","Grimsby",1,1,"D",19,19,3,5,8,6,10,2,1,0,0,0,0,0,0,2,38,8,14,12,1,0
"20231216SALAFC",2023-12-16,"England League Two","Salford","AFC Wimbledon",0,0,"D",8,20,3,2,9,14,1,11,2,1,0,0,0,0,0,0,28,5,23,12,3,0
"20231216STOSUT",2023-12-16,"England League Two","Stockport","Sutton",8,0,"H",18,7,11,1,12,10,5,1,0,1,0,0,0,0,0,8,25,12,22,6,1,0
"20231216SWIBAR",2023-12-16,"England League Two","Swindon","Barrow",0,3,"A",4,8,1,3,12,14,7,5,1,1,0,0,0,0,0,3,12,4,26,12,2,0
"20231216WALTRA",2023-12-16,"England League Two","Walsall","Tranmere",1,0,"H",13,17,4,6,14,9,4,1,4,1,0,0,0,0,0,1,30,10,23,5,5,0
"20231216WRECOL",2023-12-16,"England League Two","Wrexham","Colchester",2,1,"H",11,18,5,4,8,7,4,7,3,2,1,0,0,0,0,3,29,9,15,11,5,1
"20231222FORGIL",2023-12-22,"England League Two","Forest Green","Gillingham",0,0,"D",11,11,4,3,11,9,3,8,2,1,0,0,0,0,0,0,22,7,20,11,3,0
"20231222COLSAL",2023-12-22,"England League Two","Colchester","Salford",2,1,"H",11,11,5,4,11,10,9,7,5,1,0,0,0,0,0,3,22,9,21,16,6,0
"20231222CRAAFC",2023-12-22,"England League Two","Crawley Town","AFC Wimbledon",1,2,"A",18,12,7,2,11,11,6,5,2,3,0,1,0,0,0,3,30,9,22,11,5,1
"20231222CREBAR",2023-12-22,"England League Two","Crewe","Barrow",1,3,"A",7,11,3,6,12,10,5,2,4,4,0,0,0,0,0,4,18,9,22,7,8,0
"20231222DONBRA",2023-12-22,"England League Two","Doncaster","Bradford",1,3,"A",7,13,2,5,9,13,9,4,1,1,0,0,0,0,0,4,20,7,22,13,2,0
"20231222STONOT",2023-12-22,"England League Two","Stockport","Notts County",2,1,"H",9,12,5,3,14,6,4,3,4,2,0,0,0,0,0,3,21,8,20,7,6,0
"20231223ACCWAL",2023-12-23,"England League Two","Accrington","Walsall",2,1,"H",13,13,6,1,11,6,9,7,1,0,0,0,0,0,0,3,26,7,17,16,1,0
"20231223GRIHAR",2023-12-23,"England League Two","Grimsby","Harrogate",1,2,"A",14,14,1,5,11,7,9,6,1,1,0,0,0,0,0,3,28,6,18,15,2,0
"20231223MORMIL",2023-12-23,"England League Two","Morecambe","Milton Keynes Dons",1,3,"A",9,20,4,7,12,12,4,5,3,1,0,0,0,0,0,4,29,11,24,9,4,0
"20231223SUTMAN",2023-12-23,"England League Two","Sutton","Mansfield",0,2,"A",7,17,1,5,10,10,2,5,1,1,0,0,0,0,0,2,24,6,20,7,2,0
"20231223TRASWI",2023-12-23,"England League Two","Tranmere","Swindon",2,1,"H",18,8,9,5,11,10,6,3,2,3,0,0,0,0,0,3,26,14,21,9,5,0
"20231223WRENEW",2023-12-23,"England League Two","Wrexham","Newport County",2,0,"H",16,9,5,2,9,9,7,5,0,1,0,0,0,0,0,2,25,7,18,12,1,0
"20231226MANGRI",2023-12-26,"England League Two","Mansfield","Grimsby",2,0,"H",39,13,16,5,17,10,15,2,3,1,0,0,0,0,0,2,52,21,27,17,4,0
"20231226GILCRA",2023-12-26,"England League Two","Gillingham","Crawley Town",0,2,"A",16,8,5,3,10,15,8,1,2,5,0,0,0,0,0,2,24,8,25,9,7,0
"20231226AFCSUT",2023-12-26,"England League Two","AFC Wimbledon","Sutton",0,1,"A",11,12,5,6,13,11,2,6,3,3,0,0,0,0,0,1,23,11,24,8,6,0
"20231226BARSTO",2023-12-26,"England League Two","Barrow","Stockport",2,2,"D",13,17,5,5,17,14,3,6,2,4,0,0,0,0,0,4,30,10,31,9,6,0
"20231226BRAMOR",2023-12-26,"England League Two","Bradford","Morecambe",2,2,"D",17,7,6,2,7,9,5,5,2,3,0,0,0,0,0,4,24,8,16,10,5,0
"20231226HARACC",2023-12-26,"England League Two","Harrogate","Accrington",2,1,"H",13,14,5,6,7,11,4,11,0,0,0,0,0,0,0,3,27,11,18,15,0,0
"20231226MILCOL",2023-12-26,"England League Two","Milton Keynes Dons","Colchester",1,0,"H",27,7,4,3,12,8,11,1,3,1,0,0,0,0,0,1,34,7,20,12,4,0
"20231226NEWFOR",2023-12-26,"England League Two","Newport County","Forest Green",4,2,"H",13,12,8,4,10,22,7,7,3,4,0,1,0,0,0,6,25,12,32,14,7,1
"20231226NOTDON",2023-12-26,"England League Two","Notts County","Doncaster",3,0,"H",20,13,10,4,6,11,13,3,0,2,0,0,0,0,0,3,33,14,17,16,2,0
"20231226SALTRA",2023-12-26,"England League Two","Salford","Tranmere",1,5,"A",10,19,5,9,7,11,4,3,3,1,1,0,0,0,0,6,29,14,18,7,4,1
"20231226SWIWRE",2023-12-26,"England League Two","Swindon","Wrexham",0,1,"A",16,15,3,4,8,10,8,5,1,0,0,1,1,0,1,1,31,7,18,13,1,1
"20231226WALCRE",2023-12-26,"England League Two","Walsall","Crewe",2,0,"H",15,15,5,4,9,11,5,4,1,5,0,0,0,0,0,2,30,9,20,9,6,0
"20231229AFCCOL",2023-12-29,"England League Two","AFC Wimbledon","Colchester",5,3,"H",31,14,13,4,16,7,5,2,3,1,0,1,0,0,0,8,45,17,23,7,4,1
"20231229BARACC",2023-12-29,"England League Two","Barrow","Accrington",1,1,"D",18,11,5,3,12,12,8,3,0,6,0,0,0,0,0,2,29,8,24,11,6,0
"20231229BRASTO",2023-12-29,"England League Two","Bradford","Stockport",0,0,"D",8,10,1,1,16,7,6,3,2,2,0,0,0,0,0,0,18,2,23,9,4,0
"20231229GILSUT",2023-12-29,"England League Two","Gillingham","Sutton",1,0,"H",24,4,4,2,6,10,12,0,1,3,0,1,0,0,0,1,28,6,16,12,4,1
"20231229HARTRA",2023-12-29,"England League Two","Harrogate","Tranmere",0,2,"A",12,10,2,4,5,9,7,6,1,2,0,0,0,0,0,2,22,6,14,13,3,0
"20231229MANDON",2023-12-29,"England League Two","Mansfield","Doncaster",1,1,"D",12,12,6,4,9,13,7,4,1,1,0,0,0,0,0,2,24,10,22,11,2,0
"20231229MILCRA",2023-12-29,"England League Two","Milton Keynes Dons","Crawley Town",2,0,"H",13,10,8,3,7,9,6,2,3,0,0,1,0,0,0,2,23,11,16,8,3,1
"20231229NEWCRE",2023-12-29,"England League Two","Newport County","Crewe",1,1,"D",19,22,3,4,10,6,7,5,0,1,0,0,0,0,0,2,41,7,16,12,1,0
"20231229NOTMOR",2023-12-29,"England League Two","Notts County","Morecambe",5,0,"H",13,6,7,2,7,8,4,2,1,2,0,0,0,0,0,5,19,9,15,6,3,0
"20231229SALGRI",2023-12-29,"England League Two","Salford","Grimsby",0,3,"A",10,22,2,5,10,8,5,12,0,1,0,0,0,0,0,3,32,7,18,17,1,0
"20231229SWIFOR",2023-12-29,"England League Two","Swindon","Forest Green",2,1,"H",15,19,5,7,11,20,6,4,3,5,0,0,1,0,1,3,34,12,31,10,8,0
"20231229WALWRE",2023-12-29,"England League Two","Walsall","Wrexham",3,1,"H",22,16,8,5,7,9,2,4,3,1,0,0,0,0,0,4,38,13,16,6,4,0
"20240101ACCSAL",2024-01-01,"England League Two","Accrington","Salford",3,0,"H",17,12,6,5,13,9,5,3,4,2,0,0,0,0,0,3,29,11,22,8,6,0
"20240101COLGIL",2024-01-01,"England League Two","Colchester","Gillingham",0,1,"A",15,15,4,7,9,7,0,6,1,3,0,0,0,0,0,1,30,11,16,6,4,0
"20240101CRASWI",2024-01-01,"England League Two","Crawley Town","Swindon",3,1,"H",11,14,3,8,15,12,3,9,0,0,0,0,0,0,0,4,25,11,27,12,0,0
"20240101CREBRA",2024-01-01,"England League Two","Crewe","Bradford",1,0,"H",4,16,1,4,12,18,1,8,5,2,0,0,0,0,0,1,20,5,30,9,7,0
"20240101DONMIL",2024-01-01,"England League Two","Doncaster","Milton Keynes Dons",3,0,"H",20,12,6,3,17,13,6,5,2,4,0,0,0,0,0,3,32,9,30,11,6,0
"20240101FORAFC",2024-01-01,"England League Two","Forest Green","AFC Wimbledon",1,1,"D",16,14,4,4,10,7,7,9,1,2,0,0,1,1,0,2,30,8,17,16,3,0
"20240101GRIWAL",2024-01-01,"England League Two","Grimsby","Walsall",1,6,"A",8,18,3,7,12,14,9,7,0,1,0,0,0,0,0,7,26,10,26,16,1,0
"20240101MORHAR",2024-01-01,"England League Two","Morecambe","Harrogate",2,2,"D",17,11,6,5,6,8,7,4,3,2,0,0,0,0,0,4,28,11,14,11,5,0
"20240101STOMAN",2024-01-01,"England League Two","Stockport","Mansfield",0,2,"A",11,8,4,3,10,8,3,6,1,3,0,0,0,0,0,2,19,7,18,9,4,0
"20240101SUTNEW",2024-01-01,"England League Two","Sutton","Newport County",1,1,"D",13,11,4,2,8,5,3,7,1,0,0,0,0,0,0,2,24,6,13,10,1,0
"20240101TRANOT",2024-01-01,"England League Two","Tranmere","Notts County",4,2,"H",14,12,7,7,10,5,7,7,1,1,0,0,0,0,0,6,26,14,15,14,2,0
"20240101WREBAR",2024-01-01,"England League Two","Wrexham","Barrow",4,1,"H",16,7,10,3,12,14,3,0,1,4,0,0,0,0,0,5,23,13,26,3,5,0
"20240106HARDON",2024-01-06,"England League Two","Harrogate","Doncaster",3,1,"H",11,17,4,2,8,11,3,4,0,3,0,0,0,0,0,4,28,6,19,7,3,0
"20240106BARTRA",2024-01-06,"England League Two","Barrow","Tranmere",1,0,"H",15,6,2,1,10,11,4,5,1,1,0,0,0,0,0,1,21,3,21,9,2,0
"20240106BRACRA",2024-01-06,"England League Two","Bradford","Crawley Town",2,4,"A",20,13,8,6,6,11,10,3,1,2,0,0,0,0,0,6,33,14,17,13,3,0
"20240106MANCRE",2024-01-06,"England League Two","Mansfield","Crewe",0,1,"A",21,12,3,3,7,8,12,5,2,2,0,0,0,0,0,1,33,6,15,17,4,0
"20240106SALFOR",2024-01-06,"England League Two","Salford","Forest Green",2,2,"D",12,13,5,3,9,14,8,4,2,2,1,1,0,0,0,4,25,8,23,12,4,2
"20240106SWICOL",2024-01-06,"England League Two","Swindon","Colchester",2,2,"D",9,17,4,6,8,9,5,2,1,2,0,0,0,0,0,4,26,10,17,7,3,0
"20240113ACCGIL",2024-01-13,"England League Two","Accrington","Gillingham",1,2,"A",14,11,5,3,9,12,5,7,2,2,0,0,0,0,0,3,25,8,21,12,4,0
"20240113COLBRA",2024-01-13,"England League Two","Colchester","Bradford",1,1,"D",6,22,3,3,5,11,2,8,0,0,0,0,0,0,0,2,28,6,16,10,0,0
"20240113CRASAL",2024-01-13,"England League Two","Crawley Town","Salford",0,1,"A",10,35,1,12,8,15,2,10,1,3,0,0,0,0,0,1,45,13,23,12,4,0
"20240113CRESWI",2024-01-13,"England League Two","Crewe","Swindon",2,1,"H",11,11,5,3,7,9,3,8,3,3,0,0,0,0,0,3,22,8,16,11,6,0
"20240113DONNEW",2024-01-13,"England League Two","Doncaster","Newport County",0,1,"A",13,5,5,1,12,16,2,4,1,2,0,0,0,0,0,1,18,6,28,6,3,0
"20240113FORHAR",2024-01-13,"England League Two","Forest Green","Harrogate",0,2,"A",4,17,1,5,19,6,3,8,2,2,1,0,0,0,0,2,21,6,25,11,4,1
"20240113GRINOT",2024-01-13,"England League Two","Grimsby","Notts County",5,5,"D",22,19,9,9,10,9,9,2,1,3,0,0,0,0,0,10,41,18,19,11,4,0
"20240113MORMAN",2024-01-13,"England League Two","Morecambe","Mansfield",1,1,"D",9,6,3,3,9,9,3,5,3,1,0,0,0,0,0,2,15,6,18,8,4,0
"20240113STOWAL",2024-01-13,"England League Two","Stockport","Walsall",3,1,"H",15,7,6,3,10,10,8,6,1,1,0,0,0,0,0,4,22,9,20,14,2,0
"20240113SUTBAR",2024-01-13,"England League Two","Sutton","Barrow",2,2,"D",9,16,4,5,8,7,5,5,1,0,0,0,0,0,0,4,25,9,15,10,1,0
"20240113TRAMIL",2024-01-13,"England League Two","Tranmere","Milton Keynes Dons",1,2,"A",5,24,2,6,7,9,2,6,1,0,0,0,0,0,0,3,29,8,16,8,1,0
"20240113WREAFC",2024-01-13,"England League Two","Wrexham","AFC Wimbledon",2,0,"H",10,17,5,1,11,13,5,5,1,1,0,0,0,0,0,2,27,6,24,10,2,0
"20240120BARCRE",2024-01-20,"England League Two","Barrow","Crewe",1,3,"A",13,13,5,6,7,10,5,0,1,6,0,0,0,0,0,4,26,11,17,5,7,0
"20240120GILFOR",2024-01-20,"England League Two","Gillingham","Forest Green",1,1,"D",13,11,3,5,6,11,6,0,4,2,0,0,0,0,0,2,24,8,17,6,6,0
"20240120MILMOR",2024-01-20,"England League Two","Milton Keynes Dons","Morecambe",1,2,"A",22,7,6,3,10,10,8,6,2,3,0,0,0,0,0,3,29,9,20,14,5,0
"20240120NEWWRE",2024-01-20,"England League Two","Newport County","Wrexham",1,0,"H",16,4,5,1,13,12,5,2,6,3,0,1,0,0,0,1,20,6,25,7,9,1
"20240123BRASAL",2024-01-23,"England League Two","Bradford","Salford",1,1,"D",7,12,4,4,7,14,3,3,0,1,0,0,0,0,0,2,19,8,21,6,1,0
"20240123MANSUT",2024-01-23,"England League Two","Mansfield","Sutton",1,1,"D",17,2,2,1,8,13,13,8,2,1,0,0,0,0,0,2,19,3,21,21,3,0
"20240123MILAFC",2024-01-23,"England League Two","Milton Keynes Dons","AFC Wimbledon",3,1,"H",18,8,12,2,11,17,3,3,1,1,0,2,0,0,0,4,26,14,28,6,2,2
"20240127AFCMAN",2024-01-27,"England League Two","AFC Wimbledon","Mansfield",2,1,"H",19,5,5,1,16,10,6,2,4,4,0,2,0,0,0,3,24,6,26,8,8,2
"20240127CRESAL",2024-01-27,"England League Two","Crewe","Salford",2,3,"A",11,18,3,6,10,16,2,5,1,4,0,0,0,0,0,5,29,9,26,7,5,0
"20240127DONSTO",2024-01-27,"England League Two","Doncaster","Stockport",1,5,"A",7,14,1,7,17,11,2,10,2,1,0,0,0,0,0,6,21,8,28,12,3,0
"20240127FORACC",2024-01-27,"England League Two","Forest Green","Accrington",0,1,"A",12,9,2,4,6,17,6,1,1,5,0,0,0,0,0,1,21,6,23,7,6,0
"20240127GRITRA",2024-01-27,"England League Two","Grimsby","Tranmere",1,2,"A",12,5,3,2,12,10,6,2,1,2,0,0,0,0,0,3,17,5,22,8,3,0
"20240127MILGIL",2024-01-27,"England League Two","Milton Keynes Dons","Gillingham",2,1,"H",11,14,7,6,10,8,5,4,1,0,0,0,0,0,0,3,25,13,18,9,1,0
"20240127MORCOL",2024-01-27,"England League Two","Morecambe","Colchester",0,1,"A",8,16,1,3,7,11,3,9,3,2,0,0,0,0,0,1,24,4,18,12,5,0
"20240127NOTBAR",2024-01-27,"England League Two","Notts County","Barrow",1,1,"D",9,11,1,3,9,11,6,8,1,4,0,0,0,0,0,2,20,4,20,14,5,0
"20240127SWIBRA",2024-01-27,"England League Two","Swindon","Bradford",2,0,"H",5,11,2,3,10,17,3,4,2,2,0,0,0,0,0,2,16,5,27,7,4,0
"20240127WALSUT",2024-01-27,"England League Two","Walsall","Sutton",1,1,"D",10,10,5,2,10,15,4,4,5,3,0,0,0,0,0,2,20,7,25,8,8,0
"20240130SUTHAR",2024-01-30,"England League Two","Sutton","Harrogate",1,2,"A",18,10,3,3,11,5,10,4,1,3,0,0,0,0,0,3,28,6,16,14,4,0
"20240203NEWSWI",2024-02-03,"England League Two","Newport County","Swindon",2,1,"H",11,16,4,3,11,13,3,7,2,4,0,0,1,0,1,3,27,7,24,10,6,0
"20240203ACCGRI",2024-02-03,"England League Two","Accrington","Grimsby",0,0,"D",5,16,3,3,13,6,6,9,1,1,0,0,0,0,0,0,21,6,19,15,2,0
"20240203BARMIL",2024-02-03,"England League Two","Barrow","Milton Keynes Dons",1,0,"H",15,8,6,4,10,14,6,8,3,2,0,0,0,0,0,1,23,10,24,14,5,0
"20240203BRAAFC",2024-02-03,"England League Two","Bradford","AFC Wimbledon",0,0,"D",11,6,3,1,11,17,4,3,3,4,0,0,0,0,0,0,17,4,28,7,7,0
"20240203COLFOR",2024-02-03,"England League Two","Colchester","Forest Green",3,3,"D",20,11,5,3,14,10,5,5,1,1,0,0,0,0,0,6,31,8,24,10,2,0
"20240203CRAMOR",2024-02-03,"England League Two","Crawley Town","Morecambe",1,2,"A",7,11,3,7,8,13,2,3,2,2,0,0,0,0,0,3,18,10,21,5,4,0
"20240203GILWAL",2024-02-03,"England League Two","Gillingham","Walsall",1,1,"D",14,18,3,3,12,15,5,4,3,2,0,0,0,0,0,2,32,6,27,9,5,0
"20240203MANNOT",2024-02-03,"England League Two","Mansfield","Notts County",1,0,"H",13,13,7,1,16,6,3,8,4,0,0,0,0,0,0,1,26,8,22,11,4,0
"20240203SALWRE",2024-02-03,"England League Two","Salford","Wrexham",3,1,"H",18,6,9,1,15,16,9,3,4,3,0,0,1,0,1,4,24,10,31,12,7,0
"20240203STOHAR",2024-02-03,"England League Two","Stockport","Harrogate",1,1,"D",20,4,5,2,12,8,8,1,3,1,0,0,0,0,0,2,24,7,20,9,4,0
"20240203SUTDON",2024-02-03,"England League Two","Sutton","Doncaster",1,1,"D",14,9,5,1,13,21,1,4,2,3,0,0,0,0,0,2,23,6,34,5,5,0
"20240203TRACRE",2024-02-03,"England League Two","Tranmere","Crewe",0,0,"D",9,10,0,1,9,17,7,6,1,4,0,0,0,0,0,0,19,1,26,13,5,0
"20240209NOTGIL",2024-02-09,"England League Two","Notts County","Gillingham",1,3,"A",11,11,4,4,9,13,4,4,2,1,0,0,0,0,0,4,22,8,22,8,3,0
"20240210AFCBAR",2024-02-10,"England League Two","AFC Wimbledon","Barrow",2,0,"H",10,10,3,3,23,7,7,6,3,2,0,1,0,0,0,2,20,6,30,13,5,1
"20240210CRECRA",2024-02-10,"England League Two","Crewe","Crawley Town",1,0,"H",10,8,1,2,11,14,7,5,4,2,0,0,0,0,0,1,18,3,25,12,6,0
"20240210DONTRA",2024-02-10,"England League Two","Doncaster","Tranmere",2,1,"H",4,11,3,3,13,7,2,10,1,3,0,0,0,0,0,3,15,6,20,12,4,0
"20240210FORMAN",2024-02-10,"England League Two","Forest Green","Mansfield",0,4,"A",19,13,5,8,5,9,10,7,2,0,0,0,0,0,0,4,32,13,14,17,2,0
"20240210GRISTO",2024-02-10,"England League Two","Grimsby","Stockport",1,3,"A",9,9,2,4,10,16,7,7,4,3,0,0,0,0,0,4,18,6,26,14,7,0
"20240210HARCOL",2024-02-10,"England League Two","Harrogate","Colchester",1,0,"H",11,25,6,5,4,12,7,9,1,3,0,0,0,0,0,1,36,11,16,16,4,0
"20240210MILACC",2024-02-10,"England League Two","Milton Keynes Dons","Accrington",2,1,"H",13,7,7,1,7,22,5,3,1,6,0,0,0,0,0,3,20,8,29,8,7,0
"20240210MORSUT",2024-02-10,"England League Two","Morecambe","Sutton",1,0,"H",13,14,4,3,15,18,6,1,4,4,0,0,0,0,0,1,27,7,33,7,8,0
"20240210SWISAL",2024-02-10,"England League Two","Swindon","Salford",1,1,"D",25,13,7,4,10,7,10,7,3,0,0,0,0,0,0,2,38,11,17,17,3,0
"20240210WALNEW",2024-02-10,"England League Two","Walsall","Newport County",0,3,"A",15,10,2,5,17,10,7,0,0,0,1,0,0,0,0,3,25,7,27,7,0,1
"20240210WREBRA",2024-02-10,"England League Two","Wrexham","Bradford",0,1,"A",17,10,5,8,5,19,11,3,0,3,0,0,0,0,0,1,27,13,24,14,3,0
"20240213ACCAFC",2024-02-13,"England League Two","Accrington","AFC Wimbledon",2,0,"H",14,14,2,4,8,12,6,6,1,1,0,0,0,0,0,2,28,6,20,12,2,0
"20240213BARFOR",2024-02-13,"England League Two","Barrow","Forest Green",1,2,"A",9,10,1,6,14,10,6,1,1,3,0,0,0,0,0,3,19,7,24,7,4,0
"20240213BRAMIL",2024-02-13,"England League Two","Bradford","Milton Keynes Dons",4,0,"H",11,16,7,3,16,8,1,6,5,1,0,0,0,0,0,4,27,10,24,7,6,0
"20240213CRAWAL",2024-02-13,"England League Two","Crawley Town","Walsall",1,1,"D",15,11,3,4,13,12,7,8,3,3,0,0,0,0,0,2,26,7,25,15,6,0
"20240213GILSWI",2024-02-13,"England League Two","Gillingham","Swindon",2,2,"D",16,15,3,7,6,10,11,6,1,2,0,0,0,0,0,4,31,10,16,17,3,0
"20240213MANHAR",2024-02-13,"England League Two","Mansfield","Harrogate",9,2,"H",23,7,13,3,11,5,6,3,1,0,0,0,0,0,0,11,30,16,16,9,1,0
"20240213NEWNOT",2024-02-13,"England League Two","Newport County","Notts County",1,3,"A",11,13,3,8,5,11,9,6,0,0,0,0,0,0,0,4,24,11,16,15,0,0
"20240213SALDON",2024-02-13,"England League Two","Salford","Doncaster",2,2,"D",12,8,6,2,17,18,3,3,4,2,0,0,0,0,0,4,20,8,35,6,6,0
"20240213STOCRE",2024-02-13,"England League Two","Stockport","Crewe",1,3,"A",6,8,2,5,14,17,4,7,0,1,0,0,0,0,0,4,14,7,31,11,1,0
"20240213SUTWRE",2024-02-13,"England League Two","Sutton","Wrexham",1,2,"A",11,12,6,4,7,9,10,2,3,0,0,0,0,0,0,3,23,10,16,12,3,0
"20240213TRAMOR",2024-02-13,"England League Two","Tranmere","Morecambe",2,3,"A",10,18,5,6,12,13,0,10,5,2,0,0,0,0,0,5,28,11,25,10,7,0
"20240217AFCMOR",2024-02-17,"England League Two","AFC Wimbledon","Morecambe",1,1,"D",15,5,3,1,15,13,6,3,1,5,0,0,0,0,0,2,20,4,28,9,6,0
"20240217BRASUT",2024-02-17,"England League Two","Bradford","Sutton",1,0,"H",11,15,7,3,11,18,1,6,1,2,0,0,0,0,0,1,26,10,29,7,3,0
"20240217COLACC",2024-02-17,"England League Two","Colchester","Accrington",1,1,"D",17,8,5,1,16,10,6,4,3,1,0,1,0,0,0,2,25,6,26,10,4,1
"20240217CRAFOR",2024-02-17,"England League Two","Crawley Town","Forest Green",2,0,"H",18,10,6,4,9,7,3,3,0,1,0,0,0,0,0,2,28,10,16,6,1,0
"20240217CREHAR",2024-02-17,"England League Two","Crewe","Harrogate",0,0,"D",18,1,2,0,11,12,7,1,0,3,0,0,0,0,0,0,19,2,23,8,3,0
"20240217GRIDON",2024-02-17,"England League Two","Grimsby","Doncaster",1,5,"A",12,9,4,4,17,20,5,6,2,3,0,0,0,0,0,6,21,8,37,11,5,0
"20240217NEWGIL",2024-02-17,"England League Two","Newport County","Gillingham",1,0,"H",6,18,2,3,11,11,4,5,2,2,0,0,0,0,0,1,24,5,22,9,4,0
"20240217SALBAR",2024-02-17,"England League Two","Salford","Barrow",5,3,"H",29,14,12,8,15,10,8,6,3,1,0,0,0,0,0,8,43,20,25,14,4,0
"20240217SWIMIL",2024-02-17,"England League Two","Swindon","Milton Keynes Dons",1,2,"A",12,9,3,3,13,9,5,1,2,1,0,0,0,0,0,3,21,6,22,6,3,0
"20240217TRASTO",2024-02-17,"England League Two","Tranmere","Stockport",4,0,"H",16,11,9,3,8,9,7,6,1,2,0,0,0,0,0,4,27,12,17,13,3,0
"20240217WALMAN",2024-02-17,"England League Two","Walsall","Mansfield",2,1,"H",15,14,5,7,9,12,9,6,2,2,0,0,0,0,0,3,29,12,21,15,4,0
"20240217WRENOT",2024-02-17,"England League Two","Wrexham","Notts County",1,0,"H",16,11,4,3,8,7,7,8,1,2,0,0,0,0,0,1,27,7,15,15,3,0
"20240220AFCCRA",2024-02-20,"England League Two","AFC Wimbledon","Crawley Town",0,1,"A",14,15,6,4,10,6,11,5,1,0,0,0,0,0,0,1,29,10,16,16,1,0
"20240220GILSTO",2024-02-20,"England League Two","Gillingham","Stockport",0,0,"D",4,10,1,1,12,16,0,7,1,2,0,0,0,0,0,0,14,2,28,7,3,0
"20240220MILWRE",2024-02-20,"England League Two","Milton Keynes Dons","Wrexham",1,1,"D",11,18,5,5,5,12,5,6,3,1,1,1,0,0,0,2,29,10,17,11,4,2
"20240220WALMOR",2024-02-20,"England League Two","Walsall","Morecambe",3,0,"H",13,16,6,1,12,12,6,8,4,2,0,0,0,0,0,3,29,7,24,14,6,0
"20240224ACCCRA",2024-02-24,"England League Two","Accrington","Crawley Town",0,1,"A",23,9,10,4,8,11,6,5,2,2,0,0,0,0,0,1,32,14,19,11,4,0
"20240224DONAFC",2024-02-24,"England League Two","Doncaster","AFC Wimbledon",1,0,"H",14,4,3,1,5,18,8,2,0,3,0,0,0,0,0,1,18,4,23,10,3,0
"20240224FORTRA",2024-02-24,"England League Two","Forest Green","Tranmere",1,0,"H",4,20,3,4,9,10,1,9,1,2,0,1,0,0,0,1,24,7,19,10,3,1
"20240224GILWRE",2024-02-24,"England League Two","Gillingham","Wrexham",1,0,"H",14,16,5,3,10,8,7,11,0,2,0,0,0,0,0,1,30,8,18,18,2,0
"20240224HARWAL",2024-02-24,"England League Two","Harrogate","Walsall",0,2,"A",12,16,0,6,2,7,7,4,0,2,0,0,0,0,0,2,28,6,9,11,2,0
"20240224MANSAL",2024-02-24,"England League Two","Mansfield","Salford",5,1,"H",29,14,7,3,11,11,9,8,2,3,0,1,0,0,0,6,43,10,22,17,5,1
"20240224MILNEW",2024-02-24,"England League Two","Milton Keynes Dons","Newport County",3,0,"H",20,4,8,2,9,11,9,5,2,3,0,0,0,0,0,3,24,10,20,14,5,0
"20240224MORGRI",2024-02-24,"England League Two","Morecambe","Grimsby",1,1,"D",18,14,5,2,13,12,10,4,1,1,0,0,0,0,0,2,32,7,25,14,2,0
"20240224NOTCRE",2024-02-24,"England League Two","Notts County","Crewe",1,3,"A",14,9,6,3,11,7,9,4,4,4,0,0,0,0,0,4,23,9,18,13,8,0
"20240224STOSWI",2024-02-24,"England League Two","Stockport","Swindon",0,0,"D",20,8,8,2,10,12,10,4,0,2,0,0,0,0,0,0,28,10,22,14,2,0
"20240224SUTCOL",2024-02-24,"England League Two","Sutton","Colchester",1,1,"D",16,11,4,4,15,12,5,5,2,3,0,0,0,0,0,2,27,8,27,10,5,0
"20240227FORWRE",2024-02-27,"England League Two","Forest Green","Wrexham",1,1,"D",6,19,2,5,8,7,3,6,1,0,0,0,0,0,0,2,25,7,15,9,1,0
"20240227HARNEW",2024-02-27,"England League Two","Harrogate","Newport County",1,4,"A",7,16,1,6,7,15,1,8,1,0,0,0,0,0,0,5,23,7,22,9,1,0
"20240227NOTSUT",2024-02-27,"England League Two","Notts County","Sutton",3,4,"A",13,17,7,7,7,13,4,9,1,5,0,0,0,0,0,7,30,14,20,13,6,0
"20240227SALCOL",2024-02-27,"England League Two","Salford","Colchester",1,1,"D",11,16,5,7,12,15,2,4,4,2,0,0,0,0,0,2,27,12,27,6,6,0
"20240227SWITRA",2024-02-27,"England League Two","Swindon","Tranmere",3,1,"H",15,9,7,3,12,12,9,5,2,1,0,0,0,0,0,4,24,10,24,14,3,0
"20240227WALACC",2024-02-27,"England League Two","Walsall","Accrington",2,1,"H",26,9,5,2,6,17,7,5,2,2,0,0,0,0,0,3,35,7,23,12,4,0
"20240302AFCMIL",2024-03-02,"England League Two","AFC Wimbledon","Milton Keynes Dons",1,0,"H",10,10,2,3,21,8,6,5,6,6,0,0,0,0,0,1,20,5,29,11,12,0
"20240302CREMOR",2024-03-02,"England League Two","Crewe","Morecambe",2,3,"A",26,6,10,4,8,12,11,0,2,3,0,0,0,0,0,5,32,14,20,11,5,0
"20240302GRIFOR",2024-03-02,"England League Two","Grimsby","Forest Green",1,0,"H",7,7,1,0,9,11,7,7,1,1,0,0,0,0,0,1,14,1,20,14,2,0
"20240302NEWMAN",2024-03-02,"England League Two","Newport County","Mansfield",0,1,"A",6,16,0,6,8,7,4,5,2,0,0,0,0,0,0,1,22,6,15,9,2,0
"20240302SALGIL",2024-03-02,"England League Two","Salford","Gillingham",0,2,"A",15,10,4,4,12,8,9,6,3,1,0,0,0,0,0,2,25,8,20,15,4,0
"20240302SWIHAR",2024-03-02,"England League Two","Swindon","Harrogate",1,1,"D",15,9,3,1,7,10,11,5,1,1,0,0,0,0,0,2,24,4,17,16,2,0
"20240302TRASUT",2024-03-02,"England League Two","Tranmere","Sutton",1,0,"H",24,11,13,6,4,13,9,8,3,3,0,0,0,0,0,1,35,19,17,17,6,0
"20240302WALDON",2024-03-02,"England League Two","Walsall","Doncaster",3,1,"H",10,6,4,5,8,13,8,4,0,5,0,0,0,0,0,4,16,9,21,12,5,0
"20240302WREACC",2024-03-02,"England League Two","Wrexham","Accrington",4,0,"H",22,12,11,3,9,20,6,4,1,1,0,1,0,0,0,4,34,14,29,10,2,1
"20240305AFCGRI",2024-03-05,"England League Two","AFC Wimbledon","Grimsby",0,0,"D",15,9,6,1,8,12,7,3,1,4,0,0,0,0,0,0,24,7,20,10,5,0
"20240305BARGIL",2024-03-05,"England League Two","Barrow","Gillingham",2,0,"H",10,7,4,2,11,8,1,8,3,4,0,0,0,0,0,2,17,6,19,9,7,0
"20240305BRADON",2024-03-05,"England League Two","Bradford","Doncaster",1,1,"D",6,13,3,5,19,10,1,10,5,4,0,0,0,0,0,2,19,8,29,11,9,0
"20240305MANMIL",2024-03-05,"England League Two","Mansfield","Milton Keynes Dons",1,2,"A",23,17,11,5,12,9,5,3,2,1,0,0,0,0,0,3,40,16,21,8,3,0
"20240305MORCRA",2024-03-05,"England League Two","Morecambe","Crawley Town",1,0,"H",13,17,5,2,14,17,2,7,4,4,0,0,0,0,0,1,30,7,31,9,8,0
"20240309ACCBRA",2024-03-09,"England League Two","Accrington","Bradford",0,3,"A",16,17,3,5,15,8,6,7,1,1,0,0,0,0,0,3,33,8,23,13,2,0
"20240309BARCOL",2024-03-09,"England League Two","Barrow","Colchester",2,0,"H",8,9,4,3,10,14,3,6,1,3,0,0,0,0,0,2,17,7,24,9,4,0
"20240309DONCRE",2024-03-09,"England League Two","Doncaster","Crewe",2,0,"H",14,9,9,2,11,12,5,7,0,4,0,0,0,0,0,2,23,11,23,12,4,0
"20240309FORWAL",2024-03-09,"England League Two","Forest Green","Walsall",2,0,"H",5,17,3,4,14,7,0,7,3,1,0,1,0,0,0,2,22,7,21,7,4,1
"20240309GILTRA",2024-03-09,"England League Two","Gillingham","Tranmere",1,1,"D",26,10,5,4,11,6,6,2,1,3,0,0,0,0,0,2,36,9,17,8,4,0
"20240309HARCRA",2024-03-09,"England League Two","Harrogate","Crawley Town",1,2,"A",17,18,8,5,6,10,5,7,1,1,0,0,0,0,0,3,35,13,16,12,2,0
"20240309MANSWI",2024-03-09,"England League Two","Mansfield","Swindon",3,2,"H",22,20,10,8,9,8,6,3,1,1,0,0,0,0,0,5,42,18,17,9,2,0
"20240309MILSAL",2024-03-09,"England League Two","Milton Keynes Dons","Salford",3,1,"H",9,9,6,6,10,16,5,2,2,5,0,0,0,0,0,4,18,12,26,7,7,0
"20240309MORWRE",2024-03-09,"England League Two","Morecambe","Wrexham",1,3,"A",6,20,2,8,13,10,5,9,2,1,1,0,0,0,0,4,26,10,23,14,3,1
"20240309NOTAFC",2024-03-09,"England League Two","Notts County","AFC Wimbledon",0,2,"A",8,8,1,4,8,17,7,2,2,5,0,0,0,0,0,2,16,5,25,9,7,0
"20240309STONEW",2024-03-09,"England League Two","Stockport","Newport County",1,0,"H",27,3,14,2,8,15,11,2,1,4,0,0,0,0,0,1,30,16,23,13,5,0
"20240309SUTGRI",2024-03-09,"England League Two","Sutton","Grimsby",1,1,"D",9,20,1,9,13,15,4,7,1,3,0,0,0,0,0,2,29,10,28,11,4,0
"20240312AFCGIL",2024-03-12,"England League Two","AFC Wimbledon","Gillingham",2,0,"H",16,8,9,2,13,10,7,3,1,2,0,1,0,0,0,2,24,11,23,10,3,1
"20240312BRAFOR",2024-03-12,"England League Two","Bradford","Forest Green",0,2,"A",17,8,6,3,6,5,9,2,1,1,0,0,0,0,0,2,25,9,11,11,2,0
"20240312CRANOT",2024-03-12,"England League Two","Crawley Town","Notts County",2,1,"H",31,12,14,6,13,4,9,3,5,2,0,1,0,0,0,3,43,20,17,12,7,1
"20240312CRESUT",2024-03-12,"England League Two","Crewe","Sutton",1,0,"H",7,11,3,2,13,12,5,4,1,4,0,0,0,0,0,1,18,5,25,9,5,0
"20240312GRIMIL",2024-03-12,"England League Two","Grimsby","Milton Keynes Dons",1,0,"H",7,6,3,1,17,16,2,6,5,0,0,0,0,0,0,1,13,4,33,8,5,0
"20240312NEWMOR",2024-03-12,"England League Two","Newport County","Morecambe",5,3,"H",19,23,9,7,12,8,8,5,3,1,0,0,0,0,0,8,42,16,20,13,4,0
"20240312SWIACC",2024-03-12,"England League Two","Swindon","Accrington",1,2,"A",15,14,5,6,7,14,6,4,2,2,0,0,0,0,0,3,29,11,21,10,4,0
"20240312TRAMAN",2024-03-12,"England League Two","Tranmere","Mansfield",2,1,"H",16,13,7,4,10,15,6,5,2,4,0,0,0,0,0,3,29,11,25,11,6,0
"20240312WALBAR",2024-03-12,"England League Two","Walsall","Barrow",1,1,"D",12,12,6,3,11,12,2,5,2,1,0,0,0,0,0,2,24,9,23,7,3,0
"20240312WREHAR",2024-03-12,"England League Two","Wrexham","Harrogate",0,0,"D",16,3,4,0,13,9,10,3,1,2,0,0,0,0,0,0,19,4,22,13,3,0
"20240314SALSTO",2024-03-14,"England League Two","Salford","Stockport",2,2,"D",6,11,4,5,14,15,2,7,4,2,0,0,0,0,0,4,17,9,29,9,6,0
"20240316ACCNOT",2024-03-16,"England League Two","Accrington","Notts County",2,2,"D",23,14,6,7,13,11,6,5,2,1,0,0,0,0,0,4,37,13,24,11,3,0
"20240316AFCNEW",2024-03-16,"England League Two","AFC Wimbledon","Newport County",0,2,"A",15,8,3,4,17,13,4,3,1,4,0,0,2,0,2,2,23,7,30,7,5,0
"20240316BARHAR",2024-03-16,"England League Two","Barrow","Harrogate",0,0,"D",18,8,1,1,9,13,4,2,1,1,0,0,0,0,0,0,26,2,22,6,2,0
"20240316BRAMAN",2024-03-16,"England League Two","Bradford","Mansfield",1,5,"A",6,27,1,11,10,11,5,5,2,2,0,0,0,0,0,6,33,12,21,10,4,0
"20240316COLWAL",2024-03-16,"England League Two","Colchester","Walsall",1,1,"D",14,13,6,4,14,14,8,6,1,2,0,0,0,0,0,2,27,10,28,14,3,0
"20240316FORSUT",2024-03-16,"England League Two","Forest Green","Sutton",0,1,"A",5,7,2,2,10,9,1,3,1,0,0,0,0,0,0,1,12,4,19,4,1,0
"20240316GILGRI",2024-03-16,"England League Two","Gillingham","Grimsby",1,1,"D",15,8,6,3,15,19,4,2,2,3,0,0,0,0,0,2,23,9,34,6,5,0
"20240316MILCRE",2024-03-16,"England League Two","Milton Keynes Dons","Crewe",3,1,"H",14,15,10,6,14,12,4,3,3,2,0,0,0,0,0,4,29,16,26,7,5,0
"20240316SWIDON",2024-03-16,"England League Two","Swindon","Doncaster",1,2,"A",15,7,4,2,12,13,7,3,3,3,0,0,0,0,0,3,22,6,25,10,6,0
"20240316WRETRA",2024-03-16,"England League Two","Wrexham","Tranmere",0,1,"A",25,7,4,3,7,10,9,4,2,2,0,0,0,0,0,1,32,7,17,13,4,0
"20240317SALMOR",2024-03-17,"England League Two","Salford","Morecambe",3,1,"H",22,5,7,1,10,8,8,4,1,1,0,0,0,0,0,4,27,8,18,12,2,0
"20240318CRASTO",2024-03-18,"England League Two","Crawley Town","Stockport",1,1,"D",10,14,3,7,12,11,4,4,1,1,0,0,0,0,0,2,24,10,23,8,2,0
"20240319BRANOT",2024-03-19,"England League Two","Bradford","Notts County",0,3,"A",13,20,3,12,22,8,2,8,5,1,0,0,0,0,0,3,33,15,30,10,6,0
"20240323MANCOL",2024-03-23,"England League Two","Mansfield","Colchester",1,1,"D",15,10,7,6,8,13,8,6,1,4,0,0,0,0,0,2,25,13,21,14,5,0
"20240323HARBRA",2024-03-23,"England League Two","Harrogate","Bradford",3,0,"H",13,10,7,3,12,14,4,5,1,1,0,0,0,0,0,3,23,10,26,9,2,0
"20240323BARNEW",2024-03-23,"England League Two","Barrow","Newport County",1,0,"H",18,8,3,2,7,12,5,4,1,2,0,0,0,0,0,1,26,5,19,9,3,0
"20240323CREAFC",2024-03-23,"England League Two","Crewe","AFC Wimbledon",1,1,"D",10,14,3,1,6,11,4,2,2,2,0,0,0,0,0,2,24,4,17,6,4,0
"20240323DONFOR",2024-03-23,"England League Two","Doncaster","Forest Green",2,0,"H",14,3,6,0,10,13,3,0,2,2,0,0,0,0,0,2,17,6,23,3,4,0
"20240323GRIWRE",2024-03-23,"England League Two","Grimsby","Wrexham",1,3,"A",11,13,2,5,7,15,2,4,1,1,0,0,0,0,0,4,24,7,22,6,2,0
"20240323MORGIL",2024-03-23,"England League Two","Morecambe","Gillingham",2,3,"A",14,10,5,3,15,11,5,7,4,2,0,0,0,0,0,5,24,8,26,12,6,0
"20240323NOTSAL",2024-03-23,"England League Two","Notts County","Salford",1,2,"A",14,14,2,7,3,20,5,2,0,3,0,0,0,0,0,3,28,9,23,7,3,0
"20240323SUTACC",2024-03-23,"England League Two","Sutton","Accrington",3,1,"H",14,11,10,5,12,11,8,3,1,1,0,0,0,0,0,4,25,15,23,11,2,0
"20240323TRACRA",2024-03-23,"England League Two","Tranmere","Crawley Town",1,3,"A",15,10,5,3,8,10,6,3,1,1,0,0,0,0,0,4,25,8,18,9,2,0
"20240323STOMIL",2024-03-23,"England League Two","Stockport","Milton Keynes Dons",5,0,"H",10,13,7,3,17,11,3,1,1,1,0,0,0,0,0,5,23,10,28,4,2,0
"20240329ACCMOR",2024-03-29,"England League Two","Accrington","Morecambe",1,2,"A",17,11,7,5,18,17,8,3,4,2,0,0,0,0,0,3,28,12,35,11,6,0
"20240329AFCHAR",2024-03-29,"England League Two","AFC Wimbledon","Harrogate",1,1,"D",16,11,5,1,9,7,6,4,1,1,1,0,0,0,0,2,27,6,16,10,2,1
"20240329BARGRI",2024-03-29,"England League Two","Barrow","Grimsby",3,1,"H",14,12,7,2,14,12,5,7,1,0,0,0,0,0,0,4,26,9,26,12,1,0
"20240329BRATRA",2024-03-29,"England League Two","Bradford","Tranmere",2,0,"H",21,13,7,3,8,15,5,9,2,3,0,0,0,0,0,2,34,10,23,14,5,0
"20240329COLNEW",2024-03-29,"England League Two","Colchester","Newport County",2,1,"H",19,3,7,2,13,15,10,1,2,2,0,0,0,0,0,3,22,9,28,11,4,0
"20240329CRADON",2024-03-29,"England League Two","Crawley Town","Doncaster",0,2,"A",19,17,7,8,9,15,11,8,3,2,0,1,0,0,0,2,36,15,24,19,5,1
"20240329FORSTO",2024-03-29,"England League Two","Forest Green","Stockport",0,3,"A",1,14,0,5,11,8,2,5,2,0,0,0,0,0,0,3,15,5,19,7,2,0
"20240329GILCRE",2024-03-29,"England League Two","Gillingham","Crewe",0,0,"D",10,7,2,2,16,12,3,3,2,3,0,0,0,0,0,0,17,4,28,6,5,0
"20240329MILWAL",2024-03-29,"England League Two","Milton Keynes Dons","Walsall",5,0,"H",19,4,8,1,6,13,4,5,0,2,0,0,0,0,0,5,23,9,19,9,2,0
"20240329SALSUT",2024-03-29,"England League Two","Salford","Sutton",1,2,"A",15,8,6,4,9,18,4,4,1,4,0,0,0,0,0,3,23,10,27,8,5,0
"20240329SWINOT",2024-03-29,"England League Two","Swindon","Notts County",2,1,"H",9,8,5,5,10,4,5,2,3,0,0,0,0,0,0,3,17,10,14,7,3,0
"20240329WREMAN",2024-03-29,"England League Two","Wrexham","Mansfield",2,0,"H",7,10,4,1,11,13,1,6,1,3,0,0,0,0,0,2,17,5,24,7,4,0
"20240401GRIBRA",2024-04-01,"England League Two","Grimsby","Bradford",1,1,"D",12,11,1,4,16,18,5,2,2,5,1,0,0,0,0,2,23,5,34,7,7,1
"20240401CREFOR",2024-04-01,"England League Two","Crewe","Forest Green",0,3,"A",22,9,5,6,11,9,8,2,3,3,0,0,0,0,0,3,31,11,20,10,6,0
"20240401HARGIL",2024-04-01,"England League Two","Harrogate","Gillingham",5,1,"H",17,11,8,5,7,9,5,2,3,2,0,0,0,0,0,6,28,13,16,7,5,0
"20240401MORBAR",2024-04-01,"England League Two","Morecambe","Barrow",2,1,"H",8,17,2,4,7,11,7,6,2,2,0,0,0,0,0,3,25,6,18,13,4,0
"20240401NEWCRA",2024-04-01,"England League Two","Newport County","Crawley Town",0,4,"A",10,10,4,7,10,15,6,5,1,3,0,0,0,0,0,4,20,11,25,11,4,0
"20240401NOTMIL",2024-04-01,"England League Two","Notts County","Milton Keynes Dons",3,3,"D",13,16,4,5,10,13,6,7,2,3,0,0,0,0,0,6,29,9,23,13,5,0
"20240401STOAFC",2024-04-01,"England League Two","Stockport","AFC Wimbledon",1,0,"H",8,2,2,0,10,19,4,1,0,3,0,0,0,0,0,1,10,2,29,5,3,0
"20240401SUTSWI",2024-04-01,"England League Two","Sutton","Swindon",3,1,"H",19,13,8,4,14,9,8,2,2,1,0,0,0,0,0,4,32,12,23,10,3,0
"20240401TRACOL",2024-04-01,"England League Two","Tranmere","Colchester",1,1,"D",17,13,5,7,11,14,6,4,2,4,0,0,0,0,0,2,30,12,25,10,6,0
"20240401WALSAL",2024-04-01,"England League Two","Walsall","Salford",2,1,"H",10,18,5,6,11,15,4,5,0,2,0,0,0,0,0,3,28,11,26,9,2,0
"20240402DONWRE",2024-04-02,"England League Two","Doncaster","Wrexham",1,0,"H",13,15,6,1,10,11,4,5,3,2,0,0,0,0,0,1,28,7,21,9,5,0
"20240406ACCCRE",2024-04-06,"England League Two","Accrington","Crewe",0,0,"D",11,6,2,2,11,8,0,7,2,1,0,0,0,0,0,0,17,4,19,7,3,0
"20240406AFCSAL",2024-04-06,"England League Two","AFC Wimbledon","Salford",1,0,"H",10,12,2,4,10,16,3,2,2,6,0,2,0,0,0,1,22,6,26,5,8,2
"20240406BARSWI",2024-04-06,"England League Two","Barrow","Swindon",0,2,"A",21,13,7,9,12,19,4,3,3,2,0,0,0,0,0,2,34,16,31,7,5,0
"20240406BRAGIL",2024-04-06,"England League Two","Bradford","Gillingham",1,0,"H",16,9,6,3,11,8,7,4,1,2,0,0,0,0,0,1,25,9,19,11,3,0
"20240406COLWRE",2024-04-06,"England League Two","Colchester","Wrexham",1,2,"A",14,12,2,2,7,10,3,7,0,1,0,0,0,0,0,3,26,4,17,10,1,0
"20240406FORMIL",2024-04-06,"England League Two","Forest Green","Milton Keynes Dons",0,2,"A",3,14,0,4,15,9,4,6,2,1,0,0,0,0,0,2,17,4,24,10,3,0
"20240406GRINEW",2024-04-06,"England League Two","Grimsby","Newport County",1,0,"H",17,4,6,2,12,12,8,1,2,2,0,0,0,0,0,1,21,8,24,9,4,0
"20240406MANCRA",2024-04-06,"England League Two","Mansfield","Crawley Town",1,4,"A",22,12,5,6,9,9,8,6,0,3,0,0,0,0,0,5,34,11,18,14,3,0
"20240406MORDON",2024-04-06,"England League Two","Morecambe","Doncaster",0,3,"A",12,14,3,4,8,15,5,5,2,3,0,0,0,0,0,3,26,7,23,10,5,0
"20240406NOTHAR",2024-04-06,"England League Two","Notts County","Harrogate",3,0,"H",17,16,9,9,11,11,9,11,3,1,0,0,0,0,0,3,33,18,22,20,4,0
"20240406SUTSTO",2024-04-06,"England League Two","Sutton","Stockport",1,3,"A",4,14,2,5,16,14,5,2,3,2,0,0,0,0,0,4,18,7,30,7,5,0
"20240406TRAWAL",2024-04-06,"England League Two","Tranmere","Walsall",1,3,"A",13,16,3,6,9,11,11,6,2,2,0,0,0,0,0,4,29,9,20,17,4,0
"20240409COLSTO",2024-04-09,"England League Two","Colchester","Stockport",1,2,"A",8,10,3,3,18,14,3,4,3,3,0,0,0,0,0,3,18,6,32,7,6,0
"20240409DONWAL",2024-04-09,"England League Two","Doncaster","Walsall",2,1,"H",11,8,6,4,10,16,2,6,2,2,0,0,0,0,0,3,19,10,26,8,4,0
"20240409HARGRI",2024-04-09,"England League Two","Harrogate","Grimsby",1,0,"H",11,11,6,2,13,17,6,1,1,1,0,0,0,0,0,1,22,8,30,7,2,0
"20240409MANFOR",2024-04-09,"England League Two","Mansfield","Forest Green",1,0,"H",18,4,7,2,14,8,5,6,3,1,0,0,0,0,0,1,22,9,22,11,4,0
"20240409MORCRE",2024-04-09,"England League Two","Morecambe","Crewe",0,1,"A",12,11,2,3,8,7,5,9,1,0,0,1,0,0,0,1,23,5,15,14,1,1
"20240409NEWACC",2024-04-09,"England League Two","Newport County","Accrington",1,3,"A",8,18,2,6,12,9,3,1,2,0,1,0,0,0,0,4,26,8,21,4,2,1
"20240409WRECRA",2024-04-09,"England League Two","Wrexham","Crawley Town",4,1,"H",14,15,7,8,6,6,5,9,1,1,0,0,0,0,0,5,29,15,12,14,2,0
"20240413CRACOL",2024-04-13,"England League Two","Crawley Town","Colchester",2,3,"A",23,11,4,6,8,14,13,5,0,3,0,1,0,0,0,5,34,10,22,18,3,1
"20240413CREGRI",2024-04-13,"England League Two","Crewe","Grimsby",0,3,"A",5,21,2,5,11,9,4,13,2,1,0,0,0,0,0,3,26,7,20,17,3,0
"20240413DONACC",2024-04-13,"England League Two","Doncaster","Accrington",4,0,"H",19,9,8,2,7,16,7,3,1,2,0,0,0,0,0,4,28,10,23,10,3,0
"20240413GILBAR",2024-04-13,"England League Two","Gillingham","Barrow",3,0,"H",11,8,7,3,13,7,6,6,0,0,0,1,0,0,0,3,19,10,20,12,0,1
"20240413HARSUT",2024-04-13,"England League Two","Harrogate","Sutton",2,2,"D",8,18,4,5,10,14,1,6,1,2,0,0,0,0,0,4,26,9,24,7,3,0
"20240413MILMAN",2024-04-13,"England League Two","Milton Keynes Dons","Mansfield",1,4,"A",12,11,2,7,10,15,3,2,3,5,0,0,0,0,0,5,23,9,25,5,8,0
"20240413NEWTRA",2024-04-13,"England League Two","Newport County","Tranmere",1,2,"A",10,15,4,5,12,14,0,10,2,2,0,0,2,0,2,3,25,9,26,10,4,0
"20240413SALBRA",2024-04-13,"England League Two","Salford","Bradford",1,2,"A",11,22,4,10,16,15,1,6,3,3,0,0,0,0,0,3,33,14,31,7,6,0
"20240413STOMOR",2024-04-13,"England League Two","Stockport","Morecambe",2,0,"H",10,1,4,0,7,15,3,2,1,3,0,0,0,0,0,2,11,4,22,5,4,0
"20240413SWIAFC",2024-04-13,"England League Two","Swindon","AFC Wimbledon",3,2,"H",9,12,5,5,6,15,2,3,1,0,1,0,0,0,0,5,21,10,21,5,1,1
"20240413WALNOT",2024-04-13,"England League Two","Walsall","Notts County",1,3,"A",21,6,3,3,14,5,8,1,4,2,1,0,0,0,0,4,27,6,19,9,6,1
"20240413WREFOR",2024-04-13,"England League Two","Wrexham","Forest Green",6,0,"H",21,4,8,4,9,12,6,0,0,2,0,0,0,0,0,6,25,12,21,6,2,0
"20240416COLGRI",2024-04-16,"England League Two","Colchester","Grimsby",2,0,"H",8,15,3,4,12,13,5,5,2,2,1,0,0,0,0,2,23,7,25,10,4,1
"20240416CRABAR",2024-04-16,"England League Two","Crawley Town","Barrow",1,1,"D",12,13,4,7,11,6,5,4,2,3,0,0,0,0,0,2,25,11,17,9,5,0
"20240416MANACC",2024-04-16,"England League Two","Mansfield","Accrington",2,1,"H",14,5,5,3,15,16,4,1,0,2,0,0,0,0,0,3,19,8,31,5,2,0
"20240416NOTSTO",2024-04-16,"England League Two","Notts County","Stockport",2,5,"A",13,22,7,9,6,8,2,9,2,2,0,0,0,0,0,7,35,16,14,11,4,0
"20240416WALSWI",2024-04-16,"England League Two","Walsall","Swindon",2,1,"H",15,14,4,4,7,6,5,7,1,0,0,0,0,0,0,3,29,8,13,12,1,0
"20240420CREWRE",2024-04-20,"England League Two","Crewe","Wrexham",0,3,"A",7,25,2,10,10,10,3,6,3,1,1,0,0,0,0,3,32,12,20,9,4,1
"20240420DONBAR",2024-04-20,"England League Two","Doncaster","Barrow",4,2,"H",11,4,8,2,12,6,3,3,3,1,0,0,0,0,0,6,15,10,18,6,4,0
"20240420GRISWI",2024-04-20,"England League Two","Grimsby","Swindon",2,0,"H",17,6,5,0,11,12,2,2,1,0,0,0,0,0,0,2,23,5,23,4,1,0
"20240420HARMIL",2024-04-20,"England League Two","Harrogate","Milton Keynes Dons",3,5,"A",16,17,8,9,9,10,4,5,0,0,0,0,0,0,0,8,33,17,19,9,0,0
"20240420MANGIL",2024-04-20,"England League Two","Mansfield","Gillingham",2,1,"H",22,7,7,2,4,13,8,5,1,2,0,0,0,0,0,3,29,9,17,13,3,0
"20240420MORFOR",2024-04-20,"England League Two","Morecambe","Forest Green",1,2,"A",9,15,3,5,7,13,10,7,1,3,0,0,0,0,0,3,24,8,20,17,4,0
"20240420NEWSAL",2024-04-20,"England League Two","Newport County","Salford",0,1,"A",6,19,2,8,13,11,2,7,2,3,0,0,0,0,0,1,25,10,24,9,5,0
"20240420NOTCOL",2024-04-20,"England League Two","Notts County","Colchester",1,0,"H",19,10,6,5,8,9,9,2,1,3,0,0,0,0,0,1,29,11,17,11,4,0
"20240420STOACC",2024-04-20,"England League Two","Stockport","Accrington",4,2,"H",17,9,7,3,4,15,4,3,2,3,0,0,0,0,0,6,26,10,19,7,5,0
"20240420SUTCRA",2024-04-20,"England League Two","Sutton","Crawley Town",2,2,"D",16,20,7,10,15,10,3,7,2,1,0,0,0,0,0,4,36,17,25,10,3,0
"20240420TRAAFC",2024-04-20,"England League Two","Tranmere","AFC Wimbledon",3,2,"H",20,13,6,4,5,15,11,3,0,1,0,1,0,0,0,5,33,10,20,14,1,1
"20240420WALBRA",2024-04-20,"England League Two","Walsall","Bradford",2,3,"A",22,11,8,5,13,14,9,4,2,3,0,1,0,0,0,5,33,13,27,13,5,1
"20240423BARBRA",2024-04-23,"England League Two","Barrow","Bradford",1,2,"A",9,9,4,5,15,13,1,8,3,3,0,0,0,0,0,3,18,9,28,9,6,0
"20240423COLDON",2024-04-23,"England League Two","Colchester","Doncaster",1,4,"A",9,11,3,9,14,9,6,2,2,3,0,0,0,0,0,5,20,12,23,8,5,0
"20240427ACCTRA",2024-04-27,"England League Two","Accrington","Tranmere",4,1,"H",20,10,7,2,13,10,9,7,2,0,0,0,0,0,0,5,30,9,23,16,2,0
"20240427AFCWAL",2024-04-27,"England League Two","AFC Wimbledon","Walsall",5,1,"H",6,17,5,3,8,10,2,3,0,1,0,0,0,0,0,6,23,8,18,5,1,0
"20240427BARMAN",2024-04-27,"England League Two","Barrow","Mansfield",1,1,"D",19,6,6,1,12,15,5,1,1,3,0,0,0,0,0,2,25,7,27,6,4,0
"20240427BRANEW",2024-04-27,"England League Two","Bradford","Newport County",4,1,"H",17,16,6,2,8,12,7,2,0,1,0,0,0,0,0,5,33,8,20,9,1,0
"20240427COLCRE",2024-04-27,"England League Two","Colchester","Crewe",1,1,"D",15,9,5,5,7,12,2,3,1,1,0,0,0,0,0,2,24,10,19,5,2,0
"20240427CRAGRI",2024-04-27,"England League Two","Crawley Town","Grimsby",2,0,"H",9,10,5,2,7,9,5,7,0,0,0,0,0,0,0,2,19,7,16,12,0,0
"20240427FORNOT",2024-04-27,"England League Two","Forest Green","Notts County",1,0,"H",15,10,3,1,18,9,7,7,1,2,0,0,0,0,0,1,25,4,27,14,3,0
"20240427GILDON",2024-04-27,"England League Two","Gillingham","Doncaster",2,2,"D",17,12,7,4,11,12,7,5,2,1,0,1,0,0,0,4,29,11,23,12,3,1
"20240427MILSUT",2024-04-27,"England League Two","Milton Keynes Dons","Sutton",4,4,"D",18,17,8,12,10,13,3,9,2,2,0,0,0,0,0,8,35,20,23,12,4,0
"20240427SALHAR",2024-04-27,"England League Two","Salford","Harrogate",2,2,"D",15,14,4,4,13,9,2,8,0,2,0,0,0,0,0,4,29,8,22,10,2,0
"20240427SWIMOR",2024-04-27,"England League Two","Swindon","Morecambe",3,3,"D",13,17,5,6,5,12,7,7,1,0,0,0,0,0,0,6,30,11,17,14,1,0
"20240427WRESTO",2024-04-27,"England League Two","Wrexham","Stockport",2,1,"H",9,10,4,1,14,14,3,5,0,3,0,0,0,0,0,3,19,5,28,8,3,0
"20240809CHESWI",2024-08-09,"England League Two","Chesterfield","Swindon",1,1,"D",13,6,4,1,8,13,5,0,0,5,0,0,0,0,0,2,19,5,21,5,5,0
"20240810AFCCOL",2024-08-10,"England League Two","AFC Wimbledon","Colchester",4,2,"H",14,7,6,3,16,6,5,2,5,1,0,0,0,0,0,6,21,9,22,7,6,0
"20240810BARCRE",2024-08-10,"England League Two","Barrow","Crewe",1,0,"H",10,4,4,0,13,12,3,4,3,2,0,0,0,0,0,1,14,4,25,7,5,0
"20240810CHENEW",2024-08-10,"England League Two","Cheltenham","Newport County",3,2,"H",16,11,5,6,13,8,4,6,1,3,0,0,0,0,0,5,27,11,21,10,4,0
"20240810DONACC",2024-08-10,"England League Two","Doncaster","Accrington",4,1,"H",13,3,4,2,5,17,6,1,0,2,0,0,0,0,0,5,16,6,22,7,2,0
"20240810FLEGRI",2024-08-10,"England League Two","Fleetwood Town","Grimsby",1,0,"H",9,5,4,0,11,10,10,3,0,3,0,0,0,0,0,1,14,4,21,13,3,0
"20240810GILCAR",2024-08-10,"England League Two","Gillingham","Carlisle",4,1,"H",14,18,8,5,16,9,6,7,3,0,0,0,0,0,0,5,32,13,25,13,3,0
"20240810HARBRO",2024-08-10,"England League Two","Harrogate","Bromley",0,2,"A",10,13,2,5,8,14,5,7,1,4,0,0,0,0,0,2,23,7,22,12,5,0
"20240810MILBRA",2024-08-10,"England League Two","Milton Keynes Dons","Bradford",1,2,"A",14,7,5,2,11,13,4,2,1,0,0,0,0,0,0,3,21,7,24,6,1,0
"20240810SALPOR",2024-08-10,"England League Two","Salford","Port Vale",0,2,"A",8,7,2,4,7,17,3,7,2,2,0,0,0,0,0,2,15,6,24,10,4,0
"20240810TRANOT",2024-08-10,"England League Two","Tranmere","Notts County",0,0,"D",8,11,2,1,13,5,5,8,1,1,0,0,0,0,0,0,19,3,18,13,2,0
"20240810WALMOR",2024-08-10,"England League Two","Walsall","Morecambe",1,0,"H",8,4,3,0,15,8,8,0,2,0,0,0,0,0,0,1,12,3,23,8,2,0
"20240817BROAFC",2024-08-17,"England League Two","Bromley","AFC Wimbledon",2,0,"H",7,10,4,3,7,16,2,8,1,3,0,0,0,0,0,2,17,7,23,10,4,0
"20240817CARBAR",2024-08-17,"England League Two","Carlisle","Barrow",1,0,"H",13,8,3,0,11,9,8,4,5,2,0,0,0,0,0,1,21,3,20,12,7,0
"20240817ACCHAR",2024-08-17,"England League Two","Accrington","Harrogate",3,3,"D",23,9,9,4,9,14,9,4,1,1,0,0,0,0,0,6,32,13,23,13,2,0
"20240817BRASAL",2024-08-17,"England League Two","Bradford","Salford",0,0,"D",14,6,3,2,10,10,5,1,2,4,0,0,0,0,0,0,20,5,20,6,6,0
"20240817COLMIL",2024-08-17,"England League Two","Colchester","Milton Keynes Dons",2,0,"H",12,11,8,3,16,11,4,4,2,3,0,0,1,1,0,2,23,11,27,8,5,0
"20240817CRECHE",2024-08-17,"England League Two","Crewe","Chesterfield",0,5,"A",13,20,5,11,6,9,5,7,0,3,0,0,0,0,0,5,33,16,15,12,3,0
"20240817GRICHE",2024-08-17,"England League Two","Grimsby","Cheltenham",3,2,"H",13,8,6,2,18,13,9,5,1,6,0,0,0,0,0,5,21,8,31,14,7,0
"20240817MORGIL",2024-08-17,"England League Two","Morecambe","Gillingham",0,1,"A",8,10,3,4,5,15,6,6,0,2,0,0,0,0,0,1,18,7,20,12,2,0
"20240817NEWDON",2024-08-17,"England League Two","Newport County","Doncaster",3,1,"H",12,21,5,8,16,21,4,6,1,2,0,0,0,0,0,4,33,13,37,10,3,0
"20240817PORTRA",2024-08-17,"England League Two","Port Vale","Tranmere",0,0,"D",8,7,3,1,10,11,2,5,2,4,0,0,0,0,0,0,15,4,21,7,6,0
"20240817SWIWAL",2024-08-17,"England League Two","Swindon","Walsall",0,4,"A",7,18,1,7,9,6,2,6,2,0,0,0,0,0,0,4,25,8,15,8,2,0
"20240818NOTFLE",2024-08-18,"England League Two","Notts County","Fleetwood Town",2,2,"D",17,5,8,4,7,14,11,2,2,4,0,0,0,0,0,4,22,12,21,13,6,0
"20240822NOTGRI",2024-08-22,"England League Two","Notts County","Grimsby",4,1,"H",15,14,6,3,11,13,6,4,2,1,0,0,0,0,0,5,29,9,24,10,3,0
"20240824CRESWI",2024-08-24,"England League Two","Crewe","Swindon",0,0,"D",8,9,0,3,11,11,5,10,2,1,0,0,0,0,0,0,17,3,22,15,3,0
"20240824TRAWAL",2024-08-24,"England League Two","Tranmere","Walsall",1,0,"H",5,13,1,1,15,18,3,7,2,4,0,0,0,0,0,1,18,2,33,10,6,0
"20240824BARPOR",2024-08-24,"England League Two","Barrow","Port Vale",4,0,"H",12,6,6,3,8,4,8,6,0,2,0,0,0,0,0,4,18,9,12,14,2,0
"20240824BRABRO",2024-08-24,"England League Two","Bradford","Bromley",3,1,"H",23,11,9,2,18,7,10,3,2,1,0,1,0,0,0,4,34,11,25,13,3,1
"20240824CHEAFC",2024-08-24,"England League Two","Cheltenham","AFC Wimbledon",0,1,"A",5,9,3,4,7,16,3,8,1,1,0,0,0,0,0,1,14,7,23,11,2,0
"20240824CHESAL",2024-08-24,"England League Two","Chesterfield","Salford",1,1,"D",14,5,3,2,11,16,9,1,2,5,0,1,0,0,0,2,19,5,27,10,7,1
"20240824COLHAR",2024-08-24,"England League Two","Colchester","Harrogate",0,1,"A",24,8,7,3,8,13,12,4,1,3,0,0,0,0,0,1,32,10,21,16,4,0
"20240824DONMOR",2024-08-24,"England League Two","Doncaster","Morecambe",1,0,"H",14,7,3,2,13,15,6,7,1,4,0,0,0,0,0,1,21,5,28,13,5,0
"20240824FLEGIL",2024-08-24,"England League Two","Fleetwood Town","Gillingham",0,0,"D",16,7,3,1,5,13,6,1,2,3,0,0,0,0,0,0,23,4,18,7,5,0
"20240824MILCAR",2024-08-24,"England League Two","Milton Keynes Dons","Carlisle",3,0,"H",15,9,6,3,10,15,4,0,3,0,0,0,0,0,0,3,24,9,25,4,3,0
"20240824NEWACC",2024-08-24,"England League Two","Newport County","Accrington",3,1,"H",6,18,2,7,9,13,2,7,2,1,0,0,0,0,0,4,24,9,22,9,3,0
"20240831GILCHE",2024-08-31,"England League Two","Gillingham","Chesterfield",1,0,"H",8,15,2,3,13,16,1,5,2,2,1,1,0,0,0,1,23,5,29,6,4,2
"20240831PORDON",2024-08-31,"England League Two","Port Vale","Doncaster",2,3,"A",11,9,5,4,16,13,4,4,0,1,0,0,0,0,0,5,20,9,29,8,1,0
"20240831ACCCOL",2024-08-31,"England League Two","Accrington","Colchester",1,1,"D",13,10,3,5,21,9,5,3,5,0,0,0,1,0,1,2,23,8,30,8,5,0
"20240831AFCFLE",2024-08-31,"England League Two","AFC Wimbledon","Fleetwood Town",1,0,"H",20,9,5,1,15,10,9,6,3,2,0,0,0,0,0,1,29,6,25,15,5,0
"20240831BROCRE",2024-08-31,"England League Two","Bromley","Crewe",1,2,"A",10,15,2,5,18,11,5,7,2,2,0,0,0,0,0,3,25,7,29,12,4,0
"20240831CARTRA",2024-08-31,"England League Two","Carlisle","Tranmere",1,2,"A",15,4,2,3,9,10,3,6,2,0,0,0,0,0,0,3,19,5,19,9,2,0
"20240831GRIBRA",2024-08-31,"England League Two","Grimsby","Bradford",2,1,"H",8,10,3,4,17,24,5,2,4,4,0,0,0,0,0,3,18,7,41,7,8,0
"20240831HARBAR",2024-08-31,"England League Two","Harrogate","Barrow",0,1,"A",7,12,4,6,16,13,8,6,4,1,0,0,0,0,0,1,19,10,29,14,5,0
"20240831MORNEW",2024-08-31,"England League Two","Morecambe","Newport County",0,1,"A",16,7,4,1,14,14,9,1,4,4,0,0,0,0,0,1,23,5,28,10,8,0
"20240831SWINOT",2024-08-31,"England League Two","Swindon","Notts County",1,2,"A",16,8,5,3,6,5,9,3,0,1,0,0,0,0,0,3,24,8,11,12,1,0
"20240831WALCHE",2024-08-31,"England League Two","Walsall","Cheltenham",2,1,"H",23,6,6,2,15,11,6,2,4,2,0,0,0,0,0,3,29,8,26,8,6,0
"20240902SALMIL",2024-09-02,"England League Two","Salford","Milton Keynes Dons",1,0,"H",13,16,6,5,11,9,4,5,1,0,0,0,0,0,0,1,29,11,20,9,1,0
"20240907BARSWI",2024-09-07,"England League Two","Barrow","Swindon",1,1,"D",7,19,3,5,11,10,6,5,1,2,1,1,0,0,0,2,26,8,21,11,3,2
"20240907BRACAR",2024-09-07,"England League Two","Bradford","Carlisle",2,1,"H",13,13,4,6,14,10,3,5,3,4,0,0,0,0,0,3,26,10,24,8,7,0
"20240907CHEHAR",2024-09-07,"England League Two","Cheltenham","Harrogate",1,0,"H",11,13,4,5,6,10,4,5,2,1,0,0,0,0,0,1,24,9,16,9,3,0
"20240907CHEGRI",2024-09-07,"England League Two","Chesterfield","Grimsby",2,1,"H",12,14,4,7,10,14,4,3,2,4,1,0,0,0,0,3,26,11,24,7,6,1
"20240907COLBRO",2024-09-07,"England League Two","Colchester","Bromley",1,1,"D",14,9,5,4,14,12,8,7,3,3,0,1,0,0,0,2,23,9,26,15,6,1
"20240907CREMOR",2024-09-07,"England League Two","Crewe","Morecambe",1,0,"H",6,13,2,3,17,18,1,7,2,2,0,0,0,0,0,1,19,5,35,8,4,0
"20240907DONGIL",2024-09-07,"England League Two","Doncaster","Gillingham",1,0,"H",10,6,3,1,17,16,3,5,1,1,0,0,0,0,0,1,16,4,33,8,2,0
"20240907MILWAL",2024-09-07,"England League Two","Milton Keynes Dons","Walsall",1,0,"H",9,5,5,2,7,11,3,3,1,2,0,0,0,0,0,1,14,7,18,6,3,0
"20240907NEWPOR",2024-09-07,"England League Two","Newport County","Port Vale",1,4,"A",9,24,3,7,14,11,0,7,3,2,2,0,1,0,1,5,33,10,25,7,5,2
"20240907NOTACC",2024-09-07,"England League Two","Notts County","Accrington",2,0,"H",15,11,8,3,10,15,9,2,0,6,0,0,0,0,0,2,26,11,25,11,6,0
"20240912HARDON",2024-09-12,"England League Two","Harrogate","Doncaster",2,0,"H",8,21,4,5,16,8,5,6,3,3,0,0,0,0,0,2,29,9,24,11,6,0
"20240914AFCMIL",2024-09-14,"England League Two","AFC Wimbledon","Milton Keynes Dons",3,0,"H",12,8,8,2,13,8,2,4,0,0,0,0,0,0,0,3,20,10,21,6,0,0
"20240914SWINEW",2024-09-14,"England League Two","Swindon","Newport County",4,0,"H",13,3,6,0,11,8,3,1,1,0,0,0,0,0,0,4,16,6,19,4,1,0
"20240914ACCCRE",2024-09-14,"England League Two","Accrington","Crewe",0,1,"A",5,7,1,3,11,15,3,1,0,2,0,0,0,0,0,1,12,4,26,4,2,0
"20240914BRONOT",2024-09-14,"England League Two","Bromley","Notts County",2,4,"A",13,14,7,8,10,12,5,2,2,1,0,0,0,0,0,6,27,15,22,7,3,0
"20240914CARFLE",2024-09-14,"England League Two","Carlisle","Fleetwood Town",2,3,"A",9,13,5,4,11,17,3,4,4,4,0,0,0,0,0,5,22,9,28,7,8,0
"20240914GILTRA",2024-09-14,"England League Two","Gillingham","Tranmere",3,0,"H",12,19,5,4,10,11,5,10,2,0,1,0,0,0,0,3,31,9,21,15,2,1
"20240914GRIBAR",2024-09-14,"England League Two","Grimsby","Barrow",1,2,"A",9,16,3,6,9,15,7,6,3,3,0,0,0,0,0,3,25,9,24,13,6,0
"20240914MORCOL",2024-09-14,"England League Two","Morecambe","Colchester",3,3,"D",10,23,3,8,15,13,0,2,2,1,1,0,1,0,1,6,33,11,28,2,3,1
"20240914PORCHE",2024-09-14,"England League Two","Port Vale","Chesterfield",1,0,"H",13,5,4,0,16,10,2,7,6,0,0,0,0,0,0,1,18,4,26,9,6,0
"20240914SALCHE",2024-09-14,"England League Two","Salford","Cheltenham",2,1,"H",9,13,3,3,10,10,4,6,1,0,0,0,0,0,0,3,22,6,20,10,1,0
"20240914WALBRA",2024-09-14,"England League Two","Walsall","Bradford",2,1,"H",12,5,6,2,6,14,7,6,1,5,0,0,0,0,0,3,17,8,20,13,6,0
"20240921ACCPOR",2024-09-21,"England League Two","Accrington","Port Vale",2,2,"D",13,14,4,6,11,8,3,8,3,0,0,0,0,0,0,4,27,10,19,11,3,0
"20240921CHECHE",2024-09-21,"England League Two","Chesterfield","Cheltenham",1,1,"D",13,7,5,3,10,13,6,1,3,1,0,0,0,0,0,2,20,8,23,7,4,0
"20240921BARNEW",2024-09-21,"England League Two","Barrow","Newport County",2,0,"H",21,8,9,0,9,14,10,2,1,4,0,0,0,0,0,2,29,9,23,12,5,0
"20240921BRAAFC",2024-09-21,"England League Two","Bradford","AFC Wimbledon",0,0,"D",11,7,5,0,7,14,7,3,3,2,0,0,0,0,0,0,18,5,21,10,5,0
"20240921COLTRA",2024-09-21,"England League Two","Colchester","Tranmere",3,0,"H",11,14,8,6,7,10,2,5,2,4,0,0,0,0,0,3,25,14,17,7,6,0
"20240921CREHAR",2024-09-21,"England League Two","Crewe","Harrogate",3,0,"H",19,8,6,5,17,16,5,7,3,3,0,0,0,0,0,3,27,11,33,12,6,0
"20240921GRIBRO",2024-09-21,"England League Two","Grimsby","Bromley",1,0,"H",10,16,3,2,9,13,3,4,2,1,1,0,0,0,0,1,26,5,22,7,3,1
"20240921MILDON",2024-09-21,"England League Two","Milton Keynes Dons","Doncaster",1,1,"D",11,13,3,6,8,8,4,5,2,1,1,1,0,0,0,2,24,9,16,9,3,2
"20240921NOTGIL",2024-09-21,"England League Two","Notts County","Gillingham",0,1,"A",12,9,3,5,11,10,6,4,3,4,0,0,0,0,0,1,21,8,21,10,7,0
"20240921SALWAL",2024-09-21,"England League Two","Salford","Walsall",0,2,"A",18,17,2,6,10,14,6,5,1,4,0,0,0,0,0,2,35,8,24,11,5,0
"20240921SWICAR",2024-09-21,"England League Two","Swindon","Carlisle",0,2,"A",17,8,2,2,10,9,9,5,0,3,0,0,0,0,0,2,25,4,19,14,3,0
"20240923FLEMOR",2024-09-23,"England League Two","Fleetwood Town","Morecambe",2,2,"D",25,9,12,4,14,12,5,1,6,4,0,0,0,0,0,4,34,16,26,6,10,0
"20240927TRASAL",2024-09-27,"England League Two","Tranmere","Salford",0,0,"D",16,8,6,3,11,15,11,4,3,7,0,0,0,0,0,0,24,9,26,15,10,0
"20240928HARBRA",2024-09-28,"England League Two","Harrogate","Bradford",2,1,"H",11,11,5,1,12,13,4,2,2,1,0,0,0,0,0,3,22,6,25,6,3,0
"20240928WALCOL",2024-09-28,"England League Two","Walsall","Colchester",4,0,"H",15,9,6,0,14,6,5,5,1,3,0,0,0,0,0,4,24,6,20,10,4,0
"20240928BROMIL",2024-09-28,"England League Two","Bromley","Milton Keynes Dons",1,1,"D",12,13,4,4,10,12,4,2,1,1,0,0,0,0,0,2,25,8,22,6,2,0
"20240928CARGRI",2024-09-28,"England League Two","Carlisle","Grimsby",2,3,"A",11,12,4,6,12,17,5,4,3,0,0,0,0,0,0,5,23,10,29,9,3,0
"20240928CHEFLE",2024-09-28,"England League Two","Cheltenham","Fleetwood Town",0,2,"A",6,14,1,5,13,13,2,6,2,3,0,0,0,0,0,2,20,6,26,8,5,0
"20240928DONCHE",2024-09-28,"England League Two","Doncaster","Chesterfield",0,3,"A",7,6,1,4,16,9,4,10,3,2,2,0,0,0,0,3,13,5,25,14,5,2
"20240928GILBAR",2024-09-28,"England League Two","Gillingham","Barrow",2,0,"H",7,9,4,3,14,10,7,3,5,2,0,0,0,0,0,2,16,7,24,10,7,0
"20240928MORNOT",2024-09-28,"England League Two","Morecambe","Notts County",1,1,"D",10,18,8,4,20,7,7,4,2,1,1,0,0,0,0,2,28,12,27,11,3,1
"20240928NEWCRE",2024-09-28,"England League Two","Newport County","Crewe",2,1,"H",10,10,2,3,10,12,3,4,3,3,0,0,0,0,0,3,20,5,22,7,6,0
"20240928PORSWI",2024-09-28,"England League Two","Port Vale","Swindon",2,1,"H",20,4,6,1,15,11,12,3,3,1,0,0,0,0,0,3,24,7,26,15,4,0
"20241001BROCHE",2024-10-01,"England League Two","Bromley","Chesterfield",2,2,"D",14,12,4,3,16,15,7,5,0,1,0,0,0,0,0,4,26,7,31,12,1,0
"20241001CARNOT",2024-10-01,"England League Two","Carlisle","Notts County",0,2,"A",21,7,7,3,9,9,14,3,1,3,0,0,0,0,0,2,28,10,18,17,4,0
"20241001CHEACC",2024-10-01,"England League Two","Cheltenham","Accrington",2,1,"H",11,10,5,3,12,14,4,7,3,2,0,0,0,0,0,3,21,8,26,11,5,0
"20241001DONBAR",2024-10-01,"England League Two","Doncaster","Barrow",1,0,"H",13,5,4,1,9,11,5,4,0,2,0,0,0,0,0,1,18,5,20,9,2,0
"20241001GILGRI",2024-10-01,"England League Two","Gillingham","Grimsby",0,1,"A",13,6,2,1,10,14,6,3,1,6,0,0,0,0,0,1,19,3,24,9,7,0
"20241001HARMIL",2024-10-01,"England League Two","Harrogate","Milton Keynes Dons",1,5,"A",10,14,5,10,10,11,3,5,0,0,0,0,0,0,0,6,24,15,21,8,0,0
"20241001MORBRA",2024-10-01,"England League Two","Morecambe","Bradford",1,1,"D",14,13,4,3,9,11,5,10,1,0,0,0,0,0,0,2,27,7,20,15,1,0
"20241001NEWSAL",2024-10-01,"England League Two","Newport County","Salford",3,1,"H",17,10,6,2,9,11,3,2,1,4,0,0,0,0,0,4,27,8,20,5,5,0
"20241001PORCOL",2024-10-01,"England League Two","Port Vale","Colchester",1,1,"D",16,11,4,2,8,8,3,3,2,4,0,0,0,0,0,2,27,6,16,6,6,0
"20241001TRASWI",2024-10-01,"England League Two","Tranmere","Swindon",1,1,"D",15,16,3,2,6,10,4,6,0,2,0,0,0,0,0,2,31,5,16,10,2,0
"20241001WALFLE",2024-10-01,"England League Two","Walsall","Fleetwood Town",2,6,"A",17,12,3,7,10,5,5,5,0,2,0,0,0,0,0,8,29,10,15,10,2,0
"20241005FLEBRO",2024-10-05,"England League Two","Fleetwood Town","Bromley",0,0,"D",16,13,2,4,12,7,6,4,0,1,0,0,1,0,1,0,29,6,19,10,1,0
"20241005GRIDON",2024-10-05,"England League Two","Grimsby","Doncaster",0,3,"A",10,8,3,5,7,11,4,4,2,0,1,0,0,0,0,3,18,8,18,8,2,1
"20241005ACCMOR",2024-10-05,"England League Two","Accrington","Morecambe",2,1,"H",12,8,3,2,15,14,5,7,3,0,0,0,0,0,0,3,20,5,29,12,3,0
"20241005BARCHE",2024-10-05,"England League Two","Barrow","Cheltenham",2,1,"H",10,7,4,5,13,12,0,1,2,1,0,0,1,0,1,3,17,9,25,1,3,0
"20241005CHEWAL",2024-10-05,"England League Two","Chesterfield","Walsall",2,2,"D",11,17,2,5,5,11,1,7,0,0,0,0,0,0,0,4,28,7,16,8,0,0
"20241005COLCAR",2024-10-05,"England League Two","Colchester","Carlisle",0,0,"D",14,9,4,1,14,18,5,7,2,3,0,0,0,0,0,0,23,5,32,12,5,0
"20241005CREGIL",2024-10-05,"England League Two","Crewe","Gillingham",2,0,"H",9,18,6,1,14,11,3,5,3,0,0,0,0,0,0,2,27,7,25,8,3,0
"20241005MILTRA",2024-10-05,"England League Two","Milton Keynes Dons","Tranmere",1,1,"D",10,8,4,3,12,12,5,5,2,1,0,0,0,0,0,2,18,7,24,10,3,0
"20241005NOTPOR",2024-10-05,"England League Two","Notts County","Port Vale",0,1,"A",15,8,3,3,8,13,6,3,3,4,0,0,0,0,0,1,23,6,21,9,7,0
"20241005SALAFC",2024-10-05,"England League Two","Salford","AFC Wimbledon",1,0,"H",9,6,4,1,13,19,4,6,4,4,0,0,1,0,1,1,15,5,32,10,8,0
"20241005SWIHAR",2024-10-05,"England League Two","Swindon","Harrogate",0,0,"D",13,7,2,1,12,12,6,2,1,1,0,0,0,0,0,0,20,3,24,8,2,0
"20241007BRANEW",2024-10-07,"England League Two","Bradford","Newport County",3,1,"H",9,9,5,2,13,11,3,2,2,3,0,0,0,0,0,4,18,7,24,5,5,0
"20241012CHENOT",2024-10-12,"England League Two","Chesterfield","Notts County",2,2,"D",13,15,6,6,9,8,5,9,3,3,0,0,0,0,0,4,28,12,17,14,6,0
"20241012AFCCAR",2024-10-12,"England League Two","AFC Wimbledon","Carlisle",4,0,"H",13,3,4,1,16,10,6,2,2,2,0,0,0,0,0,4,16,5,26,8,4,0
"20241012BARMOR",2024-10-12,"England League Two","Barrow","Morecambe",0,1,"A",10,7,5,3,8,15,3,4,1,4,0,0,0,0,0,1,17,8,23,7,5,0
"20241012CHESWI",2024-10-12,"England League Two","Cheltenham","Swindon",2,3,"A",15,11,3,4,13,12,1,2,2,5,0,0,0,0,0,5,26,7,25,3,7,0
"20241012DONCRE",2024-10-12,"England League Two","Doncaster","Crewe",1,1,"D",20,9,5,2,7,9,9,2,0,3,0,0,0,0,0,2,29,7,16,11,3,0
"20241012GILACC",2024-10-12,"England League Two","Gillingham","Accrington",1,2,"A",8,14,2,7,10,17,4,3,1,3,0,0,0,0,0,3,22,9,27,7,4,0
"20241012HARNEW",2024-10-12,"England League Two","Harrogate","Newport County",1,0,"H",7,8,3,1,11,7,7,5,0,1,0,0,0,0,0,1,15,4,18,12,1,0
"20241012MILPOR",2024-10-12,"England League Two","Milton Keynes Dons","Port Vale",0,1,"A",8,12,3,6,9,14,9,5,1,3,0,0,0,0,0,1,20,9,23,14,4,0
"20241012SALGRI",2024-10-12,"England League Two","Salford","Grimsby",1,2,"A",26,6,10,4,16,11,9,1,3,4,0,0,0,0,0,3,32,14,27,10,7,0
"20241012TRABRA",2024-10-12,"England League Two","Tranmere","Bradford",0,2,"A",13,8,2,3,11,10,8,2,1,3,0,0,0,0,0,2,21,5,21,10,4,0
"20241018NEWCHE",2024-10-18,"England League Two","Newport County","Chesterfield",0,3,"A",10,8,4,3,14,11,6,7,3,2,0,0,0,0,0,3,18,7,25,13,5,0
"20241019ACCBAR",2024-10-19,"England League Two","Accrington","Barrow",1,0,"H",6,12,2,2,17,10,2,9,4,1,0,0,0,0,0,1,18,4,27,11,5,0
"20241019BRAGIL",2024-10-19,"England League Two","Bradford","Gillingham",2,1,"H",16,6,6,3,10,13,8,4,5,4,0,0,0,0,0,3,22,9,23,12,9,0
"20241019BROTRA",2024-10-19,"England League Two","Bromley","Tranmere",1,2,"A",25,11,8,3,9,11,9,6,1,5,0,0,0,0,0,3,36,11,20,15,6,0
"20241019CARHAR",2024-10-19,"England League Two","Carlisle","Harrogate",1,1,"D",23,4,9,2,7,9,2,1,2,0,0,0,0,0,0,2,27,11,16,3,2,0
"20241019COLCHE",2024-10-19,"England League Two","Colchester","Cheltenham",1,2,"A",20,6,4,4,10,12,5,3,1,1,0,0,0,0,0,3,26,8,22,8,2,0
"20241019CRESAL",2024-10-19,"England League Two","Crewe","Salford",1,1,"D",7,11,3,5,9,23,8,4,0,3,0,0,0,0,0,2,18,8,32,12,3,0
"20241019GRIWAL",2024-10-19,"England League Two","Grimsby","Walsall",1,4,"A",8,14,5,4,6,12,4,6,2,0,0,0,0,0,0,5,22,9,18,10,2,0
"20241019MORMIL",2024-10-19,"England League Two","Morecambe","Milton Keynes Dons",1,3,"A",18,16,4,9,9,13,9,4,0,3,0,0,0,0,0,4,34,13,22,13,3,0
"20241019NOTAFC",2024-10-19,"England League Two","Notts County","AFC Wimbledon",1,0,"H",12,16,3,8,13,19,3,1,3,2,0,0,0,0,0,1,28,11,32,4,5,0
"20241019PORFLE",2024-10-19,"England League Two","Port Vale","Fleetwood Town",3,1,"H",8,6,3,3,10,13,8,4,0,4,0,0,0,0,0,4,14,6,23,12,4,0
"20241019SWIDON",2024-10-19,"England League Two","Swindon","Doncaster",1,2,"A",8,14,3,5,9,15,3,12,3,2,0,0,0,0,0,3,22,8,24,15,5,0
"20241022AFCMOR",2024-10-22,"England League Two","AFC Wimbledon","Morecambe",3,0,"H",19,4,9,2,10,6,10,1,1,1,0,0,0,0,0,3,23,11,16,11,2,0
"20241022BARNOT",2024-10-22,"England League Two","Barrow","Notts County",1,1,"D",12,11,7,5,16,14,4,4,3,4,0,0,0,0,0,2,23,12,30,8,7,0
"20241022CHEBRA",2024-10-22,"England League Two","Cheltenham","Bradford",1,1,"D",9,15,6,5,14,6,7,10,3,1,0,0,0,0,0,2,24,11,20,17,4,0
"20241022CHECOL",2024-10-22,"England League Two","Chesterfield","Colchester",1,1,"D",24,4,8,1,12,15,17,0,2,3,0,0,0,0,0,2,28,9,27,17,5,0
"20241022DONBRO",2024-10-22,"England League Two","Doncaster","Bromley",0,1,"A",22,12,8,3,4,10,11,8,1,4,0,0,0,0,0,1,34,11,14,19,5,0
"20241022FLECRE",2024-10-22,"England League Two","Fleetwood Town","Crewe",0,1,"A",15,7,5,2,8,12,8,5,0,2,0,0,0,0,0,1,22,7,20,13,2,0
"20241022GILNEW",2024-10-22,"England League Two","Gillingham","Newport County",0,2,"A",25,4,5,3,8,14,9,0,2,2,0,0,0,0,0,2,29,8,22,9,4,0
"20241022HARPOR",2024-10-22,"England League Two","Harrogate","Port Vale",0,1,"A",12,20,3,4,6,11,5,9,1,2,0,0,0,0,0,1,32,7,17,14,3,0
"20241022MILACC",2024-10-22,"England League Two","Milton Keynes Dons","Accrington",2,1,"H",5,14,2,6,14,20,1,5,4,6,0,0,0,0,0,3,19,8,34,6,10,0
"20241022SALSWI",2024-10-22,"England League Two","Salford","Swindon",2,1,"H",16,6,4,2,17,9,6,1,2,1,0,0,0,0,0,3,22,6,26,7,3,0
"20241022TRAGRI",2024-10-22,"England League Two","Tranmere","Grimsby",0,1,"A",18,10,4,2,13,8,4,2,6,2,0,0,0,0,0,1,28,6,21,6,8,0
"20241022WALCAR",2024-10-22,"England League Two","Walsall","Carlisle",3,1,"H",10,7,6,2,7,8,5,2,2,2,0,0,0,0,0,4,17,8,15,7,4,0
"20241026COLSAL",2024-10-26,"England League Two","Colchester","Salford",1,2,"A",11,12,3,5,11,20,5,3,0,0,0,0,0,0,0,3,23,8,31,8,0,0
"20241026MORCHE",2024-10-26,"England League Two","Morecambe","Chesterfield",2,5,"A",15,9,4,6,11,10,5,3,4,2,0,0,0,0,0,7,24,10,21,8,6,0
"20241026ACCWAL",2024-10-26,"England League Two","Accrington","Walsall",0,0,"D",4,15,1,5,10,9,3,11,1,0,0,0,0,0,0,0,19,6,19,14,1,0
"20241026BRADON",2024-10-26,"England League Two","Bradford","Doncaster",1,2,"A",15,20,4,7,10,11,6,13,3,5,0,0,0,0,0,3,35,11,21,19,8,0
"20241026BROBAR",2024-10-26,"England League Two","Bromley","Barrow",1,1,"D",8,12,4,5,12,11,5,4,2,4,0,0,0,0,0,2,20,9,23,9,6,0
"20241026CARCHE",2024-10-26,"England League Two","Carlisle","Cheltenham",0,1,"A",9,14,1,4,14,16,5,5,4,3,0,0,0,0,0,1,23,5,30,10,7,0
"20241026CRETRA",2024-10-26,"England League Two","Crewe","Tranmere",3,1,"H",13,12,6,3,7,10,6,3,3,3,0,0,0,0,0,4,25,9,17,9,6,0
"20241026GRIMIL",2024-10-26,"England League Two","Grimsby","Milton Keynes Dons",1,3,"A",15,12,5,5,9,16,2,1,2,3,0,0,0,0,0,4,27,10,25,3,5,0
"20241026NEWFLE",2024-10-26,"England League Two","Newport County","Fleetwood Town",0,0,"D",10,14,3,3,11,10,6,4,1,3,0,0,0,0,0,0,24,6,21,10,4,0
"20241026NOTHAR",2024-10-26,"England League Two","Notts County","Harrogate",1,0,"H",24,5,7,2,9,11,5,3,1,2,0,0,0,0,0,1,29,9,20,8,3,0
"20241026PORAFC",2024-10-26,"England League Two","Port Vale","AFC Wimbledon",3,2,"H",10,21,4,5,14,15,2,6,5,1,0,0,0,0,0,5,31,9,29,8,6,0
"20241026SWIGIL",2024-10-26,"England League Two","Swindon","Gillingham",1,1,"D",8,13,1,3,5,10,3,3,1,2,1,0,0,0,0,2,21,4,15,6,3,1
"20241029FLESAL",2024-10-29,"England League Two","Fleetwood Town","Salford",2,2,"D",18,11,4,3,8,15,2,2,3,6,0,0,0,0,0,4,29,7,23,4,9,0
"20241109HARMOR",2024-11-09,"England League Two","Harrogate","Morecambe",1,2,"A",22,11,6,3,12,10,4,4,0,1,0,0,0,0,0,3,33,9,22,8,1,0
"20241109SALCAR",2024-11-09,"England League Two","Salford","Carlisle",0,1,"A",15,4,3,1,16,16,8,4,3,2,0,0,0,0,0,1,19,4,32,12,5,0
"20241109AFCGRI",2024-11-09,"England League Two","AFC Wimbledon","Grimsby",0,1,"A",16,8,5,3,13,10,6,1,2,3,0,0,0,0,0,1,24,8,23,7,5,0
"20241109BARCOL",2024-11-09,"England League Two","Barrow","Colchester",1,1,"D",9,4,2,3,12,17,5,3,3,4,0,0,0,0,0,2,13,5,29,8,7,0
"20241109CHEBRO",2024-11-09,"England League Two","Cheltenham","Bromley",1,1,"D",15,12,5,5,12,14,4,2,0,1,0,1,0,0,0,2,27,10,26,6,1,1
"20241109CHEACC",2024-11-09,"England League Two","Chesterfield","Accrington",0,3,"A",13,7,4,5,5,20,7,1,2,3,0,0,0,0,0,3,20,9,25,8,5,0
"20241109DONNOT",2024-11-09,"England League Two","Doncaster","Notts County",1,1,"D",19,9,6,4,13,11,9,3,0,3,0,0,0,0,0,2,28,10,24,12,3,0
"20241109FLEBRA",2024-11-09,"England League Two","Fleetwood Town","Bradford",1,0,"H",7,16,1,4,9,12,6,11,1,1,0,0,0,0,0,1,23,5,21,17,2,0
"20241109GILPOR",2024-11-09,"England League Two","Gillingham","Port Vale",1,0,"H",4,5,1,0,11,10,3,1,2,1,0,0,0,0,0,1,9,1,21,4,3,0
"20241109MILSWI",2024-11-09,"England League Two","Milton Keynes Dons","Swindon",3,1,"H",19,11,11,3,8,4,7,5,1,1,0,0,0,0,0,4,30,14,12,12,2,0
"20241109TRANEW",2024-11-09,"England League Two","Tranmere","Newport County",2,1,"H",15,10,5,2,16,12,7,2,2,2,0,1,0,0,0,3,25,7,28,9,4,1
"20241109WALCRE",2024-11-09,"England League Two","Walsall","Crewe",1,1,"D",12,3,2,1,16,13,6,3,4,4,0,0,0,0,0,2,15,3,29,9,8,0
"20241116ACCSWI",2024-11-16,"England League Two","Accrington","Swindon",2,2,"D",17,11,7,3,18,13,7,3,2,4,0,0,0,0,0,4,28,10,31,10,6,0
"20241116BARAFC",2024-11-16,"England League Two","Barrow","AFC Wimbledon",1,3,"A",10,14,5,7,7,12,6,5,2,4,0,0,0,0,0,4,24,12,19,11,6,0
"20241116BROCAR",2024-11-16,"England League Two","Bromley","Carlisle",1,1,"D",9,23,2,5,9,9,5,8,1,7,1,0,0,0,0,2,32,7,18,13,8,1
"20241116COLBRA",2024-11-16,"England League Two","Colchester","Bradford",1,1,"D",14,6,3,1,10,10,6,3,1,4,0,0,0,0,0,2,20,4,20,9,5,0
"20241116CRENOT",2024-11-16,"England League Two","Crewe","Notts County",2,0,"H",10,17,3,3,13,5,2,6,6,1,1,0,0,0,0,2,27,6,18,8,7,1
"20241116DONSAL",2024-11-16,"England League Two","Doncaster","Salford",1,1,"D",12,10,1,3,9,19,6,3,3,2,0,0,0,0,0,2,22,4,28,9,5,0
"20241116HARCHE",2024-11-16,"England League Two","Harrogate","Chesterfield",2,1,"H",7,12,4,4,13,14,7,6,3,5,0,0,1,0,1,3,19,8,27,13,8,0
"20241116MILCHE",2024-11-16,"England League Two","Milton Keynes Dons","Cheltenham",3,2,"H",7,12,5,4,9,10,4,8,1,0,0,0,0,0,0,5,19,9,19,12,1,0
"20241116MORPOR",2024-11-16,"England League Two","Morecambe","Port Vale",0,1,"A",11,13,0,2,8,14,4,5,0,2,0,0,0,0,0,1,24,2,22,9,2,0
"20241116NEWGRI",2024-11-16,"England League Two","Newport County","Grimsby",0,0,"D",12,8,6,2,15,14,4,3,3,4,0,0,0,0,0,0,20,8,29,7,7,0
"20241119AFCACC",2024-11-19,"England League Two","AFC Wimbledon","Accrington",2,2,"D",14,6,4,3,8,19,2,5,4,3,0,1,0,0,0,4,20,7,27,7,7,1
"20241122CHETRA",2024-11-22,"England League Two","Cheltenham","Tranmere",1,0,"H",14,13,4,4,13,6,5,9,1,3,0,0,0,0,0,1,27,8,19,14,4,0
"20241123GRICOL",2024-11-23,"England League Two","Grimsby","Colchester",0,1,"A",10,10,3,5,10,18,6,6,0,3,0,0,0,0,0,1,20,8,28,12,3,0
"20241123NOTNEW",2024-11-23,"England League Two","Notts County","Newport County",0,0,"D",27,7,7,2,9,14,10,1,0,3,0,0,0,0,0,0,34,9,23,11,3,0
"20241123AFCWAL",2024-11-23,"England League Two","AFC Wimbledon","Walsall",0,1,"A",10,7,4,3,12,16,8,5,2,5,0,0,0,0,0,1,17,7,28,13,7,0
"20241123CARDON",2024-11-23,"England League Two","Carlisle","Doncaster",0,0,"D",7,15,3,3,10,12,3,6,1,2,0,1,0,0,0,0,22,6,22,9,3,1
"20241123CHEBAR",2024-11-23,"England League Two","Chesterfield","Barrow",1,0,"H",8,5,3,1,6,6,8,4,2,3,0,0,0,0,0,1,13,4,12,12,5,0
"20241123GILHAR",2024-11-23,"England League Two","Gillingham","Harrogate",1,2,"A",7,9,1,3,13,10,5,3,2,1,0,0,0,0,0,3,16,4,23,8,3,0
"20241123SWIMOR",2024-11-23,"England League Two","Swindon","Morecambe",2,3,"A",9,11,3,6,7,13,5,8,1,1,0,0,0,0,0,5,20,9,20,13,2,0
"20241125PORCRE",2024-11-25,"England League Two","Port Vale","Crewe",1,1,"D",9,24,1,6,13,9,4,9,2,1,1,0,0,0,0,2,33,7,22,13,3,1
"20241126TRAAFC",2024-11-26,"England League Two","Tranmere","AFC Wimbledon",0,2,"A",17,14,5,4,11,14,4,2,4,1,0,0,0,0,0,2,31,9,25,6,5,0
"20241126WALBRO",2024-11-26,"England League Two","Walsall","Bromley",2,2,"D",17,11,5,4,8,12,4,6,0,1,0,0,0,0,0,4,28,9,20,10,1,0
"20241130CARCRE",2024-11-30,"England League Two","Carlisle","Crewe",1,1,"D",6,8,2,3,13,14,0,3,4,2,0,0,0,0,0,2,14,5,27,3,6,0
"20241130FLECOL",2024-11-30,"England League Two","Fleetwood Town","Colchester",0,0,"D",8,8,3,1,12,10,3,7,2,1,0,0,0,0,0,0,16,4,22,10,3,0
"20241203AFCNEW",2024-12-03,"England League Two","AFC Wimbledon","Newport County",2,2,"D",16,11,6,4,17,10,7,0,3,0,0,0,0,0,0,4,27,10,27,7,3,0
"20241203BRABAR",2024-12-03,"England League Two","Bradford","Barrow",1,1,"D",8,7,4,2,14,7,5,4,4,3,0,0,0,0,0,2,15,6,21,9,7,0
"20241203CHEPOR",2024-12-03,"England League Two","Cheltenham","Port Vale",1,1,"D",9,14,4,4,9,7,5,8,2,2,0,0,0,0,0,2,23,8,16,13,4,0
"20241203COLSWI",2024-12-03,"England League Two","Colchester","Swindon",4,0,"H",14,10,9,2,12,10,8,5,0,3,0,0,0,0,0,4,24,11,22,13,3,0
"20241203GRIACC",2024-12-03,"England League Two","Grimsby","Accrington",5,2,"H",13,12,6,5,12,14,6,5,0,5,0,0,0,0,0,7,25,11,26,11,5,0
"20241203MILCHE",2024-12-03,"England League Two","Milton Keynes Dons","Chesterfield",3,0,"H",12,8,9,3,10,10,5,1,1,2,0,1,0,0,0,3,20,12,20,6,3,1
"20241203SALHAR",2024-12-03,"England League Two","Salford","Harrogate",2,0,"H",16,6,4,2,18,14,9,2,2,2,0,0,0,0,0,2,22,6,32,11,4,0
"20241203TRAMOR",2024-12-03,"England League Two","Tranmere","Morecambe",2,2,"D",18,7,2,3,16,15,11,4,0,3,0,0,0,0,0,4,25,5,31,15,3,0
"20241203WALNOT",2024-12-03,"England League Two","Walsall","Notts County",3,2,"H",23,14,7,6,12,5,3,7,2,0,0,0,0,0,0,5,37,13,17,10,2,0
"20241204BROGIL",2024-12-04,"England League Two","Bromley","Gillingham",2,1,"H",13,16,4,2,9,9,5,5,1,1,0,0,0,0,0,3,29,6,18,10,2,0
"20241204FLEDON",2024-12-04,"England League Two","Fleetwood Town","Doncaster",2,4,"A",11,10,2,6,7,12,5,6,1,3,0,0,0,0,0,6,21,8,19,11,4,0
"20241207CREBRA",2024-12-07,"England League Two","Crewe","Bradford",1,1,"D",10,11,2,2,20,12,3,5,4,5,0,1,0,0,0,2,21,4,32,8,9,1
"20241207PORWAL",2024-12-07,"England League Two","Port Vale","Walsall",0,1,"A",9,9,1,4,4,14,5,8,0,3,0,0,0,0,0,1,18,5,18,13,3,0
"20241207ACCBRO",2024-12-07,"England League Two","Accrington","Bromley",1,2,"A",6,6,2,3,12,7,3,3,2,3,0,0,0,0,0,3,12,5,19,6,5,0
"20241207CHETRA",2024-12-07,"England League Two","Chesterfield","Tranmere",3,0,"H",20,6,8,3,8,8,3,4,2,3,0,0,0,0,0,3,26,11,16,7,5,0
"20241207DONCHE",2024-12-07,"England League Two","Doncaster","Cheltenham",2,2,"D",17,10,4,4,14,14,5,6,2,1,0,0,0,0,0,4,27,8,28,11,3,0
"20241207GILSAL",2024-12-07,"England League Two","Gillingham","Salford",1,0,"H",5,10,3,5,15,7,1,2,2,2,0,0,0,0,0,1,15,8,22,3,4,0
"20241207HARAFC",2024-12-07,"England League Two","Harrogate","AFC Wimbledon",0,3,"A",5,19,1,8,9,9,2,9,2,1,0,0,0,0,0,3,24,9,18,11,3,0
"20241207MORGRI",2024-12-07,"England League Two","Morecambe","Grimsby",0,3,"A",10,16,4,7,9,20,4,3,4,3,0,0,0,0,0,3,26,11,29,7,7,0
"20241207SWIFLE",2024-12-07,"England League Two","Swindon","Fleetwood Town",3,1,"H",13,9,4,2,5,11,5,7,1,2,0,0,0,0,0,4,22,6,16,12,3,0
"20241214SALNOT",2024-12-14,"England League Two","Salford","Notts County",3,0,"H",13,14,5,2,13,10,3,4,1,2,0,0,0,0,0,3,27,7,23,7,3,0
"20241214TRAHAR",2024-12-14,"England League Two","Tranmere","Harrogate",2,1,"H",21,7,5,5,15,10,11,2,2,1,0,0,0,0,0,3,28,10,25,13,3,0
"20241214AFCDON",2024-12-14,"England League Two","AFC Wimbledon","Doncaster",1,0,"H",7,5,2,0,11,13,5,2,3,5,0,0,0,0,0,1,12,2,24,7,8,0
"20241214BRASWI",2024-12-14,"England League Two","Bradford","Swindon",1,0,"H",7,3,2,0,14,14,3,3,2,2,0,0,0,0,0,1,10,2,28,6,4,0
"20241214BROPOR",2024-12-14,"England League Two","Bromley","Port Vale",0,0,"D",24,13,7,4,10,9,5,3,0,1,0,0,0,0,0,0,37,11,19,8,1,0
"20241214CARCHE",2024-12-14,"England League Two","Carlisle","Chesterfield",0,2,"A",11,9,3,4,14,9,8,1,3,2,0,0,0,0,0,2,20,7,23,9,5,0
"20241214CHEMOR",2024-12-14,"England League Two","Cheltenham","Morecambe",2,0,"H",12,7,3,0,14,15,5,6,2,2,0,0,0,0,0,2,19,3,29,11,4,0
"20241214COLNEW",2024-12-14,"England League Two","Colchester","Newport County",0,0,"D",20,7,4,2,13,10,8,3,3,2,0,0,0,0,0,0,27,6,23,11,5,0
"20241214GRICRE",2024-12-14,"England League Two","Grimsby","Crewe",0,2,"A",11,9,1,5,7,14,4,4,1,3,0,0,0,0,0,2,20,6,21,8,4,0
"20241214MILGIL",2024-12-14,"England League Two","Milton Keynes Dons","Gillingham",0,1,"A",12,5,3,2,7,13,3,1,0,3,0,0,0,0,0,1,17,5,20,4,3,0
"20241214WALBAR",2024-12-14,"England League Two","Walsall","Barrow",1,0,"H",10,7,3,3,9,9,5,3,2,3,0,0,0,0,0,1,17,6,18,8,5,0
"20241216FLEACC",2024-12-16,"England League Two","Fleetwood Town","Accrington",1,1,"D",9,16,4,6,10,14,5,4,3,3,0,0,0,0,0,2,25,10,24,9,6,0
"20241220CRECOL",2024-12-20,"England League Two","Crewe","Colchester",0,0,"D",7,10,0,2,12,15,5,4,1,1,0,0,0,0,0,0,17,2,27,9,2,0
"20241220GILCHE",2024-12-20,"England League Two","Gillingham","Cheltenham",2,2,"D",18,5,7,2,18,10,5,1,0,2,0,0,0,0,0,4,23,9,28,6,2,0
"20241221BARFLE",2024-12-21,"England League Two","Barrow","Fleetwood Town",2,0,"H",14,7,8,1,6,12,9,5,1,1,0,0,0,0,0,2,21,9,18,14,2,0
"20241221DONTRA",2024-12-21,"England League Two","Doncaster","Tranmere",3,1,"H",22,10,10,4,12,9,4,4,1,2,0,1,0,0,0,4,32,14,21,8,3,1
"20241221ACCSAL",2024-12-21,"England League Two","Accrington","Salford",0,2,"A",7,5,2,3,12,12,3,3,2,4,0,0,0,0,0,2,12,5,24,6,6,0
"20241221CHEAFC",2024-12-21,"England League Two","Chesterfield","AFC Wimbledon",1,0,"H",6,11,3,1,12,18,4,6,2,2,0,0,0,0,0,1,17,4,30,10,4,0
"20241221HARWAL",2024-12-21,"England League Two","Harrogate","Walsall",0,2,"A",3,20,1,8,10,8,0,12,1,0,1,0,0,0,0,2,23,9,18,12,1,1
"20241221MORBRO",2024-12-21,"England League Two","Morecambe","Bromley",0,2,"A",5,10,0,4,8,8,4,4,1,1,0,0,0,0,0,2,15,4,16,8,2,0
"20241221NEWMIL",2024-12-21,"England League Two","Newport County","Milton Keynes Dons",6,3,"H",16,17,9,4,9,16,2,9,1,3,0,0,0,0,0,9,33,13,25,11,4,0
"20241221NOTBRA",2024-12-21,"England League Two","Notts County","Bradford",3,0,"H",13,12,7,3,13,9,3,11,0,2,0,0,0,0,0,3,25,10,22,14,2,0
"20241221PORCAR",2024-12-21,"England League Two","Port Vale","Carlisle",0,0,"D",10,9,2,2,16,13,5,1,1,5,0,0,0,0,0,0,19,4,29,6,6,0
"20241221SWIGRI",2024-12-21,"England League Two","Swindon","Grimsby",3,1,"H",17,11,4,4,16,10,5,4,2,1,0,0,0,0,0,4,28,8,26,9,3,0
"20241226AFCSWI",2024-12-26,"England League Two","AFC Wimbledon","Swindon",1,1,"D",9,14,3,2,12,8,3,5,0,2,0,0,0,0,0,2,23,5,20,8,2,0
"20241226BRAPOR",2024-12-26,"England League Two","Bradford","Port Vale",2,1,"H",10,14,5,3,13,14,4,5,3,2,0,1,1,1,0,3,24,8,27,9,5,1
"20241226BRONEW",2024-12-26,"England League Two","Bromley","Newport County",5,2,"H",14,6,6,3,15,9,10,2,0,0,0,0,0,0,0,7,20,9,24,12,0,0
"20241226CARMOR",2024-12-26,"England League Two","Carlisle","Morecambe",0,1,"A",8,15,2,6,9,11,9,7,1,3,1,0,0,0,0,1,23,8,20,16,4,1
"20241226CHECRE",2024-12-26,"England League Two","Cheltenham","Crewe",2,1,"H",14,9,5,4,15,15,4,6,1,4,0,0,0,0,0,3,23,9,30,10,5,0
"20241226COLGIL",2024-12-26,"England League Two","Colchester","Gillingham",2,0,"H",12,10,4,4,10,13,3,2,2,2,0,0,0,0,0,2,22,8,23,5,4,0
"20241226FLECHE",2024-12-26,"England League Two","Fleetwood Town","Chesterfield",2,0,"H",6,12,3,7,15,8,5,5,3,2,0,0,0,0,0,2,18,10,23,10,5,0
"20241226GRIHAR",2024-12-26,"England League Two","Grimsby","Harrogate",2,1,"H",14,12,3,2,13,9,4,3,2,2,0,0,0,0,0,3,26,5,22,7,4,0
"20241226MILNOT",2024-12-26,"England League Two","Milton Keynes Dons","Notts County",0,2,"A",13,11,5,5,9,11,5,4,2,3,0,0,0,0,0,2,24,10,20,9,5,0
"20241226SALBAR",2024-12-26,"England League Two","Salford","Barrow",3,0,"H",11,16,5,2,14,12,3,8,3,2,1,0,0,0,0,3,27,7,26,11,5,1
"20241226WALDON",2024-12-26,"England League Two","Walsall","Doncaster",2,0,"H",13,12,3,1,9,12,8,4,2,1,0,0,0,0,0,2,25,4,21,12,3,0
"20241229BROSWI",2024-12-29,"England League Two","Bromley","Swindon",1,1,"D",12,17,1,3,14,12,4,3,2,4,0,0,0,0,0,2,29,4,26,7,6,0
"20241229CARACC",2024-12-29,"England League Two","Carlisle","Accrington",2,1,"H",11,12,2,5,12,17,4,4,5,5,0,0,0,0,0,3,23,7,29,8,10,0
"20241229BRACHE",2024-12-29,"England League Two","Bradford","Chesterfield",2,1,"H",7,12,2,4,23,13,2,5,4,1,0,0,0,0,0,3,19,6,36,7,5,0
"20241229CHENOT",2024-12-29,"England League Two","Cheltenham","Notts County",3,5,"A",12,16,6,6,10,12,2,5,1,2,0,0,0,0,0,8,28,12,22,7,3,0
"20241229COLDON",2024-12-29,"England League Two","Colchester","Doncaster",1,1,"D",10,11,2,7,12,17,5,1,4,2,0,1,0,0,0,2,21,9,29,6,6,1
"20241229FLEHAR",2024-12-29,"England League Two","Fleetwood Town","Harrogate",1,1,"D",19,9,4,4,10,10,11,5,3,1,0,0,0,0,0,2,28,8,20,16,4,0
"20241229GRIPOR",2024-12-29,"England League Two","Grimsby","Port Vale",3,0,"H",15,12,8,2,11,11,7,4,1,1,0,0,0,0,0,3,27,10,22,11,2,0
"20241229MILCRE",2024-12-29,"England League Two","Milton Keynes Dons","Crewe",1,1,"D",12,5,2,3,16,10,4,9,3,2,0,0,0,0,0,2,17,5,26,13,5,0
"20241229SALMOR",2024-12-29,"England League Two","Salford","Morecambe",1,0,"H",16,6,8,2,21,10,3,6,1,1,0,0,0,0,0,1,22,10,31,9,2,0
"20241229TRABAR",2024-12-29,"England League Two","Tranmere","Barrow",1,1,"D",15,17,5,6,13,16,6,2,3,5,0,0,0,0,0,2,32,11,29,8,8,0
"20241229WALNEW",2024-12-29,"England League Two","Walsall","Newport County",2,0,"H",15,4,6,1,12,6,6,2,3,1,0,0,0,0,0,2,19,7,18,8,4,0
"20241230AFCGIL",2024-12-30,"England League Two","AFC Wimbledon","Gillingham",1,0,"H",6,8,2,3,12,13,1,7,2,4,0,0,0,0,0,1,14,5,25,8,6,0
"20220102ARBINV",2022-01-02,"Scotland Championship","Arbroath","Inverness C",0,0,"D",8,9,2,2,6,15,6,5,0,3,0,0,0,0,0,0,17,4,21,11,3,0
"20220102QUEHAM",2022-01-02,"Scotland Championship","Queen of Sth","Hamilton",0,3,"A",1,19,0,10,10,8,3,6,0,0,1,0,0,0,0,3,20,10,18,9,0,1
"20220102RAIDUN",2022-01-02,"Scotland Championship","Raith Rvs","Dunfermline",0,0,"D",6,8,2,2,19,16,5,2,1,2,0,0,0,0,0,0,14,4,35,7,3,0
"20220108AYRARB",2022-01-08,"Scotland Championship","Ayr","Arbroath",1,0,"H",7,8,4,3,11,11,3,9,1,0,0,0,0,0,0,1,15,7,22,12,1,0
"20220108HAMPAR",2022-01-08,"Scotland Championship","Hamilton","Partick",2,2,"D",9,11,5,6,16,13,5,7,2,1,0,0,0,0,0,4,20,11,29,12,3,0
"20220108INVRAI",2022-01-08,"Scotland Championship","Inverness C","Raith Rvs",1,1,"D",10,11,6,4,15,9,2,3,1,4,0,0,0,0,0,2,21,10,24,5,5,0
"20220108MORDUN",2022-01-08,"Scotland Championship","Morton","Dunfermline",5,0,"H",14,10,10,3,13,6,2,1,0,0,0,0,0,0,0,5,24,13,19,3,0,0
"20220108QUEKIL",2022-01-08,"Scotland Championship","Queen of Sth","Kilmarnock",0,2,"A",4,18,0,7,18,7,4,9,1,1,0,0,0,0,0,2,22,7,25,13,2,0
"20220114PARKIL",2022-01-14,"Scotland Championship","Partick","Kilmarnock",1,1,"D",14,13,5,5,11,11,7,2,2,1,0,0,0,0,0,2,27,10,22,9,3,0
"20220115AYRMOR",2022-01-15,"Scotland Championship","Ayr","Morton",0,2,"A",6,7,1,4,11,8,6,4,4,0,0,0,0,0,0,2,13,5,19,10,4,0
"20220115DUNHAM",2022-01-15,"Scotland Championship","Dunfermline","Hamilton",1,0,"H",13,9,7,7,15,13,5,7,2,1,0,0,0,0,0,1,22,14,28,12,3,0
"20220115INVQUE",2022-01-15,"Scotland Championship","Inverness C","Queen of Sth",2,2,"D",19,9,9,4,11,8,5,2,2,2,0,0,0,0,0,4,28,13,19,7,4,0
"20220115RAIARB",2022-01-15,"Scotland Championship","Raith Rvs","Arbroath",1,2,"A",2,7,1,6,14,7,7,3,0,2,0,0,0,0,0,3,9,7,21,10,2,0
"20220122DUNINV",2022-01-22,"Scotland Championship","Dunfermline","Inverness C",1,1,"D",8,7,5,3,12,12,2,2,3,3,0,0,0,0,0,2,15,8,24,4,6,0
"20220128MORRAI",2022-01-28,"Scotland Championship","Morton","Raith Rvs",2,2,"D",14,11,5,3,8,13,5,4,3,2,0,0,0,0,0,4,25,8,21,9,5,0
"20220129HAMAYR",2022-01-29,"Scotland Championship","Hamilton","Ayr",1,1,"D",7,3,2,2,8,12,8,2,2,3,0,0,0,0,0,2,10,4,20,10,5,0
"20220129KILINV",2022-01-29,"Scotland Championship","Kilmarnock","Inverness C",1,0,"H",12,9,4,4,14,14,2,5,1,2,0,0,0,0,0,1,21,8,28,7,3,0
"20220129QUEDUN",2022-01-29,"Scotland Championship","Queen of Sth","Dunfermline",0,2,"A",5,10,0,4,16,10,9,8,0,0,0,0,0,0,0,2,15,4,26,17,0,0
"20220201PARAYR",2022-02-01,"Scotland Championship","Partick","Ayr",1,0,"H",5,5,3,2,14,13,5,3,3,3,0,0,0,0,0,1,10,5,27,8,6,0
"20220201RAIQUE",2022-02-01,"Scotland Championship","Raith Rvs","Queen of Sth",3,3,"D",16,7,6,4,4,9,8,2,0,1,0,0,0,0,0,6,23,10,13,10,1,0
"20220204ARBKIL",2022-02-04,"Scotland Championship","Arbroath","Kilmarnock",1,0,"H",11,9,6,4,9,17,4,6,2,1,0,1,0,0,0,1,20,10,26,10,3,1
"20220205AYRDUN",2022-02-05,"Scotland Championship","Ayr","Dunfermline",1,1,"D",10,6,3,2,16,12,8,2,3,3,0,0,0,0,0,2,16,5,28,10,6,0
"20220205INVMOR",2022-02-05,"Scotland Championship","Inverness C","Morton",0,1,"A",10,8,2,2,13,10,4,7,1,2,0,0,0,0,0,1,18,4,23,11,3,0
"20220205RAIHAM",2022-02-05,"Scotland Championship","Raith Rvs","Hamilton",0,0,"D",7,11,2,2,11,13,6,13,2,2,0,0,0,0,0,0,18,4,24,19,4,0
"20220209ARBHAM",2022-02-09,"Scotland Championship","Arbroath","Hamilton",2,2,"D",9,8,4,3,12,19,5,6,2,2,0,0,1,0,1,4,17,7,31,11,4,0
"20220209INVPAR",2022-02-09,"Scotland Championship","Inverness C","Partick",3,3,"D",10,12,6,5,14,6,7,5,1,0,0,0,0,0,0,6,22,11,20,12,1,0
"20220209KILAYR",2022-02-09,"Scotland Championship","Kilmarnock","Ayr",1,2,"A",11,13,6,5,7,14,4,4,0,2,0,0,0,0,0,3,24,11,21,8,2,0
"20220212KILDUN",2022-02-12,"Scotland Championship","Kilmarnock","Dunfermline",2,1,"H",12,9,8,5,12,7,5,1,5,3,0,1,0,0,0,3,21,13,19,6,8,1
"20220212MORQUE",2022-02-12,"Scotland Championship","Morton","Queen of Sth",2,1,"H",15,12,9,3,13,7,5,3,1,1,0,0,0,0,0,3,27,12,20,8,2,0
"20220219HAMMOR",2022-02-19,"Scotland Championship","Hamilton","Morton",1,0,"H",4,5,1,2,8,11,2,5,3,1,0,0,0,0,0,1,9,3,19,7,4,0
"20220219INVAYR",2022-02-19,"Scotland Championship","Inverness C","Ayr",1,2,"A",9,10,2,6,8,14,10,1,1,1,1,0,0,0,0,3,19,8,22,11,2,1
"20220219KILRAI",2022-02-19,"Scotland Championship","Kilmarnock","Raith Rvs",3,0,"H",9,7,6,2,17,10,2,6,0,0,0,0,0,0,0,3,16,8,27,8,0,0
"20220219QUEARB",2022-02-19,"Scotland Championship","Queen of Sth","Arbroath",0,0,"D",8,4,4,2,9,10,5,5,0,1,0,0,0,0,0,0,12,6,19,10,1,0
"20220222PARMOR",2022-02-22,"Scotland Championship","Partick","Morton",0,1,"A",16,5,6,2,9,10,9,1,1,1,0,0,0,0,0,1,21,8,19,10,2,0
"20220225HAMINV",2022-02-25,"Scotland Championship","Hamilton","Inverness C",1,1,"D",9,5,4,7,12,18,4,4,1,2,0,0,0,0,0,2,14,11,30,8,3,0
"20220226AYRQUE",2022-02-26,"Scotland Championship","Ayr","Queen of Sth",0,1,"A",10,7,2,2,11,12,9,4,2,3,0,0,0,0,0,1,17,4,23,13,5,0
"20220226DUNKIL",2022-02-26,"Scotland Championship","Dunfermline","Kilmarnock",0,0,"D",3,8,0,3,11,16,1,5,3,1,0,0,0,0,0,0,11,3,27,6,4,0
"20220226MORARB",2022-02-26,"Scotland Championship","Morton","Arbroath",0,0,"D",11,5,1,1,17,11,5,4,0,2,0,0,0,0,0,0,16,2,28,9,2,0
"20220226RAIPAR",2022-02-26,"Scotland Championship","Raith Rvs","Partick",0,0,"D",10,4,4,3,10,9,9,2,0,3,0,0,0,0,0,0,14,7,19,11,3,0
"20220301ARBPAR",2022-03-01,"Scotland Championship","Arbroath","Partick",1,1,"D",9,7,2,1,14,11,7,2,3,2,0,0,0,0,0,2,16,3,25,9,5,0
"20220304PARINV",2022-03-04,"Scotland Championship","Partick","Inverness C",1,0,"H",15,19,3,1,8,7,2,4,0,0,0,0,0,0,0,1,34,4,15,6,0,0
"20220305ARBDUN",2022-03-05,"Scotland Championship","Arbroath","Dunfermline",1,0,"H",8,6,4,3,13,9,3,3,2,1,0,0,0,0,0,1,14,7,22,6,3,0
"20220305KILHAM",2022-03-05,"Scotland Championship","Kilmarnock","Hamilton",2,0,"H",16,5,8,4,12,12,4,1,0,3,0,0,0,0,0,2,21,12,24,5,3,0
"20220305QUEMOR",2022-03-05,"Scotland Championship","Queen of Sth","Morton",3,0,"H",12,5,6,0,7,10,6,4,1,3,0,0,0,0,0,3,17,6,17,10,4,0
"20220305RAIAYR",2022-03-05,"Scotland Championship","Raith Rvs","Ayr",0,4,"A",6,9,0,6,15,15,3,3,0,1,0,0,0,0,0,4,15,6,30,6,1,0
"20220308PARQUE",2022-03-08,"Scotland Championship","Partick","Queen of Sth",1,0,"H",13,6,5,2,5,10,3,2,1,2,0,0,0,0,0,1,19,7,15,5,3,0
"20220311AYRKIL",2022-03-11,"Scotland Championship","Ayr","Kilmarnock",1,3,"A",6,11,2,6,12,11,5,8,0,2,1,0,0,0,0,4,17,8,23,13,2,1
"20220312HAMDUN",2022-03-12,"Scotland Championship","Hamilton","Dunfermline",2,2,"D",8,8,2,5,8,8,4,2,2,2,0,0,0,0,0,4,16,7,16,6,4,0
"20220312INVARB",2022-03-12,"Scotland Championship","Inverness C","Arbroath",3,0,"H",5,6,3,2,13,10,3,3,2,3,0,0,0,0,0,3,11,5,23,6,5,0
"20220312MORPAR",2022-03-12,"Scotland Championship","Morton","Partick",2,1,"H",11,10,6,3,12,6,7,7,2,1,0,0,0,0,0,3,21,9,18,14,3,0
"20220312QUERAI",2022-03-12,"Scotland Championship","Queen of Sth","Raith Rvs",0,1,"A",6,7,2,4,10,7,3,4,0,0,0,0,0,0,0,1,13,6,17,7,0,0
"20220318DUNMOR",2022-03-18,"Scotland Championship","Dunfermline","Morton",1,1,"D",25,8,4,2,8,14,13,2,0,1,0,0,0,0,0,2,33,6,22,15,1,0
"20220319ARBAYR",2022-03-19,"Scotland Championship","Arbroath","Ayr",1,0,"H",9,9,4,1,10,14,7,4,3,1,0,1,0,0,0,1,18,5,24,11,4,1
"20220319KILQUE",2022-03-19,"Scotland Championship","Kilmarnock","Queen of Sth",2,1,"H",18,6,9,4,9,9,6,1,1,1,0,0,0,0,0,3,24,13,18,7,2,0
"20220319PARHAM",2022-03-19,"Scotland Championship","Partick","Hamilton",0,4,"A",3,14,0,7,7,10,2,3,3,2,0,0,0,0,0,4,17,7,17,5,5,0
"20220319RAIINV",2022-03-19,"Scotland Championship","Raith Rvs","Inverness C",2,3,"A",7,6,4,5,6,10,6,3,2,4,2,0,0,0,0,5,13,9,16,9,6,2
"20220322DUNPAR",2022-03-22,"Scotland Championship","Dunfermline","Partick",4,1,"H",11,8,3,6,7,8,3,7,1,2,0,0,0,0,0,5,19,9,15,10,3,0
"20220326ARBRAI",2022-03-26,"Scotland Championship","Arbroath","Raith Rvs",3,3,"D",11,5,5,4,8,9,8,1,4,1,0,0,0,0,0,6,16,9,17,9,5,0
"20220326HAMQUE",2022-03-26,"Scotland Championship","Hamilton","Queen of Sth",1,0,"H",12,4,5,1,8,10,13,6,1,1,0,1,0,0,0,1,16,6,18,19,2,1
"20220326INVDUN",2022-03-26,"Scotland Championship","Inverness C","Dunfermline",2,0,"H",14,7,4,3,7,10,7,3,1,2,0,0,0,0,0,2,21,7,17,10,3,0
"20220326KILPAR",2022-03-26,"Scotland Championship","Kilmarnock","Partick",2,1,"H",12,6,2,3,9,13,2,7,0,3,0,0,0,0,0,3,18,5,22,9,3,0
"20220326MORAYR",2022-03-26,"Scotland Championship","Morton","Ayr",1,1,"D",10,11,3,5,13,18,5,9,1,1,0,0,0,0,0,2,21,8,31,14,2,0
"20220401AYRHAM",2022-04-01,"Scotland Championship","Ayr","Hamilton",1,1,"D",13,6,6,4,5,8,6,8,2,4,0,0,0,0,0,2,19,10,13,14,6,0
"20220401MORKIL",2022-04-01,"Scotland Championship","Morton","Kilmarnock",1,1,"D",14,10,3,2,13,10,8,2,0,1,0,0,0,0,0,2,24,5,23,10,1,0
"20220402PARARB",2022-04-02,"Scotland Championship","Partick","Arbroath",0,0,"D",9,7,5,2,10,7,3,2,0,0,0,0,0,0,0,0,16,7,17,5,0,0
"20220406DUNRAI",2022-04-06,"Scotland Championship","Dunfermline","Raith Rvs",2,0,"H",11,5,6,2,10,16,5,1,1,1,0,0,0,0,0,2,16,8,26,6,2,0
"20220408QUEPAR",2022-04-08,"Scotland Championship","Queen of Sth","Partick",0,1,"A",14,4,1,1,12,10,3,3,1,4,0,0,0,0,0,1,18,2,22,6,5,0
"20220409AYRINV",2022-04-09,"Scotland Championship","Ayr","Inverness C",2,2,"D",8,6,5,2,5,12,5,5,1,0,0,0,0,0,0,4,14,7,17,10,1,0
"20220409HAMARB",2022-04-09,"Scotland Championship","Hamilton","Arbroath",0,1,"A",6,6,1,2,7,15,5,1,3,3,0,0,0,0,0,1,12,3,22,6,6,0
"20220409KILDUN",2022-04-09,"Scotland Championship","Kilmarnock","Dunfermline",2,0,"H",23,4,11,3,15,14,12,3,2,1,0,0,0,0,0,2,27,14,29,15,3,0
"20220409RAIMOR",2022-04-09,"Scotland Championship","Raith Rvs","Morton",0,1,"A",13,8,4,3,9,9,5,8,1,2,0,0,0,0,0,1,21,7,18,13,3,0
"20220415INVKIL",2022-04-15,"Scotland Championship","Inverness C","Kilmarnock",2,1,"H",11,9,4,3,14,8,5,7,1,0,0,0,0,0,0,3,20,7,22,12,1,0
"20220416ARBQUE",2022-04-16,"Scotland Championship","Arbroath","Queen of Sth",5,1,"H",9,12,6,6,9,7,5,6,2,0,0,0,0,0,0,6,21,12,16,11,2,0
"20220416DUNAYR",2022-04-16,"Scotland Championship","Dunfermline","Ayr",2,1,"H",6,9,3,2,6,6,4,4,3,1,0,0,0,0,0,3,15,5,12,8,4,0
"20220416MORHAM",2022-04-16,"Scotland Championship","Morton","Hamilton",0,1,"A",9,10,2,5,14,8,3,4,4,2,0,0,0,0,0,1,19,7,22,7,6,0
"20220416PARRAI",2022-04-16,"Scotland Championship","Partick","Raith Rvs",0,1,"A",10,9,5,3,12,13,6,5,2,2,0,0,0,0,0,1,19,8,25,11,4,0
"20220419QUEINV",2022-04-19,"Scotland Championship","Queen of Sth","Inverness C",2,1,"H",9,9,3,3,10,12,2,4,2,0,0,0,0,0,0,3,18,6,22,6,2,0
"20220422KILARB",2022-04-22,"Scotland Championship","Kilmarnock","Arbroath",2,1,"H",20,5,10,1,11,12,11,4,4,1,0,0,0,0,0,3,25,11,23,15,5,0
"20220423HAMRAI",2022-04-23,"Scotland Championship","Hamilton","Raith Rvs",0,2,"A",6,8,0,5,12,13,4,4,1,3,0,0,0,0,0,2,14,5,25,8,4,0
"20220423MORINV",2022-04-23,"Scotland Championship","Morton","Inverness C",0,1,"A",8,9,3,4,11,14,6,7,1,3,0,0,0,0,0,1,17,7,25,13,4,0
"20220423PARDUN",2022-04-23,"Scotland Championship","Partick","Dunfermline",1,0,"H",8,3,4,1,9,14,1,5,0,1,0,0,0,0,0,1,11,5,23,6,1,0
"20220423QUEAYR",2022-04-23,"Scotland Championship","Queen of Sth","Ayr",1,1,"D",11,9,2,3,7,11,3,7,1,3,0,0,0,0,0,2,20,5,18,10,4,0
"20220429ARBMOR",2022-04-29,"Scotland Championship","Arbroath","Morton",3,0,"H",16,4,7,1,7,12,11,0,0,0,0,0,0,0,0,3,20,8,19,11,0,0
"20220429AYRPAR",2022-04-29,"Scotland Championship","Ayr","Partick",3,1,"H",7,5,4,2,7,9,5,2,0,2,0,0,0,0,0,4,12,6,16,7,2,0
"20220429DUNQUE",2022-04-29,"Scotland Championship","Dunfermline","Queen of Sth",1,2,"A",14,9,4,5,10,10,8,4,1,2,0,0,0,0,0,3,23,9,20,12,3,0
"20220429INVHAM",2022-04-29,"Scotland Championship","Inverness C","Hamilton",4,0,"H",10,7,8,2,11,7,3,6,0,2,0,0,0,0,0,4,17,10,18,9,2,0
"20220429RAIKIL",2022-04-29,"Scotland Championship","Raith Rvs","Kilmarnock",1,1,"D",19,10,8,4,8,10,8,3,2,1,0,0,0,0,0,2,29,12,18,11,3,0
"20220730AYRARB",2022-07-30,"Scotland Championship","Ayr","Arbroath",0,0,"D",14,8,5,2,12,18,4,5,0,5,1,0,0,0,0,0,22,7,30,9,5,1
"20220730COVRAI",2022-07-30,"Scotland Championship","Cove Rangers","Raith Rvs",2,0,"H",9,14,4,5,14,10,7,6,4,2,0,0,0,0,0,2,23,9,24,13,6,0
"20220730DUNPAR",2022-07-30,"Scotland Championship","Dundee","Partick",2,3,"A",13,10,7,5,12,17,10,2,1,2,0,0,0,0,0,5,23,12,29,12,3,0
"20220730HAMMOR",2022-07-30,"Scotland Championship","Hamilton","Morton",1,1,"D",7,15,3,4,13,11,6,5,4,4,1,0,0,0,0,2,22,7,24,11,8,1
"20220730INVQUE",2022-07-30,"Scotland Championship","Inverness C","Queens Park",1,1,"D",17,16,8,5,8,9,10,4,0,1,0,0,0,0,0,2,33,13,17,14,1,0
"20220805QUEAYR",2022-08-05,"Scotland Championship","Queens Park","Ayr",2,3,"A",7,17,4,11,8,6,6,10,2,0,0,0,0,0,0,5,24,15,14,16,2,0
"20220806ARBINV",2022-08-06,"Scotland Championship","Arbroath","Inverness C",0,0,"D",12,4,6,2,11,11,6,1,1,2,0,0,0,0,0,0,16,8,22,7,3,0
"20220806MORCOV",2022-08-06,"Scotland Championship","Morton","Cove Rangers",1,0,"H",7,8,3,3,13,12,0,6,3,4,0,0,0,0,0,1,15,6,25,6,7,0
"20220806PARHAM",2022-08-06,"Scotland Championship","Partick","Hamilton",1,1,"D",14,8,9,2,6,14,8,2,1,2,0,0,0,0,0,2,22,11,20,10,3,0
"20220806RAIDUN",2022-08-06,"Scotland Championship","Raith Rvs","Dundee",0,1,"A",7,10,4,5,12,9,4,3,2,4,0,0,0,0,0,1,17,9,21,7,6,0
"20220812DUNARB",2022-08-12,"Scotland Championship","Dundee","Arbroath",4,2,"H",10,6,7,2,3,13,11,8,1,2,0,0,0,0,0,6,16,9,16,19,3,0
"20220813AYRHAM",2022-08-13,"Scotland Championship","Ayr","Hamilton",2,2,"D",18,6,9,4,7,7,5,4,1,1,0,0,0,0,0,4,24,13,14,9,2,0
"20220813INVCOV",2022-08-13,"Scotland Championship","Inverness C","Cove Rangers",4,1,"H",15,4,10,3,8,13,4,2,2,4,0,0,0,0,0,5,19,13,21,6,6,0
"20220813QUEPAR",2022-08-13,"Scotland Championship","Queens Park","Partick",3,2,"H",11,15,7,5,10,11,6,8,3,0,0,0,0,0,0,5,26,12,21,14,3,0
"20220813RAIMOR",2022-08-13,"Scotland Championship","Raith Rvs","Morton",2,1,"H",5,7,4,3,9,20,2,3,4,4,0,0,0,0,0,3,12,7,29,5,8,0
"20220819PARINV",2022-08-19,"Scotland Championship","Partick","Inverness C",4,1,"H",13,11,8,4,7,11,4,8,1,2,0,0,0,0,0,5,24,12,18,12,3,0
"20220820ARBQUE",2022-08-20,"Scotland Championship","Arbroath","Queens Park",1,2,"A",10,14,4,8,16,4,6,6,2,1,0,0,0,0,0,3,24,12,20,12,3,0
"20220820COVAYR",2022-08-20,"Scotland Championship","Cove Rangers","Ayr",1,2,"A",6,21,4,8,10,8,3,3,0,0,0,0,0,0,0,3,27,12,18,6,0,0
"20220820HAMRAI",2022-08-20,"Scotland Championship","Hamilton","Raith Rvs",0,2,"A",6,14,3,7,10,16,5,4,0,2,0,0,0,0,0,2,20,10,26,9,2,0
"20220820MORDUN",2022-08-20,"Scotland Championship","Morton","Dundee",0,0,"D",5,2,3,0,9,7,5,8,2,1,0,0,0,0,0,0,7,3,16,13,3,0
"20220826AYRDUN",2022-08-26,"Scotland Championship","Ayr","Dundee",3,1,"H",12,10,6,7,11,8,4,3,1,0,0,1,0,0,0,4,22,13,19,7,1,1
"20220827HAMARB",2022-08-27,"Scotland Championship","Hamilton","Arbroath",1,0,"H",11,3,4,1,14,5,7,7,2,3,0,1,0,0,0,1,14,5,19,14,5,1
"20220827INVMOR",2022-08-27,"Scotland Championship","Inverness C","Morton",0,1,"A",9,4,3,3,13,12,6,5,3,3,0,0,0,0,0,1,13,6,25,11,6,0
"20220827PARRAI",2022-08-27,"Scotland Championship","Partick","Raith Rvs",2,1,"H",7,5,5,2,3,5,6,2,0,1,0,0,0,0,0,3,12,7,8,8,1,0
"20220827QUECOV",2022-08-27,"Scotland Championship","Queens Park","Cove Rangers",2,1,"H",20,12,9,5,7,6,6,5,1,1,0,0,0,0,0,3,32,14,13,11,2,0
"20220903ARBPAR",2022-09-03,"Scotland Championship","Arbroath","Partick",0,2,"A",1,7,0,5,8,4,2,11,3,2,1,0,0,0,0,2,8,5,12,13,5,1
"20220903COVHAM",2022-09-03,"Scotland Championship","Cove Rangers","Hamilton",2,2,"D",5,9,2,4,12,11,3,3,1,1,0,0,0,0,0,4,14,6,23,6,2,0
"20220903DUNQUE",2022-09-03,"Scotland Championship","Dundee","Queens Park",3,0,"H",16,14,7,6,13,5,7,6,2,1,0,0,0,0,0,3,30,13,18,13,3,0
"20220903MORAYR",2022-09-03,"Scotland Championship","Morton","Ayr",1,2,"A",11,14,5,4,11,16,9,5,2,4,0,0,1,0,1,3,25,9,27,14,6,0
"20220903RAIINV",2022-09-03,"Scotland Championship","Raith Rvs","Inverness C",0,2,"A",6,8,3,3,13,10,2,3,2,1,0,0,0,0,0,2,14,6,23,5,3,0
"20220917DUNINV",2022-09-17,"Scotland Championship","Dundee","Inverness C",2,3,"A",7,7,5,4,14,12,12,8,2,1,1,0,1,0,1,5,14,9,26,20,3,1
"20220917HAMQUE",2022-09-17,"Scotland Championship","Hamilton","Queens Park",0,2,"A",13,12,6,4,9,14,15,2,1,1,0,0,0,0,0,2,25,10,23,17,2,0
"20220917MORARB",2022-09-17,"Scotland Championship","Morton","Arbroath",1,2,"A",11,3,5,2,12,11,1,5,2,2,1,0,0,0,0,3,14,7,23,6,4,1
"20220917PARCOV",2022-09-17,"Scotland Championship","Partick","Cove Rangers",2,2,"D",15,7,7,4,11,11,4,6,2,3,0,0,0,0,0,4,22,11,22,10,5,0
"20220917RAIAYR",2022-09-17,"Scotland Championship","Raith Rvs","Ayr",3,2,"H",8,8,5,4,5,16,1,4,2,3,0,0,0,0,0,5,16,9,21,5,5,0
"20221001AYRINV",2022-10-01,"Scotland Championship","Ayr","Inverness C",0,1,"A",14,4,2,3,8,5,20,3,1,1,0,0,0,0,0,1,18,5,13,23,2,0
"20221001COVARB",2022-10-01,"Scotland Championship","Cove Rangers","Arbroath",2,0,"H",4,2,4,1,2,4,3,7,0,1,0,0,0,0,0,2,6,5,6,10,1,0
"20221001HAMDUN",2022-10-01,"Scotland Championship","Hamilton","Dundee",0,2,"A",7,11,2,3,11,11,7,1,1,0,0,0,0,0,0,2,18,5,22,8,1,0
"20221001PARMOR",2022-10-01,"Scotland Championship","Partick","Morton",5,1,"H",17,6,10,1,10,11,8,2,2,2,0,0,0,0,0,6,23,11,21,10,4,0
"20221001QUERAI",2022-10-01,"Scotland Championship","Queens Park","Raith Rvs",1,0,"H",17,14,4,5,9,9,13,2,3,1,0,0,0,0,0,1,31,9,18,15,4,0
"20221004COVDUN",2022-10-04,"Scotland Championship","Cove Rangers","Dundee",3,1,"H",8,9,5,4,11,19,6,7,1,2,0,0,0,0,0,4,17,9,30,13,3,0
"20221004QUEMOR",2022-10-04,"Scotland Championship","Queens Park","Morton",1,2,"A",14,16,5,8,14,10,6,8,1,4,0,0,1,0,1,3,30,13,24,14,5,0
"20221007INVPAR",2022-10-07,"Scotland Championship","Inverness C","Partick",1,0,"H",15,6,4,2,12,12,4,0,1,3,0,1,0,0,0,1,21,6,24,4,4,1
"20221008ARBDUN",2022-10-08,"Scotland Championship","Arbroath","Dundee",1,1,"D",5,4,3,2,7,7,6,3,3,4,0,0,0,0,0,2,9,5,14,9,7,0
"20221008AYRQUE",2022-10-08,"Scotland Championship","Ayr","Queens Park",5,0,"H",11,16,6,5,9,6,5,10,1,0,0,0,0,0,0,5,27,11,15,15,1,0
"20221008MORHAM",2022-10-08,"Scotland Championship","Morton","Hamilton",5,0,"H",13,9,8,1,18,19,7,4,4,4,0,0,0,0,0,5,22,9,37,11,8,0
"20221008RAICOV",2022-10-08,"Scotland Championship","Raith Rvs","Cove Rangers",3,0,"H",8,3,6,0,9,9,8,4,2,2,0,0,0,0,0,3,11,6,18,12,4,0
"20221014QUEARB",2022-10-14,"Scotland Championship","Queens Park","Arbroath",1,1,"D",9,11,5,6,8,8,5,7,0,3,0,0,0,0,0,2,20,11,16,12,3,0
"20221015COVINV",2022-10-15,"Scotland Championship","Cove Rangers","Inverness C",0,1,"A",5,8,3,3,5,15,6,2,3,5,1,0,2,0,2,1,13,6,20,8,8,1
"20221015DUNAYR",2022-10-15,"Scotland Championship","Dundee","Ayr",2,1,"H",5,4,3,2,1,4,6,8,1,1,0,0,0,0,0,3,9,5,5,14,2,0
"20221015HAMPAR",2022-10-15,"Scotland Championship","Hamilton","Partick",1,2,"A",13,15,5,4,21,10,10,3,2,2,0,0,0,0,0,3,28,9,31,13,4,0
"20221015MORRAI",2022-10-15,"Scotland Championship","Morton","Raith Rvs",1,0,"H",11,10,2,3,9,15,5,6,3,3,0,0,0,0,0,1,21,5,24,11,6,0
"20221018INVHAM",2022-10-18,"Scotland Championship","Inverness C","Hamilton",0,1,"A",7,10,2,3,10,12,6,9,1,2,0,0,0,0,0,1,17,5,22,15,3,0
"20221019ARBRAI",2022-10-19,"Scotland Championship","Arbroath","Raith Rvs",0,1,"A",8,12,3,5,11,12,10,2,3,1,0,0,0,0,0,1,20,8,23,12,4,0
"20221022ARBHAM",2022-10-22,"Scotland Championship","Arbroath","Hamilton",1,0,"H",6,10,1,4,14,12,7,6,3,2,0,1,0,0,0,1,16,5,26,13,5,1
"20221022AYRCOV",2022-10-22,"Scotland Championship","Ayr","Cove Rangers",2,2,"D",24,6,11,5,9,12,9,6,0,3,0,0,0,0,0,4,30,16,21,15,3,0
"20221022DUNMOR",2022-10-22,"Scotland Championship","Dundee","Morton",0,0,"D",12,7,4,2,14,8,7,11,1,4,1,0,0,0,0,0,19,6,22,18,5,1
"20221022INVRAI",2022-10-22,"Scotland Championship","Inverness C","Raith Rvs",1,1,"D",3,13,2,7,13,10,3,13,1,0,0,0,0,0,0,2,16,9,23,16,1,0
"20221022PARQUE",2022-10-22,"Scotland Championship","Partick","Queens Park",0,4,"A",12,13,3,8,7,8,9,4,1,4,0,0,0,0,0,4,25,11,15,13,5,0
"20221025AYRPAR",2022-10-25,"Scotland Championship","Ayr","Partick",4,2,"H",11,12,5,4,12,4,1,9,3,0,0,0,0,0,0,6,23,9,16,10,3,0
"20221028MORINV",2022-10-28,"Scotland Championship","Morton","Inverness C",4,0,"H",6,11,5,2,14,10,2,4,2,1,0,0,0,0,0,4,17,7,24,6,3,0
"20221028QUEDUN",2022-10-28,"Scotland Championship","Queens Park","Dundee",2,2,"D",11,14,6,4,14,14,7,6,1,2,1,0,0,0,0,4,25,10,28,13,3,1
"20221029ARBAYR",2022-10-29,"Scotland Championship","Arbroath","Ayr",0,2,"A",11,12,2,4,3,8,4,5,1,1,0,0,0,0,0,2,23,6,11,9,2,0
"20221029HAMCOV",2022-10-29,"Scotland Championship","Hamilton","Cove Rangers",4,4,"D",9,14,6,10,9,11,8,5,3,5,0,0,1,0,1,8,23,16,20,13,8,0
"20221029RAIPAR",2022-10-29,"Scotland Championship","Raith Rvs","Partick",3,0,"H",8,6,6,3,9,10,2,9,2,3,0,0,0,0,0,3,14,9,19,11,5,0
"20221104COVQUE",2022-11-04,"Scotland Championship","Cove Rangers","Queens Park",2,0,"H",13,14,4,4,14,10,5,8,2,2,0,0,1,0,1,2,27,8,24,13,4,0
"20221105AYRMOR",2022-11-05,"Scotland Championship","Ayr","Morton",1,1,"D",9,8,4,2,17,9,6,4,3,3,0,0,0,0,0,2,17,6,26,10,6,0
"20221105INVARB",2022-11-05,"Scotland Championship","Inverness C","Arbroath",1,1,"D",14,7,9,5,13,5,6,6,2,0,0,0,0,0,0,2,21,14,18,12,2,0
"20221105PARDUN",2022-11-05,"Scotland Championship","Partick","Dundee",2,3,"A",2,10,2,4,10,7,4,5,0,1,1,0,0,0,0,5,12,6,17,9,1,1
"20221105RAIHAM",2022-11-05,"Scotland Championship","Raith Rvs","Hamilton",3,1,"H",18,3,6,2,14,11,5,5,3,4,0,0,0,0,0,4,21,8,25,10,7,0
"20221111HAMAYR",2022-11-11,"Scotland Championship","Hamilton","Ayr",2,3,"A",15,6,7,5,9,11,6,4,3,4,0,0,0,0,0,5,21,12,20,10,7,0
"20221112ARBCOV",2022-11-12,"Scotland Championship","Arbroath","Cove Rangers",1,1,"D",9,12,2,5,11,9,1,2,4,1,0,0,0,0,0,2,21,7,20,3,5,0
"20221112DUNRAI",2022-11-12,"Scotland Championship","Dundee","Raith Rvs",2,0,"H",15,6,7,1,6,10,4,4,1,2,0,0,0,0,0,2,21,8,16,8,3,0
"20221112MORPAR",2022-11-12,"Scotland Championship","Morton","Partick",2,1,"H",9,10,4,3,18,9,7,9,1,0,0,1,0,0,0,3,19,7,27,16,1,1
"20221112QUEINV",2022-11-12,"Scotland Championship","Queens Park","Inverness C",2,1,"H",10,5,5,2,1,2,18,3,0,0,0,0,1,1,0,3,15,7,3,21,0,0
"20221119COVMOR",2022-11-19,"Scotland Championship","Cove Rangers","Morton",1,2,"A",8,7,4,3,11,10,3,3,2,2,0,0,0,0,0,3,15,7,21,6,4,0
"20221119DUNHAM",2022-11-19,"Scotland Championship","Dundee","Hamilton",1,0,"H",10,9,4,4,10,12,8,2,1,2,0,0,0,0,0,1,19,8,22,10,3,0
"20221119INVAYR",2022-11-19,"Scotland Championship","Inverness C","Ayr",2,2,"D",10,12,2,8,8,8,4,4,0,1,0,0,0,0,0,4,22,10,16,8,1,0
"20221119PARARB",2022-11-19,"Scotland Championship","Partick","Arbroath",3,0,"H",9,11,4,3,9,12,5,2,0,3,0,0,1,0,1,3,20,7,21,7,3,0
"20221119RAIQUE",2022-11-19,"Scotland Championship","Raith Rvs","Queens Park",2,5,"A",20,10,13,5,10,4,5,0,2,1,0,0,0,0,0,7,30,18,14,5,3,0
"20221203ARBMOR",2022-12-03,"Scotland Championship","Arbroath","Morton",1,1,"D",10,14,3,2,3,11,5,5,0,2,0,0,0,0,0,2,24,5,14,10,2,0
"20221203AYRRAI",2022-12-03,"Scotland Championship","Ayr","Raith Rvs",2,0,"H",12,11,6,2,12,5,5,8,1,0,0,0,0,0,0,2,23,8,17,13,1,0
"20221203COVPAR",2022-12-03,"Scotland Championship","Cove Rangers","Partick",1,1,"D",8,5,6,3,9,10,3,5,1,1,0,0,0,0,0,2,13,9,19,8,2,0
"20221203INVDUN",2022-12-03,"Scotland Championship","Inverness C","Dundee",0,1,"A",10,6,1,4,15,14,4,3,1,2,0,0,0,0,0,1,16,5,29,7,3,0
"20221203QUEHAM",2022-12-03,"Scotland Championship","Queens Park","Hamilton",4,0,"H",10,13,7,5,7,8,4,8,0,0,0,0,0,0,0,4,23,12,15,12,0,0
"20221217PARAYR",2022-12-17,"Scotland Championship","Partick","Ayr",3,2,"H",13,8,8,5,7,11,7,0,4,3,0,0,0,0,0,5,21,13,18,7,7,0
"20221217RAIARB",2022-12-17,"Scotland Championship","Raith Rvs","Arbroath",1,1,"D",3,3,2,3,6,5,4,5,1,2,0,0,0,0,0,2,6,5,11,9,3,0
"20221223ARBQUE",2022-12-23,"Scotland Championship","Arbroath","Queens Park",1,4,"A",8,21,2,6,12,6,6,5,4,2,0,0,0,0,0,5,29,8,18,11,6,0
"20221223AYRDUN",2022-12-23,"Scotland Championship","Ayr","Dundee",0,2,"A",6,9,2,5,18,13,5,7,5,1,1,1,0,0,0,2,15,7,31,12,6,2
"20221223COVHAM",2022-12-23,"Scotland Championship","Cove Rangers","Hamilton",2,0,"H",7,9,3,5,16,17,9,5,5,2,0,0,0,0,0,2,16,8,33,14,7,0
"20221223PARINV",2022-12-23,"Scotland Championship","Partick","Inverness C",5,1,"H",16,3,7,2,8,9,5,2,0,0,0,1,0,0,0,6,19,9,17,7,0,1
"20221223RAIMOR",2022-12-23,"Scotland Championship","Raith Rvs","Morton",2,2,"D",8,7,5,3,13,7,6,6,2,1,0,0,0,0,0,4,15,8,20,12,3,0
"20230102DUNARB",2023-01-02,"Scotland Championship","Dundee","Arbroath",2,4,"A",5,8,3,5,13,14,6,7,1,2,1,0,0,0,0,6,13,8,27,13,3,1
"20230102HAMRAI",2023-01-02,"Scotland Championship","Hamilton","Raith Rvs",0,1,"A",6,13,2,6,14,11,1,6,1,3,0,0,0,0,0,1,19,8,25,7,4,0
"20230102INVCOV",2023-01-02,"Scotland Championship","Inverness C","Cove Rangers",6,1,"H",12,10,6,4,8,17,2,11,0,3,0,0,0,0,0,7,22,10,25,13,3,0
"20230102QUEPAR",2023-01-02,"Scotland Championship","Queens Park","Partick",2,0,"H",12,16,5,4,3,11,4,7,1,4,0,0,0,0,0,2,28,9,14,11,5,0
"20230106RAIDUN",2023-01-06,"Scotland Championship","Raith Rvs","Dundee",1,1,"D",4,12,2,3,11,12,4,6,3,2,0,0,0,0,0,2,16,5,23,10,5,0
"20230107ARBINV",2023-01-07,"Scotland Championship","Arbroath","Inverness C",1,4,"A",5,9,1,6,16,16,3,4,2,3,0,0,0,0,0,5,14,7,32,7,5,0
"20230107AYRHAM",2023-01-07,"Scotland Championship","Ayr","Hamilton",1,0,"H",10,4,5,1,15,12,3,5,0,2,0,0,0,0,0,1,14,6,27,8,2,0
"20230107COVQUE",2023-01-07,"Scotland Championship","Cove Rangers","Queens Park",0,6,"A",7,14,2,10,6,11,2,7,3,1,0,0,0,0,0,6,21,12,17,9,4,0
"20230107PARMOR",2023-01-07,"Scotland Championship","Partick","Morton",2,1,"H",7,4,4,2,7,19,8,4,3,2,0,0,0,0,0,3,11,6,26,12,5,0
"20230114AYRARB",2023-01-14,"Scotland Championship","Ayr","Arbroath",2,2,"D",9,11,5,4,11,7,11,5,2,2,0,0,0,0,0,4,20,9,18,16,4,0
"20230114COVRAI",2023-01-14,"Scotland Championship","Cove Rangers","Raith Rvs",2,2,"D",5,9,4,4,5,8,5,1,1,2,0,0,0,0,0,4,14,8,13,6,3,0
"20230114HAMMOR",2023-01-14,"Scotland Championship","Hamilton","Morton",1,0,"H",8,18,6,4,8,12,4,16,1,2,0,1,0,0,0,1,26,10,20,20,3,1
"20230114INVQUE",2023-01-14,"Scotland Championship","Inverness C","Queens Park",0,0,"D",11,8,7,5,8,4,4,8,2,1,0,0,0,0,0,0,19,12,12,12,3,0
"20230127COVAYR",2023-01-27,"Scotland Championship","Cove Rangers","Ayr",0,5,"A",5,12,3,7,5,9,2,4,1,0,0,0,0,0,0,5,17,10,14,6,1,0
"20230128DUNQUE",2023-01-28,"Scotland Championship","Dundee","Queens Park",3,0,"H",13,4,7,0,10,10,6,4,1,0,0,0,0,0,0,3,17,7,20,10,1,0
"20230128MORARB",2023-01-28,"Scotland Championship","Morton","Arbroath",1,2,"A",6,13,3,6,18,11,4,2,3,2,0,0,0,0,0,3,19,9,29,6,5,0
"20230128PARHAM",2023-01-28,"Scotland Championship","Partick","Hamilton",0,1,"A",9,4,2,2,10,9,7,3,1,1,0,0,0,0,0,1,13,4,19,10,2,0
"20230128RAIINV",2023-01-28,"Scotland Championship","Raith Rvs","Inverness C",2,2,"D",6,3,4,3,8,9,9,0,1,3,0,0,0,0,0,4,9,7,17,9,4,0
"20230203QUEAYR",2023-02-03,"Scotland Championship","Queens Park","Ayr",2,0,"H",7,7,3,3,9,8,9,3,3,0,0,0,0,0,0,2,14,6,17,12,3,0
"20230204ARBRAI",2023-02-04,"Scotland Championship","Arbroath","Raith Rvs",1,2,"A",7,9,2,2,16,8,7,6,4,1,0,0,0,0,0,3,16,4,24,13,5,0
"20230204HAMDUN",2023-02-04,"Scotland Championship","Hamilton","Dundee",1,1,"D",5,13,2,5,16,12,3,8,5,2,0,0,0,0,0,2,18,7,28,11,7,0
"20230204INVMOR",2023-02-04,"Scotland Championship","Inverness C","Morton",2,2,"D",12,16,5,8,10,10,5,3,2,3,0,0,1,0,1,4,28,13,20,8,5,0
"20230204PARCOV",2023-02-04,"Scotland Championship","Partick","Cove Rangers",0,1,"A",12,5,6,3,11,12,9,3,3,3,1,0,0,0,0,1,17,9,23,12,6,1
"20230211MORQUE",2023-02-11,"Scotland Championship","Morton","Queens Park",3,2,"H",15,11,8,5,14,8,6,12,3,2,0,0,0,0,0,5,26,13,22,18,5,0
"20230212DUNCOV",2023-02-12,"Scotland Championship","Dundee","Cove Rangers",3,0,"H",15,2,8,2,7,17,15,1,0,4,0,0,0,0,0,3,17,10,24,16,4,0
"20230217MORDUN",2023-02-17,"Scotland Championship","Morton","Dundee",1,0,"H",10,14,4,4,18,12,12,3,4,3,0,0,0,0,0,1,24,8,30,15,7,0
"20230217QUERAI",2023-02-17,"Scotland Championship","Queens Park","Raith Rvs",1,1,"D",7,16,3,9,6,8,4,3,2,3,0,0,0,0,0,2,23,12,14,7,5,0
"20230218AYRPAR",2023-02-18,"Scotland Championship","Ayr","Partick",0,1,"A",7,6,1,2,12,13,3,3,1,1,0,0,0,0,0,1,13,3,25,6,2,0
"20230218COVARB",2023-02-18,"Scotland Championship","Cove Rangers","Arbroath",1,1,"D",11,12,3,6,14,13,4,4,0,4,0,0,0,0,0,2,23,9,27,8,4,0
"20230218INVHAM",2023-02-18,"Scotland Championship","Inverness C","Hamilton",0,3,"A",8,9,4,6,8,6,6,5,2,2,0,0,0,0,0,3,17,10,14,11,4,0
"20230221HAMINV",2023-02-21,"Scotland Championship","Hamilton","Inverness C",2,1,"H",11,20,6,2,7,8,5,10,1,2,0,1,0,0,0,3,31,8,15,15,3,1
"20230224RAIAYR",2023-02-24,"Scotland Championship","Raith Rvs","Ayr",0,0,"D",12,12,2,4,7,7,5,6,2,1,0,0,0,0,0,0,24,6,14,11,3,0
"20230225ARBPAR",2023-02-25,"Scotland Championship","Arbroath","Partick",0,0,"D",10,4,6,2,19,7,4,7,1,2,0,0,0,0,0,0,14,8,26,11,3,0
"20230225DUNINV",2023-02-25,"Scotland Championship","Dundee","Inverness C",1,1,"D",7,8,4,5,9,14,11,2,0,5,0,0,0,0,0,2,15,9,23,13,5,0
"20230225HAMQUE",2023-02-25,"Scotland Championship","Hamilton","Queens Park",1,4,"A",9,14,5,8,9,10,6,4,1,0,0,0,0,0,0,5,23,13,19,10,1,0
"20230225MORCOV",2023-02-25,"Scotland Championship","Morton","Cove Rangers",2,1,"H",13,8,4,2,13,14,8,3,3,2,0,0,0,0,0,3,21,6,27,11,5,0
"20230228DUNPAR",2023-02-28,"Scotland Championship","Dundee","Partick",1,3,"A",5,8,2,5,11,9,7,6,0,4,0,0,0,0,0,4,13,7,20,13,4,0
"20230303HAMARB",2023-03-03,"Scotland Championship","Hamilton","Arbroath",0,0,"D",10,10,4,4,14,16,4,5,3,3,0,1,1,1,0,0,20,8,30,9,6,1
"20230304AYRINV",2023-03-04,"Scotland Championship","Ayr","Inverness C",1,2,"A",10,16,1,5,12,10,2,4,2,2,1,0,0,0,0,3,26,6,22,6,4,1
"20230304COVDUN",2023-03-04,"Scotland Championship","Cove Rangers","Dundee",0,2,"A",3,9,0,5,11,12,3,4,1,2,0,0,0,0,0,2,12,5,23,7,3,0
"20230304PARRAI",2023-03-04,"Scotland Championship","Partick","Raith Rvs",3,0,"H",6,7,5,3,16,11,6,4,1,2,0,0,0,0,0,3,13,8,27,10,3,0
"20230304QUEMOR",2023-03-04,"Scotland Championship","Queens Park","Morton",2,2,"D",17,7,8,3,5,14,10,2,1,2,0,0,0,0,0,4,24,11,19,12,3,0
"20230307MORAYR",2023-03-07,"Scotland Championship","Morton","Ayr",1,3,"A",11,13,6,7,11,8,6,4,3,2,0,0,0,0,0,4,24,13,19,10,5,0
"20230310QUECOV",2023-03-10,"Scotland Championship","Queens Park","Cove Rangers",1,0,"H",13,8,6,3,5,8,11,1,2,2,0,0,0,0,0,1,21,9,13,12,4,0
"20230311MORPAR",2023-03-11,"Scotland Championship","Morton","Partick",0,0,"D",6,12,1,2,21,9,4,4,4,6,0,0,0,0,0,0,18,3,30,8,10,0
"20230317ARBMOR",2023-03-17,"Scotland Championship","Arbroath","Morton",1,1,"D",8,15,4,6,19,8,6,4,3,0,0,0,0,0,0,2,23,10,27,10,3,0
"20230318HAMAYR",2023-03-18,"Scotland Championship","Hamilton","Ayr",0,2,"A",3,12,1,4,9,8,3,8,0,2,0,0,0,0,0,2,15,5,17,11,2,0
"20230318PARDUN",2023-03-18,"Scotland Championship","Partick","Dundee",0,0,"D",8,3,3,2,11,14,2,7,0,2,0,0,0,0,0,0,11,5,25,9,2,0
"20230318QUEINV",2023-03-18,"Scotland Championship","Queens Park","Inverness C",2,1,"H",18,11,5,4,7,14,9,8,0,2,0,0,0,0,0,3,29,9,21,17,2,0
"20230318RAICOV",2023-03-18,"Scotland Championship","Raith Rvs","Cove Rangers",6,1,"H",13,5,6,3,8,10,9,6,0,4,0,0,1,0,1,7,18,9,18,15,4,0
"20230321DUNAYR",2023-03-21,"Scotland Championship","Dundee","Ayr",3,1,"H",12,11,5,1,11,12,6,3,1,1,0,0,0,0,0,4,23,6,23,9,2,0
"20230324AYRCOV",2023-03-24,"Scotland Championship","Ayr","Cove Rangers",3,0,"H",9,7,5,2,13,10,1,5,1,1,0,0,0,0,0,3,16,7,23,6,2,0
"20230324INVPAR",2023-03-24,"Scotland Championship","Inverness C","Partick",1,0,"H",9,11,5,6,15,6,2,12,3,1,1,0,0,0,0,1,20,11,21,14,4,1
"20230324QUEARB",2023-03-24,"Scotland Championship","Queens Park","Arbroath",0,1,"A",11,8,2,5,7,6,8,5,1,2,0,0,0,0,0,1,19,7,13,13,3,0
"20230331ARBAYR",2023-03-31,"Scotland Championship","Arbroath","Ayr",2,0,"H",8,13,3,2,12,14,7,8,2,1,0,0,0,0,0,2,21,5,26,15,3,0
"20230401COVPAR",2023-04-01,"Scotland Championship","Cove Rangers","Partick",0,5,"A",8,17,3,4,7,9,9,3,1,0,0,0,0,0,0,5,25,7,16,12,1,0
"20230401DUNHAM",2023-04-01,"Scotland Championship","Dundee","Hamilton",7,0,"H",18,5,9,1,9,10,5,1,0,1,0,0,0,0,0,7,23,10,19,6,1,0
"20230401MORINV",2023-04-01,"Scotland Championship","Morton","Inverness C",1,2,"A",11,9,5,4,13,12,4,1,3,3,0,0,0,0,0,3,20,9,25,5,6,0
"20230401RAIQUE",2023-04-01,"Scotland Championship","Raith Rvs","Queens Park",2,0,"H",18,5,7,2,13,12,5,2,3,2,0,1,0,0,0,2,23,9,25,7,5,1
"20230404RAIHAM",2023-04-04,"Scotland Championship","Raith Rvs","Hamilton",1,2,"A",5,2,0,2,11,8,5,1,3,2,0,1,0,0,0,3,7,2,19,6,5,1
"20230407PARQUE",2023-04-07,"Scotland Championship","Partick","Queens Park",4,0,"H",8,6,6,4,13,15,6,5,1,0,0,0,0,0,0,4,14,10,28,11,1,0
"20230408ARBDUN",2023-04-08,"Scotland Championship","Arbroath","Dundee",0,0,"D",5,4,1,1,11,16,2,5,3,3,0,0,0,0,0,0,9,2,27,7,6,0
"20230408AYRMOR",2023-04-08,"Scotland Championship","Ayr","Morton",1,1,"D",14,4,5,3,8,11,8,2,1,4,0,1,0,0,0,2,18,8,19,10,5,1
"20230408HAMCOV",2023-04-08,"Scotland Championship","Hamilton","Cove Rangers",1,1,"D",11,9,5,3,10,21,3,3,1,5,0,0,0,0,0,2,20,8,31,6,6,0
"20230408INVRAI",2023-04-08,"Scotland Championship","Inverness C","Raith Rvs",2,0,"H",5,5,3,2,6,5,5,3,0,0,0,0,0,0,0,2,10,5,11,8,0,0
"20230411DUNRAI",2023-04-11,"Scotland Championship","Dundee","Raith Rvs",3,1,"H",9,5,4,3,6,8,3,4,2,4,0,0,0,0,0,4,14,7,14,7,6,0
"20230411INVARB",2023-04-11,"Scotland Championship","Inverness C","Arbroath",2,0,"H",6,5,2,3,9,11,5,3,1,2,1,0,0,0,0,2,11,5,20,8,3,1
"20230411MORHAM",2023-04-11,"Scotland Championship","Morton","Hamilton",2,0,"H",16,12,6,2,12,7,15,4,2,1,0,0,1,1,0,2,28,8,19,19,3,0
"20230414QUEHAM",2023-04-14,"Scotland Championship","Queens Park","Hamilton",1,0,"H",13,5,3,3,14,13,7,8,2,3,0,0,0,0,0,1,18,6,27,15,5,0
"20230415COVINV",2023-04-15,"Scotland Championship","Cove Rangers","Inverness C",1,2,"A",9,11,5,6,6,10,4,3,1,1,0,0,0,0,0,3,20,11,16,7,2,0
"20230415DUNMOR",2023-04-15,"Scotland Championship","Dundee","Morton",3,3,"D",11,6,3,3,10,26,7,3,1,3,0,0,0,0,0,6,17,6,36,10,4,0
"20230415PARAYR",2023-04-15,"Scotland Championship","Partick","Ayr",1,1,"D",7,10,4,6,9,7,2,6,2,1,0,0,0,0,0,2,17,10,16,8,3,0
"20230415RAIARB",2023-04-15,"Scotland Championship","Raith Rvs","Arbroath",1,1,"D",10,4,5,2,13,11,7,2,2,2,0,0,0,0,0,2,14,7,24,9,4,0
"20230418HAMINV",2023-04-18,"Scotland Championship","Hamilton","Inverness C",1,2,"A",7,13,2,4,5,12,2,7,2,1,0,0,0,0,0,3,20,6,17,9,3,0
"20230421AYRQUE",2023-04-21,"Scotland Championship","Ayr","Queens Park",0,0,"D",13,9,2,3,12,8,9,6,0,0,0,0,0,0,0,0,22,5,20,15,0,0
"20230422ARBCOV",2023-04-22,"Scotland Championship","Arbroath","Cove Rangers",0,1,"A",9,9,2,2,7,10,8,6,1,3,0,0,0,0,0,1,18,4,17,14,4,0
"20230422HAMPAR",2023-04-22,"Scotland Championship","Hamilton","Partick",2,2,"D",11,19,3,8,15,10,6,10,5,5,0,0,0,0,0,4,30,11,25,16,10,0
"20230422INVDUN",2023-04-22,"Scotland Championship","Inverness C","Dundee",1,1,"D",6,10,4,3,12,10,4,8,2,0,0,0,0,0,0,2,16,7,22,12,2,0
"20230422MORRAI",2023-04-22,"Scotland Championship","Morton","Raith Rvs",1,0,"H",9,11,5,0,14,12,2,2,3,0,0,2,0,0,0,1,20,5,26,4,3,2
"20230428DUNCOV",2023-04-28,"Scotland Championship","Dundee","Cove Rangers",0,0,"D",16,2,4,0,7,5,11,2,2,4,0,0,0,0,0,0,18,4,12,13,6,0
"20230429AYRRAI",2023-04-29,"Scotland Championship","Ayr","Raith Rvs",1,0,"H",12,7,5,0,7,11,7,8,0,2,0,0,0,0,0,1,19,5,18,15,2,0
"20230429MORQUE",2023-04-29,"Scotland Championship","Morton","Queens Park",2,1,"H",15,11,4,4,9,11,7,2,0,3,0,0,0,0,0,3,26,8,20,9,3,0
"20230429PARARB",2023-04-29,"Scotland Championship","Partick","Arbroath",2,0,"H",9,2,5,1,6,9,4,11,1,2,0,0,0,0,0,2,11,6,15,15,3,0
"20230505ARBHAM",2023-05-05,"Scotland Championship","Arbroath","Hamilton",0,0,"D",17,8,6,1,7,15,8,4,2,2,0,0,0,0,0,0,25,7,22,12,4,0
"20230505COVMOR",2023-05-05,"Scotland Championship","Cove Rangers","Morton",1,2,"A",9,6,7,3,7,11,5,3,1,0,0,1,0,0,0,3,15,10,18,8,1,1
"20230505INVAYR",2023-05-05,"Scotland Championship","Inverness C","Ayr",1,2,"A",8,10,2,3,4,5,8,3,1,1,0,0,1,0,1,3,18,5,9,11,2,0
"20230505QUEDUN",2023-05-05,"Scotland Championship","Queens Park","Dundee",3,5,"A",7,17,5,8,12,18,8,4,0,3,0,0,1,0,1,8,24,13,30,12,3,0
"20230505RAIPAR",2023-05-05,"Scotland Championship","Raith Rvs","Partick",2,2,"D",3,13,2,7,9,7,2,12,5,3,0,0,0,0,0,4,16,9,16,14,8,0
"20230804ARBDUN",2023-08-04,"Scotland Championship","Arbroath","Dundee United",0,4,"A",3,15,1,7,13,3,6,10,2,0,0,0,1,0,1,4,18,8,16,16,2,0
"20230805DUNAIR",2023-08-05,"Scotland Championship","Dunfermline","Airdrie Utd",2,1,"H",13,12,5,3,11,9,4,5,1,1,1,0,0,0,0,3,25,8,20,9,2,1
"20230805INVQUE",2023-08-05,"Scotland Championship","Inverness C","Queens Park",1,2,"A",12,12,6,7,9,10,5,4,1,3,0,0,0,0,0,3,24,13,19,9,4,0
"20230805MORAYR",2023-08-05,"Scotland Championship","Morton","Ayr",3,1,"H",19,7,6,4,9,16,3,4,3,5,0,0,0,0,0,4,26,10,25,7,8,0
"20230805PARRAI",2023-08-05,"Scotland Championship","Partick","Raith Rvs",2,2,"D",14,14,5,6,8,9,7,4,1,2,0,0,0,0,0,4,28,11,17,11,3,0
"20230812AIRPAR",2023-08-12,"Scotland Championship","Airdrie Utd","Partick",2,1,"H",11,7,2,2,6,9,6,4,0,0,0,0,0,0,0,3,18,4,15,10,0,0
"20230812AYRINV",2023-08-12,"Scotland Championship","Ayr","Inverness C",1,0,"H",7,10,3,4,10,13,5,3,2,2,0,0,0,0,0,1,17,7,23,8,4,0
"20230812DUNDUN",2023-08-12,"Scotland Championship","Dundee United","Dunfermline",1,1,"D",16,5,4,2,14,3,10,4,0,2,0,0,0,0,0,2,21,6,17,14,2,0
"20230812QUEARB",2023-08-12,"Scotland Championship","Queens Park","Arbroath",2,1,"H",14,6,5,1,8,7,15,2,3,1,0,0,0,0,0,3,20,6,15,17,4,0
"20230812RAIMOR",2023-08-12,"Scotland Championship","Raith Rvs","Morton",3,2,"H",4,3,4,2,8,13,5,6,5,8,0,0,0,0,0,5,7,6,21,11,13,0
"20230819ARBQUE",2023-08-19,"Scotland Championship","Arbroath","Queens Park",0,1,"A",12,4,3,3,15,9,3,6,1,2,0,0,0,0,0,1,16,6,24,9,3,0
"20230826AIRINV",2023-08-26,"Scotland Championship","Airdrie Utd","Inverness C",2,1,"H",8,19,3,6,11,15,1,3,1,3,1,0,0,0,0,3,27,9,26,4,4,1
"20230826AYRDUN",2023-08-26,"Scotland Championship","Ayr","Dundee United",0,3,"A",2,13,2,8,8,9,4,11,1,2,0,0,0,0,0,3,15,10,17,15,3,0
"20230826DUNRAI",2023-08-26,"Scotland Championship","Dunfermline","Raith Rvs",0,1,"A",5,3,2,2,8,7,12,2,2,2,0,0,0,0,0,1,8,4,15,14,4,0
"20230826MORARB",2023-08-26,"Scotland Championship","Morton","Arbroath",0,3,"A",17,13,8,6,11,17,14,6,2,3,0,0,0,0,0,3,30,14,28,20,5,0
"20230826PARQUE",2023-08-26,"Scotland Championship","Partick","Queens Park",3,1,"H",10,14,6,4,8,10,1,6,2,1,0,0,0,0,0,4,24,10,18,7,3,0
"20230902ARBAYR",2023-09-02,"Scotland Championship","Arbroath","Ayr",2,1,"H",11,9,6,3,9,7,5,7,3,1,0,0,0,0,0,3,20,9,16,12,4,0
"20230902DUNAIR",2023-09-02,"Scotland Championship","Dundee United","Airdrie Utd",2,0,"H",9,9,3,3,14,8,5,3,2,2,0,0,2,2,0,2,18,6,22,8,4,0
"20230902INVDUN",2023-09-02,"Scotland Championship","Inverness C","Dunfermline",1,1,"D",7,10,2,4,10,7,2,7,2,1,0,0,0,0,0,2,17,6,17,9,3,0
"20230902MORPAR",2023-09-02,"Scotland Championship","Morton","Partick",1,4,"A",15,13,8,6,6,6,2,7,1,0,0,1,0,0,0,5,28,14,12,9,1,1
"20230902RAIQUE",2023-09-02,"Scotland Championship","Raith Rvs","Queens Park",3,2,"H",8,4,7,2,5,10,8,1,1,0,0,1,0,0,0,5,12,9,15,9,1,1
"20230915AYRPAR",2023-09-15,"Scotland Championship","Ayr","Partick",0,4,"A",13,11,10,5,6,7,9,3,3,1,0,0,0,0,0,4,24,15,13,12,4,0
"20230916ARBAIR",2023-09-16,"Scotland Championship","Arbroath","Airdrie Utd",4,0,"H",11,6,6,0,13,8,2,5,0,1,1,1,0,0,0,4,17,6,21,7,1,2
"20230916DUNMOR",2023-09-16,"Scotland Championship","Dundee United","Morton",1,1,"D",9,7,1,1,15,12,5,4,1,3,1,0,0,0,0,2,16,2,27,9,4,1
"20230916QUEDUN",2023-09-16,"Scotland Championship","Queens Park","Dunfermline",0,2,"A",14,15,2,5,11,7,8,9,2,3,0,0,0,0,0,2,29,7,18,17,5,0
"20230916RAIINV",2023-09-16,"Scotland Championship","Raith Rvs","Inverness C",1,0,"H",7,8,2,5,9,15,3,7,2,2,0,0,0,0,0,1,15,7,24,10,4,0
"20230922QUEAYR",2023-09-22,"Scotland Championship","Queens Park","Ayr",2,5,"A",12,10,4,6,8,7,4,2,2,0,0,0,0,0,0,7,22,10,15,6,2,0
"20230923AIRRAI",2023-09-23,"Scotland Championship","Airdrie Utd","Raith Rvs",1,0,"H",7,11,3,6,8,9,2,1,1,4,0,0,0,0,0,1,18,9,17,3,5,0
"20230923DUNMOR",2023-09-23,"Scotland Championship","Dunfermline","Morton",3,1,"H",10,9,5,2,8,14,10,4,0,3,0,0,0,0,0,4,19,7,22,14,3,0
"20230923INVDUN",2023-09-23,"Scotland Championship","Inverness C","Dundee United",0,1,"A",8,12,2,4,6,13,4,2,2,3,0,1,0,0,0,1,20,6,19,6,5,1
"20230923PARARB",2023-09-23,"Scotland Championship","Partick","Arbroath",0,3,"A",8,19,1,7,12,10,4,6,3,2,0,0,0,0,0,3,27,8,22,10,5,0
"20230930ARBINV",2023-09-30,"Scotland Championship","Arbroath","Inverness C",2,3,"A",11,7,3,6,14,18,8,2,1,1,0,0,0,0,0,5,18,9,32,10,2,0
"20230930AYRRAI",2023-09-30,"Scotland Championship","Ayr","Raith Rvs",1,2,"A",13,8,4,3,10,6,8,4,2,2,0,0,0,0,0,3,21,7,16,12,4,0
"20230930DUNQUE",2023-09-30,"Scotland Championship","Dundee United","Queens Park",4,1,"H",14,8,5,3,7,7,4,2,0,2,0,0,0,0,0,5,22,8,14,6,2,0
"20230930MORAIR",2023-09-30,"Scotland Championship","Morton","Airdrie Utd",0,1,"A",13,8,1,2,12,13,6,3,2,3,0,0,0,0,0,1,21,3,25,9,5,0
"20230930PARDUN",2023-09-30,"Scotland Championship","Partick","Dunfermline",3,0,"H",23,19,12,4,8,5,4,9,3,1,0,0,0,0,0,3,42,16,13,13,4,0
"20231007AIRAYR",2023-10-07,"Scotland Championship","Airdrie Utd","Ayr",1,2,"A",8,11,3,3,5,9,7,7,1,1,0,0,0,0,0,3,19,6,14,14,2,0
"20231007INVPAR",2023-10-07,"Scotland Championship","Inverness C","Partick",0,0,"D",4,4,1,3,10,8,6,4,0,1,0,0,0,0,0,0,8,4,18,10,1,0
"20231007QUEMOR",2023-10-07,"Scotland Championship","Queens Park","Morton",0,0,"D",11,7,4,2,10,8,10,3,1,3,0,0,0,0,0,0,18,6,18,13,4,0
"20231007RAIDUN",2023-10-07,"Scotland Championship","Raith Rvs","Dundee United",1,1,"D",7,7,6,4,15,13,3,3,3,4,0,0,0,0,0,2,14,10,28,6,7,0
"20231020AIRQUE",2023-10-20,"Scotland Championship","Airdrie Utd","Queens Park",1,1,"D",10,13,6,6,12,12,1,5,0,3,0,1,0,0,0,2,23,12,24,6,3,1
"20231021DUNAYR",2023-10-21,"Scotland Championship","Dunfermline","Ayr",0,1,"A",9,15,1,5,8,14,4,11,0,1,0,0,2,1,1,1,24,6,22,15,1,0
"20231021PARDUN",2023-10-21,"Scotland Championship","Partick","Dundee United",0,5,"A",7,13,2,8,9,12,2,4,1,2,1,0,0,0,0,5,20,10,21,6,3,1
"20231027DUNARB",2023-10-27,"Scotland Championship","Dundee United","Arbroath",6,0,"H",18,5,10,2,5,7,10,5,0,1,0,0,0,0,0,6,23,12,12,15,1,0
"20231027QUEPAR",2023-10-27,"Scotland Championship","Queens Park","Partick",2,2,"D",18,5,8,4,7,11,9,1,2,0,0,0,0,0,0,4,23,12,18,10,2,0
"20231028AYRMOR",2023-10-28,"Scotland Championship","Ayr","Morton",0,1,"A",13,10,6,5,15,17,4,10,2,4,0,0,1,1,0,1,23,11,32,14,6,0
"20231028INVAIR",2023-10-28,"Scotland Championship","Inverness C","Airdrie Utd",1,0,"H",7,9,2,4,9,12,3,5,2,2,0,0,0,0,0,1,16,6,21,8,4,0
"20231028RAIDUN",2023-10-28,"Scotland Championship","Raith Rvs","Dunfermline",1,0,"H",8,10,2,6,5,11,6,9,1,3,0,0,0,0,0,1,18,8,16,15,4,0
"20231031AIRDUN",2023-10-31,"Scotland Championship","Airdrie Utd","Dundee United",0,2,"A",10,10,3,5,8,6,9,3,0,0,0,0,0,0,0,2,20,8,14,12,0,0
"20231031MORRAI",2023-10-31,"Scotland Championship","Morton","Raith Rvs",1,2,"A",10,13,5,3,11,9,5,5,4,2,0,0,0,0,0,3,23,8,20,10,6,0
"20231031PARAYR",2023-10-31,"Scotland Championship","Partick","Ayr",2,2,"D",13,8,6,4,12,13,4,3,1,0,0,0,0,0,0,4,21,10,25,7,1,0
"20231103MORDUN",2023-11-03,"Scotland Championship","Morton","Dunfermline",1,2,"A",10,11,7,5,11,9,7,6,4,2,0,0,0,0,0,3,21,12,20,13,6,0
"20231104ARBPAR",2023-11-04,"Scotland Championship","Arbroath","Partick",1,3,"A",7,10,3,8,13,12,7,9,2,1,0,0,2,2,0,4,17,11,25,16,3,0
"20231104AYRQUE",2023-11-04,"Scotland Championship","Ayr","Queens Park",2,2,"D",10,7,6,3,5,9,2,7,0,2,0,0,0,0,0,4,17,9,14,9,2,0
"20231104DUNINV",2023-11-04,"Scotland Championship","Dundee United","Inverness C",1,1,"D",13,4,7,2,11,7,5,3,1,1,0,0,0,0,0,2,17,9,18,8,2,0
"20231104RAIAIR",2023-11-04,"Scotland Championship","Raith Rvs","Airdrie Utd",1,1,"D",10,16,5,9,10,8,6,3,0,1,0,0,0,0,0,2,26,14,18,9,1,0
"20231110DUNDUN",2023-11-10,"Scotland Championship","Dunfermline","Dundee United",1,2,"A",6,16,2,5,7,9,3,7,4,3,0,0,0,0,0,3,22,7,16,10,7,0
"20231111AIRARB",2023-11-11,"Scotland Championship","Airdrie Utd","Arbroath",2,0,"H",6,8,5,1,10,12,5,5,0,0,0,0,0,0,0,2,14,6,22,10,0,0
"20231111INVAYR",2023-11-11,"Scotland Championship","Inverness C","Ayr",3,1,"H",5,5,5,1,8,9,5,4,2,0,0,0,0,0,0,4,10,6,17,9,2,0
"20231111PARMOR",2023-11-11,"Scotland Championship","Partick","Morton",2,1,"H",10,6,5,2,15,14,2,2,2,3,1,0,1,1,0,3,16,7,29,4,5,1
"20231111QUERAI",2023-11-11,"Scotland Championship","Queens Park","Raith Rvs",2,3,"A",18,12,9,6,11,6,5,1,2,1,1,0,0,0,0,5,30,15,17,6,3,1
"20231118DUNINV",2023-11-18,"Scotland Championship","Dunfermline","Inverness C",1,1,"D",12,5,2,2,2,5,10,7,2,3,0,0,0,0,0,2,17,4,7,17,5,0
"20231128DUNARB",2023-11-28,"Scotland Championship","Dunfermline","Arbroath",3,0,"H",17,6,9,0,8,7,12,1,1,1,0,0,0,0,0,3,23,9,15,13,2,0
"20231202INVRAI",2023-12-02,"Scotland Championship","Inverness C","Raith Rvs",1,2,"A",6,13,2,5,12,5,3,10,2,2,0,0,0,0,0,3,19,7,17,13,4,0
"20231202PARAIR",2023-12-02,"Scotland Championship","Partick","Airdrie Utd",2,1,"H",7,7,3,4,7,7,4,8,1,0,0,0,0,0,0,3,14,7,14,12,1,0
"20231208RAIPAR",2023-12-08,"Scotland Championship","Raith Rvs","Partick",4,3,"H",17,10,9,3,13,11,10,9,2,3,0,0,0,0,0,7,27,12,24,19,5,0
"20231209AIRDUN",2023-12-09,"Scotland Championship","Airdrie Utd","Dunfermline",1,2,"A",12,9,5,6,10,3,8,4,2,0,0,0,0,0,0,3,21,11,13,12,2,0
"20231209ARBMOR",2023-12-09,"Scotland Championship","Arbroath","Morton",1,2,"A",10,10,2,5,8,10,7,4,1,3,0,0,0,0,0,3,20,7,18,11,4,0
"20231209DUNAYR",2023-12-09,"Scotland Championship","Dundee United","Ayr",1,0,"H",14,5,5,2,1,9,13,4,0,3,0,0,0,0,0,1,19,7,10,17,3,0
"20231209QUEINV",2023-12-09,"Scotland Championship","Queens Park","Inverness C",1,4,"A",5,16,3,11,7,4,2,3,2,0,0,0,0,0,0,5,21,14,11,5,2,0
"20231212MORINV",2023-12-12,"Scotland Championship","Morton","Inverness C",2,1,"H",13,7,5,2,11,7,8,2,5,2,0,0,0,0,0,3,20,7,18,10,7,0
"20231213ARBRAI",2023-12-13,"Scotland Championship","Arbroath","Raith Rvs",1,2,"A",5,8,2,5,17,9,3,6,2,2,0,0,0,0,0,3,13,7,26,9,4,0
"20231216AYRAIR",2023-12-16,"Scotland Championship","Ayr","Airdrie Utd",1,0,"H",9,14,2,4,7,8,4,1,1,3,0,0,0,0,0,1,23,6,15,5,4,0
"20231216DUNRAI",2023-12-16,"Scotland Championship","Dundee United","Raith Rvs",0,1,"A",13,5,4,3,18,11,9,3,3,2,0,0,0,0,0,1,18,7,29,12,5,0
"20231216DUNPAR",2023-12-16,"Scotland Championship","Dunfermline","Partick",1,2,"A",5,4,3,3,4,10,3,5,1,3,0,0,0,0,0,3,9,6,14,8,4,0
"20231216INVARB",2023-12-16,"Scotland Championship","Inverness C","Arbroath",1,2,"A",11,8,2,6,11,15,7,4,1,4,0,0,1,1,0,3,19,8,26,11,5,0
"20231216MORQUE",2023-12-16,"Scotland Championship","Morton","Queens Park",1,0,"H",8,14,5,6,9,12,3,7,3,1,1,0,3,1,2,1,22,11,21,10,4,1
"20231222QUEDUN",2023-12-22,"Scotland Championship","Queens Park","Dundee United",0,0,"D",5,16,1,5,9,8,4,8,2,1,0,0,0,0,0,0,21,6,17,12,3,0
"20231222RAIAYR",2023-12-22,"Scotland Championship","Raith Rvs","Ayr",4,4,"D",13,10,7,8,9,11,9,3,1,0,0,1,0,0,0,8,23,15,20,12,1,1
"20231223AIRMOR",2023-12-23,"Scotland Championship","Airdrie Utd","Morton",0,0,"D",5,7,1,1,13,7,3,6,1,1,0,0,0,0,0,0,12,2,20,9,2,0
"20231223ARBDUN",2023-12-23,"Scotland Championship","Arbroath","Dunfermline",1,1,"D",16,11,4,2,8,7,10,8,1,1,1,0,1,0,1,2,27,6,15,18,2,1
"20231223PARINV",2023-12-23,"Scotland Championship","Partick","Inverness C",1,1,"D",8,6,3,1,6,8,5,6,1,3,0,0,0,0,0,2,14,4,14,11,4,0
"20231229DUNPAR",2023-12-29,"Scotland Championship","Dundee United","Partick",3,0,"H",21,5,6,1,11,8,9,7,1,3,0,0,0,0,0,3,26,7,19,16,4,0
"20231230AYRDUN",2023-12-30,"Scotland Championship","Ayr","Dunfermline",2,2,"D",12,11,4,5,7,6,9,6,1,2,0,0,0,0,0,4,23,9,13,15,3,0
"20231230INVMOR",2023-12-30,"Scotland Championship","Inverness C","Morton",0,0,"D",7,3,2,0,6,7,2,4,0,1,0,0,0,0,0,0,10,2,13,6,1,0
"20231230QUEAIR",2023-12-30,"Scotland Championship","Queens Park","Airdrie Utd",1,2,"A",5,10,2,6,15,14,6,4,2,0,0,0,0,0,0,3,15,8,29,10,2,0
"20231230RAIARB",2023-12-30,"Scotland Championship","Raith Rvs","Arbroath",2,2,"D",7,5,4,5,11,3,9,7,1,1,0,0,0,0,0,4,12,9,14,16,2,0
"20240102AIRINV",2024-01-02,"Scotland Championship","Airdrie Utd","Inverness C",2,0,"H",6,1,5,0,13,7,6,5,0,1,0,0,0,0,0,2,7,5,20,11,1,0
"20240102ARBDUN",2024-01-02,"Scotland Championship","Arbroath","Dundee United",0,3,"A",2,11,2,6,9,7,3,6,1,2,0,0,0,0,0,3,13,8,16,9,3,0
"20240102DUNRAI",2024-01-02,"Scotland Championship","Dunfermline","Raith Rvs",1,2,"A",8,11,4,5,11,9,3,7,4,1,0,0,0,0,0,3,19,9,20,10,5,0
"20240102MORAYR",2024-01-02,"Scotland Championship","Morton","Ayr",3,0,"H",15,2,6,0,14,13,8,1,2,2,0,0,0,0,0,3,17,6,27,9,4,0
"20240102PARQUE",2024-01-02,"Scotland Championship","Partick","Queens Park",3,2,"H",14,9,5,5,6,13,8,2,3,3,0,0,0,0,0,5,23,10,19,10,6,0
"20240105QUEDUN",2024-01-05,"Scotland Championship","Queens Park","Dunfermline",2,1,"H",13,4,4,1,14,7,7,0,2,1,0,0,0,0,0,3,17,5,21,7,3,0
"20240106AIRRAI",2024-01-06,"Scotland Championship","Airdrie Utd","Raith Rvs",1,0,"H",8,8,4,3,12,10,5,6,3,5,0,1,0,0,0,1,16,7,22,11,8,1
"20240106AYRINV",2024-01-06,"Scotland Championship","Ayr","Inverness C",1,3,"A",11,5,5,4,9,9,6,3,2,3,0,0,1,1,0,4,16,9,18,9,5,0
"20240106DUNMOR",2024-01-06,"Scotland Championship","Dundee United","Morton",2,3,"A",9,7,3,4,13,11,10,2,4,4,1,0,0,0,0,5,16,7,24,12,8,1
"20240106PARARB",2024-01-06,"Scotland Championship","Partick","Arbroath",4,0,"H",10,10,7,4,14,9,3,7,0,2,0,0,0,0,0,4,20,11,23,10,2,0
"20240112INVDUN",2024-01-12,"Scotland Championship","Inverness C","Dundee United",0,1,"A",10,7,4,2,10,7,4,1,1,2,0,0,0,0,0,1,17,6,17,5,3,0
"20240113ARBAYR",2024-01-13,"Scotland Championship","Arbroath","Ayr",0,0,"D",7,14,1,2,8,6,4,4,1,2,0,0,0,0,0,0,21,3,14,8,3,0
"20240113MORPAR",2024-01-13,"Scotland Championship","Morton","Partick",1,1,"D",12,9,5,4,18,13,3,6,5,6,0,0,1,0,1,2,21,9,31,9,11,0
"20240113RAIQUE",2024-01-13,"Scotland Championship","Raith Rvs","Queens Park",1,2,"A",11,8,6,7,9,11,9,2,4,3,0,0,0,0,0,3,19,13,20,11,7,0
"20240123AYRARB",2024-01-23,"Scotland Championship","Ayr","Arbroath",2,0,"H",10,3,5,2,15,8,6,2,1,3,0,0,1,1,0,2,13,7,23,8,4,0
"20240127AIRPAR",2024-01-27,"Scotland Championship","Airdrie Utd","Partick",1,1,"D",6,4,1,3,13,6,3,5,2,3,0,0,1,0,1,2,10,4,19,8,5,0
"20240127DUNDUN",2024-01-27,"Scotland Championship","Dundee United","Dunfermline",0,0,"D",12,7,3,1,11,3,13,2,0,0,0,0,0,0,0,0,19,4,14,15,0,0
"20240127MORARB",2024-01-27,"Scotland Championship","Morton","Arbroath",3,0,"H",17,5,8,2,14,14,10,3,1,3,0,1,1,0,1,3,22,10,28,13,4,1
"20240127QUEAYR",2024-01-27,"Scotland Championship","Queens Park","Ayr",1,2,"A",7,13,2,6,7,8,1,3,1,3,1,0,0,0,0,3,20,8,15,4,4,1
"20240127RAIINV",2024-01-27,"Scotland Championship","Raith Rvs","Inverness C",2,3,"A",8,7,3,4,11,11,6,1,0,2,0,0,0,0,0,5,15,7,22,7,2,0
"20240203AYRDUN",2024-02-03,"Scotland Championship","Ayr","Dundee United",1,2,"A",7,9,3,4,16,7,6,11,2,3,1,0,1,0,1,3,16,7,23,17,5,1
"20240203DUNMOR",2024-02-03,"Scotland Championship","Dunfermline","Morton",0,5,"A",7,13,1,7,9,9,5,3,0,1,0,0,0,0,0,5,20,8,18,8,1,0
"20240203INVQUE",2024-02-03,"Scotland Championship","Inverness C","Queens Park",0,1,"A",17,4,5,3,14,10,4,4,2,2,0,0,1,1,0,1,21,8,24,8,4,0
"20240210DUNQUE",2024-02-10,"Scotland Championship","Dunfermline","Queens Park",0,3,"A",6,13,2,5,13,14,0,3,2,1,0,0,0,0,0,3,19,7,27,3,3,0
"20240216RAIDUN",2024-02-16,"Scotland Championship","Raith Rvs","Dundee United",2,1,"H",6,13,5,5,4,11,4,7,2,3,0,0,1,1,0,3,19,10,15,11,5,0
"20240217AIRAYR",2024-02-17,"Scotland Championship","Airdrie Utd","Ayr",2,3,"A",8,5,3,5,15,12,3,3,1,1,0,0,0,0,0,5,13,8,27,6,2,0
"20240217DUNARB",2024-02-17,"Scotland Championship","Dunfermline","Arbroath",1,1,"D",10,7,3,3,10,9,8,5,4,3,0,0,0,0,0,2,17,6,19,13,7,0
"20240217INVPAR",2024-02-17,"Scotland Championship","Inverness C","Partick",3,3,"D",8,7,4,4,7,12,6,8,1,2,1,0,0,0,0,6,15,8,19,14,3,1
"20240217QUEMOR",2024-02-17,"Scotland Championship","Queens Park","Morton",0,0,"D",4,9,1,5,7,11,1,5,0,1,0,0,0,0,0,0,13,6,18,6,1,0
"20240223PARDUN",2024-02-23,"Scotland Championship","Partick","Dunfermline",1,3,"A",7,15,4,7,14,7,4,9,2,1,0,0,0,0,0,4,22,11,21,13,3,0
"20240224ARBINV",2024-02-24,"Scotland Championship","Arbroath","Inverness C",1,1,"D",9,17,2,4,12,12,4,2,3,3,0,0,0,0,0,2,26,6,24,6,6,0
"20240224AYRRAI",2024-02-24,"Scotland Championship","Ayr","Raith Rvs",1,2,"A",11,6,3,5,8,7,3,6,2,1,0,0,0,0,0,3,17,8,15,9,3,0
"20240224DUNQUE",2024-02-24,"Scotland Championship","Dundee United","Queens Park",3,1,"H",12,6,7,4,16,16,5,2,1,4,0,0,0,0,0,4,18,11,32,7,5,0
"20240224MORAIR",2024-02-24,"Scotland Championship","Morton","Airdrie Utd",2,1,"H",7,7,4,2,10,12,6,5,3,2,0,0,0,0,0,3,14,6,22,11,5,0
"20240227AYRPAR",2024-02-27,"Scotland Championship","Ayr","Partick",4,3,"H",8,13,5,6,12,8,4,11,2,0,0,0,0,0,0,7,21,11,20,15,2,0
"20240227DUNAIR",2024-02-27,"Scotland Championship","Dundee United","Airdrie Utd",0,2,"A",12,10,2,4,7,12,7,7,3,1,0,0,0,0,0,2,22,6,19,14,4,0
"20240227INVDUN",2024-02-27,"Scotland Championship","Inverness C","Dunfermline",0,0,"D",6,6,1,0,8,15,5,8,2,2,0,0,0,0,0,0,12,1,23,13,4,0
"20240227QUEARB",2024-02-27,"Scotland Championship","Queens Park","Arbroath",6,0,"H",19,6,8,3,4,6,5,2,0,1,0,0,0,0,0,6,25,11,10,7,1,0
"20240227RAIMOR",2024-02-27,"Scotland Championship","Raith Rvs","Morton",0,0,"D",3,10,1,4,13,12,4,7,3,3,0,0,0,0,0,0,13,5,25,11,6,0
"20240301ARBRAI",2024-03-01,"Scotland Championship","Arbroath","Raith Rvs",3,2,"H",9,17,3,7,13,13,1,9,0,1,0,0,0,0,0,5,26,10,26,10,1,0
"20240302AIRQUE",2024-03-02,"Scotland Championship","Airdrie Utd","Queens Park",1,1,"D",17,12,8,3,6,12,8,4,2,3,0,0,1,1,0,2,29,11,18,12,5,0
"20240302DUNAYR",2024-03-02,"Scotland Championship","Dunfermline","Ayr",2,0,"H",7,3,4,1,7,10,8,4,1,1,0,0,0,0,0,2,10,5,17,12,2,0
"20240302MORINV",2024-03-02,"Scotland Championship","Morton","Inverness C",0,2,"A",7,7,2,4,16,17,6,1,4,4,0,0,1,0,1,2,14,6,33,7,8,0
"20240302PARDUN",2024-03-02,"Scotland Championship","Partick","Dundee United",1,1,"D",5,8,1,3,10,14,6,5,2,3,0,0,0,0,0,2,13,4,24,11,5,0
"20240305DUNAIR",2024-03-05,"Scotland Championship","Dunfermline","Airdrie Utd",0,2,"A",9,6,1,2,3,14,5,2,2,5,0,0,0,0,0,2,15,3,17,7,7,0
"20240305MORDUN",2024-03-05,"Scotland Championship","Morton","Dundee United",0,1,"A",6,6,1,4,15,10,1,1,5,4,0,0,0,0,0,1,12,5,25,2,9,0
"20240309DUNARB",2024-03-09,"Scotland Championship","Dundee United","Arbroath",4,0,"H",16,2,12,1,12,11,10,1,1,2,0,1,0,0,0,4,18,13,23,11,3,1
"20240309INVAIR",2024-03-09,"Scotland Championship","Inverness C","Airdrie Utd",0,0,"D",8,4,2,2,8,15,6,4,1,4,0,0,0,0,0,0,12,4,23,10,5,0
"20240309QUEPAR",2024-03-09,"Scotland Championship","Queens Park","Partick",2,2,"D",12,12,6,7,12,6,6,7,5,3,0,0,0,0,0,4,24,13,18,13,8,0
"20240309RAIDUN",2024-03-09,"Scotland Championship","Raith Rvs","Dunfermline",2,0,"H",10,13,6,5,9,10,5,8,3,3,0,0,0,0,0,2,23,11,19,13,6,0
"20240312PARRAI",2024-03-12,"Scotland Championship","Partick","Raith Rvs",0,1,"A",14,5,4,3,9,11,5,2,2,1,0,0,0,0,0,1,19,7,20,7,3,0
"20240315DUNDUN",2024-03-15,"Scotland Championship","Dunfermline","Dundee United",3,1,"H",11,14,4,3,8,10,4,4,1,2,0,0,0,0,0,4,25,7,18,8,3,0
"20240316AIRARB",2024-03-16,"Scotland Championship","Airdrie Utd","Arbroath",5,2,"H",14,5,9,2,10,14,11,5,2,4,0,0,0,0,0,7,19,11,24,16,6,0
"20240316INVAYR",2024-03-16,"Scotland Championship","Inverness C","Ayr",1,2,"A",8,5,2,3,11,17,6,4,2,1,0,0,0,0,0,3,13,5,28,10,3,0
"20240316PARMOR",2024-03-16,"Scotland Championship","Partick","Morton",2,1,"H",11,8,6,4,11,13,4,5,2,2,0,0,0,0,0,3,19,10,24,9,4,0
"20240316QUERAI",2024-03-16,"Scotland Championship","Queens Park","Raith Rvs",0,0,"D",10,14,1,4,10,6,9,11,2,1,0,0,0,0,0,0,24,5,16,20,3,0
"20240323ARBPAR",2024-03-23,"Scotland Championship","Arbroath","Partick",0,1,"A",5,9,2,4,8,9,5,4,0,1,0,0,0,0,0,1,14,6,17,9,1,0
"20240323AYRQUE",2024-03-23,"Scotland Championship","Ayr","Queens Park",1,2,"A",8,12,3,7,10,8,6,13,0,1,0,0,0,0,0,3,20,10,18,19,1,0
"20240323DUNINV",2024-03-23,"Scotland Championship","Dundee United","Inverness C",1,1,"D",18,7,7,3,8,7,7,5,1,3,0,0,0,0,0,2,25,10,15,12,4,0
"20240323MORDUN",2024-03-23,"Scotland Championship","Morton","Dunfermline",0,1,"A",10,9,2,5,7,13,4,8,3,1,0,0,0,0,0,1,19,7,20,12,4,0
"20240329AYRAIR",2024-03-29,"Scotland Championship","Ayr","Airdrie Utd",2,1,"H",12,9,4,5,11,14,7,7,0,2,0,0,0,0,0,3,21,9,25,14,2,0
"20240330ARBDUN",2024-03-30,"Scotland Championship","Arbroath","Dunfermline",2,3,"A",9,12,6,6,11,11,7,8,0,1,0,0,0,0,0,5,21,12,22,15,1,0
"20240330DUNRAI",2024-03-30,"Scotland Championship","Dundee United","Raith Rvs",2,0,"H",10,5,5,1,14,14,11,1,6,5,0,0,0,0,0,2,15,6,28,12,11,0
"20240330MORQUE",2024-03-30,"Scotland Championship","Morton","Queens Park",2,0,"H",14,10,6,1,13,12,7,1,4,2,0,0,0,0,0,2,24,7,25,8,6,0
"20240330PARINV",2024-03-30,"Scotland Championship","Partick","Inverness C",1,0,"H",10,11,5,4,18,10,4,4,1,0,0,1,0,0,0,1,21,9,28,8,1,1
"20240402ARBAIR",2024-04-02,"Scotland Championship","Arbroath","Airdrie Utd",1,2,"A",3,17,3,9,3,18,5,6,2,2,0,0,0,0,0,3,20,12,21,11,4,0
"20240406AIRMOR",2024-04-06,"Scotland Championship","Airdrie Utd","Morton",3,1,"H",11,13,6,3,13,14,6,6,2,5,0,0,0,0,0,4,24,9,27,12,7,0
"20240406DUNPAR",2024-04-06,"Scotland Championship","Dunfermline","Partick",1,1,"D",8,10,2,2,6,14,3,3,2,2,0,0,0,0,0,2,18,4,20,6,4,0
"20240406INVARB",2024-04-06,"Scotland Championship","Inverness C","Arbroath",2,1,"H",14,1,10,1,6,13,4,1,0,2,0,1,0,0,0,3,15,11,19,5,2,1
"20240406QUEDUN",2024-04-06,"Scotland Championship","Queens Park","Dundee United",0,5,"A",4,20,2,10,16,5,3,12,2,1,0,0,0,0,0,5,24,12,21,15,3,0
"20240406RAIAYR",2024-04-06,"Scotland Championship","Raith Rvs","Ayr",2,1,"H",5,3,2,2,10,17,2,2,2,2,0,0,0,0,0,3,8,4,27,4,4,0
"20240409AYRMOR",2024-04-09,"Scotland Championship","Ayr","Morton",1,1,"D",10,5,5,3,12,19,7,1,2,3,0,0,0,0,0,2,15,8,31,8,5,0
"20240409RAIAIR",2024-04-09,"Scotland Championship","Raith Rvs","Airdrie Utd",1,3,"A",15,9,4,5,7,10,3,3,1,2,0,0,0,0,0,4,24,9,17,6,3,0
"20240412MORDUN",2024-04-12,"Scotland Championship","Morton","Dundee United",1,4,"A",11,14,3,6,7,8,4,7,3,1,0,0,0,0,0,5,25,9,15,11,4,0
"20240413AIRDUN",2024-04-13,"Scotland Championship","Airdrie Utd","Dunfermline",2,1,"H",15,10,5,2,12,7,6,4,1,0,0,0,0,0,0,3,25,7,19,10,1,0
"20240413AYRARB",2024-04-13,"Scotland Championship","Ayr","Arbroath",5,0,"H",17,2,8,2,12,13,5,2,0,2,0,0,0,0,0,5,19,10,25,7,2,0
"20240413QUEINV",2024-04-13,"Scotland Championship","Queens Park","Inverness C",0,1,"A",11,6,3,2,14,13,3,3,1,2,0,0,0,0,0,1,17,5,27,6,3,0
"20240413RAIPAR",2024-04-13,"Scotland Championship","Raith Rvs","Partick",0,0,"D",12,9,6,2,7,14,6,3,2,2,0,0,0,0,0,0,21,8,21,9,4,0
"20240419INVRAI",2024-04-19,"Scotland Championship","Inverness C","Raith Rvs",0,1,"A",15,9,5,3,8,6,9,2,0,2,0,0,0,0,0,1,24,8,14,11,2,0
"20240420ARBMOR",2024-04-20,"Scotland Championship","Arbroath","Morton",1,2,"A",9,13,4,8,11,9,8,7,1,2,0,0,0,0,0,3,22,12,20,15,3,0
"20240420DUNAYR",2024-04-20,"Scotland Championship","Dundee United","Ayr",1,0,"H",20,8,4,2,10,9,12,2,1,3,0,1,0,0,0,1,28,6,19,14,4,1
"20240420DUNQUE",2024-04-20,"Scotland Championship","Dunfermline","Queens Park",0,0,"D",11,7,3,2,4,6,2,3,1,2,0,0,0,0,0,0,18,5,10,5,3,0
"20240420PARAIR",2024-04-20,"Scotland Championship","Partick","Airdrie Utd",4,0,"H",17,10,8,5,7,3,5,4,0,0,0,0,0,0,0,4,27,13,10,9,0,0
"20240426AIRDUN",2024-04-26,"Scotland Championship","Airdrie Utd","Dundee United",0,0,"D",16,6,6,1,3,9,5,0,0,0,0,0,0,0,0,0,22,7,12,5,0,0
"20240427ARBQUE",2024-04-27,"Scotland Championship","Arbroath","Queens Park",0,5,"A",1,14,0,6,6,9,1,5,0,1,0,0,0,0,0,5,15,6,15,6,1,0
"20240427DUNINV",2024-04-27,"Scotland Championship","Dunfermline","Inverness C",1,1,"D",8,9,5,6,13,8,5,8,2,1,0,0,0,0,0,2,17,11,21,13,3,0
"20240427MORRAI",2024-04-27,"Scotland Championship","Morton","Raith Rvs",0,0,"D",10,7,4,2,13,8,6,2,2,1,0,0,0,0,0,0,17,6,21,8,3,0
"20240427PARAYR",2024-04-27,"Scotland Championship","Partick","Ayr",0,0,"D",9,10,1,4,4,7,8,2,0,1,0,0,1,1,0,0,19,5,11,10,1,0
"20240503AYRDUN",2024-05-03,"Scotland Championship","Ayr","Dunfermline",3,3,"D",13,8,7,5,10,11,3,4,1,0,0,0,0,0,0,6,21,12,21,7,1,0
"20240503DUNPAR",2024-05-03,"Scotland Championship","Dundee United","Partick",4,1,"H",23,2,8,1,5,7,7,2,0,0,0,0,0,0,0,5,25,9,12,9,0,0
"20240503INVMOR",2024-05-03,"Scotland Championship","Inverness C","Morton",3,1,"H",8,4,7,2,13,11,4,4,0,3,0,0,0,0,0,4,12,9,24,8,3,0
"20240503QUEAIR",2024-05-03,"Scotland Championship","Queens Park","Airdrie Utd",2,0,"H",12,5,5,2,7,8,4,6,1,2,0,0,0,0,0,2,17,7,15,10,3,0
"20240503RAIARB",2024-05-03,"Scotland Championship","Raith Rvs","Arbroath",5,0,"H",12,3,8,2,7,16,6,5,0,0,0,0,0,0,0,5,15,10,23,11,0,0
"20240802FALQUE",2024-08-02,"Scotland Championship","Falkirk","Queens Park",2,1,"H",10,8,4,4,9,3,17,15,2,1,0,0,0,0,0,3,18,8,12,32,3,0
"20240803AIRRAI",2024-08-03,"Scotland Championship","Airdrie Utd","Raith Rvs",1,0,"H",12,4,2,1,14,10,7,3,2,3,0,0,1,0,1,1,16,3,24,10,5,0
"20240803HAMAYR",2024-08-03,"Scotland Championship","Hamilton","Ayr",0,2,"A",9,13,3,6,16,9,6,5,2,1,1,0,0,0,0,2,22,9,25,11,3,1
"20240803LIVDUN",2024-08-03,"Scotland Championship","Livingston","Dunfermline",2,0,"H",15,11,5,5,14,9,2,3,1,0,0,0,0,0,0,2,26,10,23,5,1,0
"20240803PARMOR",2024-08-03,"Scotland Championship","Partick","Morton",0,0,"D",6,8,3,2,14,7,8,5,2,1,0,0,0,0,0,0,14,5,21,13,3,0
"20240809AYRAIR",2024-08-09,"Scotland Championship","Ayr","Airdrie Utd",5,0,"H",23,5,13,1,12,13,4,5,1,3,0,0,0,0,0,5,28,14,25,9,4,0
"20240809QUELIV",2024-08-09,"Scotland Championship","Queens Park","Livingston",1,1,"D",13,15,4,5,10,9,5,10,0,3,0,0,0,0,0,2,28,9,19,15,3,0
"20240810DUNFAL",2024-08-10,"Scotland Championship","Dunfermline","Falkirk",0,2,"A",8,8,2,4,9,10,4,5,1,1,0,0,0,0,0,2,16,6,19,9,2,0
"20240810MORHAM",2024-08-10,"Scotland Championship","Morton","Hamilton",0,0,"D",9,7,3,1,11,12,4,3,1,3,0,0,0,0,0,0,16,4,23,7,4,0
"20240810RAIPAR",2024-08-10,"Scotland Championship","Raith Rvs","Partick",1,0,"H",6,10,2,6,12,14,2,6,4,2,0,1,0,0,0,1,16,8,26,8,6,1
"20240817AYRHAM",2024-08-17,"Scotland Championship","Ayr","Hamilton",3,2,"H",14,8,6,5,14,12,2,4,3,3,0,0,0,0,0,5,22,11,26,6,6,0
"20240824AIRQUE",2024-08-24,"Scotland Championship","Airdrie Utd","Queens Park",0,2,"A",11,2,2,4,14,12,6,1,3,2,0,1,0,0,0,2,13,6,26,7,5,1
"20240824AYRRAI",2024-08-24,"Scotland Championship","Ayr","Raith Rvs",2,0,"H",13,4,4,1,9,10,3,5,1,3,0,1,0,0,0,2,17,5,19,8,4,1
"20240824FALPAR",2024-08-24,"Scotland Championship","Falkirk","Partick",2,1,"H",21,7,7,3,9,9,13,0,2,3,0,1,0,0,0,3,28,10,18,13,5,1
"20240824HAMDUN",2024-08-24,"Scotland Championship","Hamilton","Dunfermline",1,0,"H",5,5,2,1,20,6,5,3,2,2,0,0,1,0,1,1,10,3,26,8,4,0
"20240824LIVMOR",2024-08-24,"Scotland Championship","Livingston","Morton",1,1,"D",14,2,6,2,13,11,7,1,2,3,0,0,0,0,0,2,16,8,24,8,5,0
"20240831DUNAYR",2024-08-31,"Scotland Championship","Dunfermline","Ayr",1,1,"D",5,9,5,5,13,13,2,5,2,3,0,0,0,0,0,2,14,10,26,7,5,0
"20240831HAMAIR",2024-08-31,"Scotland Championship","Hamilton","Airdrie Utd",2,2,"D",11,13,6,4,9,8,6,3,1,2,0,0,0,0,0,4,24,10,17,9,3,0
"20240831MORFAL",2024-08-31,"Scotland Championship","Morton","Falkirk",2,3,"A",11,10,4,6,13,18,2,9,4,3,0,0,0,0,0,5,21,10,31,11,7,0
"20240831PARQUE",2024-08-31,"Scotland Championship","Partick","Queens Park",3,0,"H",10,4,5,2,13,6,6,5,1,1,0,0,0,0,0,3,14,7,19,11,2,0
"20240831RAILIV",2024-08-31,"Scotland Championship","Raith Rvs","Livingston",0,1,"A",10,5,3,3,14,18,2,0,4,3,0,0,0,0,0,1,15,6,32,2,7,0
"20240913DUNRAI",2024-09-13,"Scotland Championship","Dunfermline","Raith Rvs",2,0,"H",13,3,3,0,10,16,5,0,3,4,0,1,0,0,0,2,16,3,26,5,7,1
"20240914AIRFAL",2024-09-14,"Scotland Championship","Airdrie Utd","Falkirk",0,2,"A",11,22,4,7,9,11,3,14,3,4,0,0,0,0,0,2,33,11,20,17,7,0
"20240914AYRPAR",2024-09-14,"Scotland Championship","Ayr","Partick",1,1,"D",10,7,5,5,15,10,3,11,3,3,0,0,0,0,0,2,17,10,25,14,6,0
"20240914LIVHAM",2024-09-14,"Scotland Championship","Livingston","Hamilton",3,0,"H",13,1,4,0,12,18,5,3,4,4,0,0,0,0,0,3,14,4,30,8,8,0
"20240914QUEMOR",2024-09-14,"Scotland Championship","Queens Park","Morton",1,0,"H",14,5,4,3,12,6,8,6,5,4,0,0,0,0,0,1,19,7,18,14,9,0
"20240921MORAIR",2024-09-21,"Scotland Championship","Morton","Airdrie Utd",2,0,"H",16,3,5,1,7,15,8,4,0,0,0,1,0,0,0,2,19,6,22,12,0,1
"20240921PARDUN",2024-09-21,"Scotland Championship","Partick","Dunfermline",1,0,"H",8,5,1,1,20,20,6,2,2,4,0,0,0,0,0,1,13,2,40,8,6,0
"20240921QUEAYR",2024-09-21,"Scotland Championship","Queens Park","Ayr",1,1,"D",7,13,2,6,10,9,4,10,2,2,0,0,0,0,0,2,20,8,19,14,4,0
"20240921RAIHAM",2024-09-21,"Scotland Championship","Raith Rvs","Hamilton",3,3,"D",11,5,8,4,7,15,5,2,1,2,0,0,0,0,0,6,16,12,22,7,3,0
"20240928AYRMOR",2024-09-28,"Scotland Championship","Ayr","Morton",1,0,"H",12,4,5,2,14,8,5,2,2,3,0,0,0,0,0,1,16,7,22,7,5,0
"20240928DUNQUE",2024-09-28,"Scotland Championship","Dunfermline","Queens Park",1,2,"A",14,6,3,5,9,6,12,3,2,2,0,0,0,0,0,3,20,8,15,15,4,0
"20240928HAMPAR",2024-09-28,"Scotland Championship","Hamilton","Partick",1,0,"H",8,9,3,4,9,7,1,12,1,4,0,0,0,0,0,1,17,7,16,13,5,0
"20240928LIVAIR",2024-09-28,"Scotland Championship","Livingston","Airdrie Utd",2,1,"H",9,3,3,1,8,12,7,8,2,4,0,0,0,0,0,3,12,4,20,15,6,0
"20240928RAIFAL",2024-09-28,"Scotland Championship","Raith Rvs","Falkirk",1,0,"H",4,4,1,0,12,13,2,4,2,4,0,0,0,0,0,1,8,1,25,6,6,0
"20241005AIRDUN",2024-10-05,"Scotland Championship","Airdrie Utd","Dunfermline",1,1,"D",12,10,5,5,14,17,6,4,4,3,0,0,0,0,0,2,22,10,31,10,7,0
"20241005FALAYR",2024-10-05,"Scotland Championship","Falkirk","Ayr",2,0,"H",13,6,5,4,13,14,6,2,0,0,0,0,0,0,0,2,19,9,27,8,0,0
"20241005MORRAI",2024-10-05,"Scotland Championship","Morton","Raith Rvs",2,0,"H",9,10,7,2,13,9,5,10,3,1,0,0,0,0,0,2,19,9,22,15,4,0
"20241005PARLIV",2024-10-05,"Scotland Championship","Partick","Livingston",0,0,"D",12,9,2,2,12,12,9,5,3,2,0,0,0,0,0,0,21,4,24,14,5,0
"20241005QUEHAM",2024-10-05,"Scotland Championship","Queens Park","Hamilton",1,0,"H",17,11,6,3,9,8,3,2,1,1,0,0,0,0,0,1,28,9,17,5,2,0
"20241008FALLIV",2024-10-08,"Scotland Championship","Falkirk","Livingston",0,0,"D",10,3,3,2,11,10,8,5,3,1,0,0,0,0,0,0,13,5,21,13,4,0
"20241012PARFAL",2024-10-12,"Scotland Championship","Partick","Falkirk",1,1,"D",7,20,2,6,12,8,4,13,2,0,0,0,0,0,0,2,27,8,20,17,2,0
"20241018HAMFAL",2024-10-18,"Scotland Championship","Hamilton","Falkirk",1,3,"A",7,13,4,6,26,9,1,4,7,3,0,0,0,0,0,4,20,10,35,5,10,0
"20241019AYRLIV",2024-10-19,"Scotland Championship","Ayr","Livingston",1,2,"A",19,5,6,4,8,10,9,1,3,4,0,0,0,0,0,3,24,10,18,10,7,0
"20241019DUNMOR",2024-10-19,"Scotland Championship","Dunfermline","Morton",0,0,"D",12,7,4,4,12,11,6,0,3,1,0,0,0,0,0,0,19,8,23,6,4,0
"20241019PARAIR",2024-10-19,"Scotland Championship","Partick","Airdrie Utd",2,1,"H",11,3,4,2,9,7,7,1,2,0,0,1,0,0,0,3,14,6,16,8,2,1
"20241019RAIQUE",2024-10-19,"Scotland Championship","Raith Rvs","Queens Park",1,1,"D",11,4,6,2,13,9,10,7,3,1,1,0,0,0,0,2,15,8,22,17,4,1
"20241026AIRAYR",2024-10-26,"Scotland Championship","Airdrie Utd","Ayr",0,1,"A",7,6,2,2,18,12,6,7,3,2,0,0,0,0,0,1,13,4,30,13,5,0
"20241026FALDUN",2024-10-26,"Scotland Championship","Falkirk","Dunfermline",2,1,"H",12,8,5,5,14,14,6,4,2,4,0,0,0,0,0,3,20,10,28,10,6,0
"20241026HAMMOR",2024-10-26,"Scotland Championship","Hamilton","Morton",3,0,"H",9,5,5,1,12,10,9,4,0,3,0,0,0,0,0,3,14,6,22,13,3,0
"20241026LIVRAI",2024-10-26,"Scotland Championship","Livingston","Raith Rvs",2,1,"H",8,10,5,5,14,6,5,5,1,1,1,1,0,0,0,3,18,10,20,10,2,2
"20241026QUEPAR",2024-10-26,"Scotland Championship","Queens Park","Partick",0,1,"A",9,8,4,3,9,11,5,3,1,1,0,0,0,0,0,1,17,7,20,8,2,0
"20241029DUNLIV",2024-10-29,"Scotland Championship","Dunfermline","Livingston",3,0,"H",15,6,6,3,15,16,6,5,2,3,0,0,0,0,0,3,21,9,31,11,5,0
"20241029MORQUE",2024-10-29,"Scotland Championship","Morton","Queens Park",0,1,"A",13,9,5,6,11,9,8,3,4,2,1,0,1,0,1,1,22,11,20,11,6,1
"20241029RAIAIR",2024-10-29,"Scotland Championship","Raith Rvs","Airdrie Utd",1,0,"H",6,5,3,3,14,10,3,3,1,1,0,0,0,0,0,1,11,6,24,6,2,0
"20241101RAIAYR",2024-11-01,"Scotland Championship","Raith Rvs","Ayr",2,0,"H",12,3,5,2,14,6,3,4,3,1,0,0,0,0,0,2,15,7,20,7,4,0
"20241102AIRHAM",2024-11-02,"Scotland Championship","Airdrie Utd","Hamilton",0,4,"A",18,19,9,10,12,10,16,6,2,2,0,0,0,0,0,4,37,19,22,22,4,0
"20241102DUNPAR",2024-11-02,"Scotland Championship","Dunfermline","Partick",0,1,"A",9,6,2,3,13,8,6,2,2,2,0,0,0,0,0,1,15,5,21,8,4,0
"20241102FALMOR",2024-11-02,"Scotland Championship","Falkirk","Morton",6,0,"H",19,3,13,2,10,11,17,0,0,3,0,0,2,2,0,6,22,15,21,17,3,0
"20241102LIVQUE",2024-11-02,"Scotland Championship","Livingston","Queens Park",1,1,"D",13,7,5,3,15,9,6,4,4,2,0,1,0,0,0,2,20,8,24,10,6,1
"20241108MORAYR",2024-11-08,"Scotland Championship","Morton","Ayr",1,1,"D",7,8,3,5,12,20,4,4,1,5,0,0,0,0,0,2,15,8,32,8,6,0
"20241109FALAIR",2024-11-09,"Scotland Championship","Falkirk","Airdrie Utd",2,0,"H",22,9,9,2,10,12,4,3,1,3,0,0,1,0,1,2,31,11,22,7,4,0
"20241109HAMLIV",2024-11-09,"Scotland Championship","Hamilton","Livingston",1,3,"A",9,12,4,6,15,13,5,3,2,2,0,0,0,0,0,4,21,10,28,8,4,0
"20241109PARRAI",2024-11-09,"Scotland Championship","Partick","Raith Rvs",1,1,"D",10,12,2,4,11,9,3,5,1,2,0,0,0,0,0,2,22,6,20,8,3,0
"20241109QUEDUN",2024-11-09,"Scotland Championship","Queens Park","Dunfermline",2,1,"H",11,19,4,4,8,6,4,10,1,1,0,0,0,0,0,3,30,8,14,14,2,0
"20241116AYRQUE",2024-11-16,"Scotland Championship","Ayr","Queens Park",3,2,"H",10,8,4,4,10,12,3,7,2,2,0,1,0,0,0,5,18,8,22,10,4,1
"20241116DUNAIR",2024-11-16,"Scotland Championship","Dunfermline","Airdrie Utd",1,0,"H",9,7,5,2,11,10,5,9,1,3,0,0,0,0,0,1,16,7,21,14,4,0
"20241116LIVFAL",2024-11-16,"Scotland Championship","Livingston","Falkirk",1,0,"H",7,6,2,1,18,15,3,8,5,2,0,0,0,0,0,1,13,3,33,11,7,0
"20241116PARHAM",2024-11-16,"Scotland Championship","Partick","Hamilton",5,1,"H",19,7,10,2,10,12,5,0,2,1,0,0,0,0,0,6,26,12,22,5,3,0
"20241116RAIMOR",2024-11-16,"Scotland Championship","Raith Rvs","Morton",2,3,"A",12,5,6,4,8,11,8,2,1,3,0,0,0,0,0,5,17,10,19,10,4,0
"20241122QUEFAL",2024-11-22,"Scotland Championship","Queens Park","Falkirk",0,1,"A",5,22,1,8,7,6,2,4,2,2,0,0,0,0,0,1,27,9,13,6,4,0
"20241123AYRDUN",2024-11-23,"Scotland Championship","Ayr","Dunfermline",1,0,"H",10,3,6,2,12,10,6,5,3,4,0,0,0,0,0,1,13,8,22,11,7,0
"20241207DUNHAM",2024-12-07,"Scotland Championship","Dunfermline","Hamilton",3,2,"H",10,7,3,3,12,13,12,2,2,0,0,0,0,0,0,5,17,6,25,14,2,0
"20241207FALRAI",2024-12-07,"Scotland Championship","Falkirk","Raith Rvs",3,0,"H",14,2,7,1,8,13,10,4,1,2,0,0,0,0,0,3,16,8,21,14,3,0
"20241207MORLIV",2024-12-07,"Scotland Championship","Morton","Livingston",0,0,"D",2,6,0,0,9,14,3,8,1,0,0,0,0,0,0,0,8,0,23,11,1,0
"20241207PARAYR",2024-12-07,"Scotland Championship","Partick","Ayr",1,0,"H",8,9,4,4,6,14,4,7,0,5,0,0,0,0,0,1,17,8,20,11,5,0
"20241207QUEAIR",2024-12-07,"Scotland Championship","Queens Park","Airdrie Utd",2,0,"H",21,8,7,3,11,5,12,4,0,1,0,0,0,0,0,2,29,10,16,16,1,0
"20241213LIVPAR",2024-12-13,"Scotland Championship","Livingston","Partick",2,0,"H",17,7,7,1,20,13,6,6,1,4,0,0,0,0,0,2,24,8,33,12,5,0
"20241214AIRMOR",2024-12-14,"Scotland Championship","Airdrie Utd","Morton",2,2,"D",14,8,7,3,8,16,3,2,4,3,0,0,0,0,0,4,22,10,24,5,7,0
"20241214AYRFAL",2024-12-14,"Scotland Championship","Ayr","Falkirk",5,2,"H",12,2,6,2,10,7,9,3,1,1,0,1,0,0,0,7,14,8,17,12,2,1
"20241214HAMQUE",2024-12-14,"Scotland Championship","Hamilton","Queens Park",2,1,"H",12,9,7,3,17,11,8,8,5,4,0,0,0,0,0,3,21,10,28,16,9,0
"20241214RAIDUN",2024-12-14,"Scotland Championship","Raith Rvs","Dunfermline",2,0,"H",6,5,3,4,11,15,3,1,0,0,0,0,0,0,0,2,11,7,26,4,0,0
"20241217AIRLIV",2024-12-17,"Scotland Championship","Airdrie Utd","Livingston",0,3,"A",8,10,2,6,10,9,4,4,2,1,0,0,0,0,0,3,18,8,19,8,3,0
"20241220QUERAI",2024-12-20,"Scotland Championship","Queens Park","Raith Rvs",1,2,"A",16,9,6,3,10,8,8,0,5,1,0,0,0,0,0,3,25,9,18,8,6,0
"20241221AIRPAR",2024-12-21,"Scotland Championship","Airdrie Utd","Partick",0,2,"A",12,9,4,5,7,8,7,5,1,1,0,0,0,0,0,2,21,9,15,12,2,0
"20241221FALHAM",2024-12-21,"Scotland Championship","Falkirk","Hamilton",1,0,"H",15,7,5,4,8,14,8,5,0,5,0,0,0,0,0,1,22,9,22,13,5,0
"20241221LIVAYR",2024-12-21,"Scotland Championship","Livingston","Ayr",0,1,"A",7,3,2,3,10,10,12,3,2,6,0,0,0,0,0,1,10,5,20,15,8,0
"20241221MORDUN",2024-12-21,"Scotland Championship","Morton","Dunfermline",2,0,"H",7,10,4,3,17,13,2,2,3,2,0,1,0,0,0,2,17,7,30,4,5,1
"20241227DUNFAL",2024-12-27,"Scotland Championship","Dunfermline","Falkirk",3,3,"D",6,8,5,5,11,14,3,6,2,3,0,0,0,0,0,6,14,10,25,9,5,0
"20241228AYRMOR",2024-12-28,"Scotland Championship","Ayr","Morton",0,0,"D",8,3,3,2,12,7,8,2,3,1,0,0,0,0,0,0,11,5,19,10,4,0
"20241228HAMAIR",2024-12-28,"Scotland Championship","Hamilton","Airdrie Utd",3,2,"H",20,13,5,6,14,6,7,2,1,1,0,0,0,0,0,5,33,11,20,9,2,0
"20241228PARQUE",2024-12-28,"Scotland Championship","Partick","Queens Park",2,1,"H",10,8,5,3,7,8,6,11,3,3,0,0,0,0,0,3,18,8,15,17,6,0
"20241228RAILIV",2024-12-28,"Scotland Championship","Raith Rvs","Livingston",2,1,"H",4,6,2,3,14,9,2,2,4,5,0,0,0,0,0,3,10,5,23,4,9,0
"20241231MORPAR",2024-12-31,"Scotland Championship","Morton","Partick",2,1,"H",10,8,4,2,8,7,1,4,2,1,0,0,0,0,0,3,18,6,15,5,3,0
"20220102DUMAIR",2022-01-02,"Scotland League 1","Dumbarton","Airdrie Utd",0,1,"A",10,11,3,4,9,14,4,9,1,1,0,0,0,0,0,1,21,7,23,13,2,0
"20220102EASMON",2022-01-02,"Scotland League 1","East Fife","Montrose",0,2,"A",7,7,4,4,11,10,1,10,0,0,1,0,0,0,0,2,14,8,21,11,0,1
"20220102PETCOV",2022-01-02,"Scotland League 1","Peterhead","Cove Rangers",0,1,"A",9,17,5,4,16,14,2,4,4,1,1,0,0,0,0,1,26,9,30,6,5,1
"20220108AIREAS",2022-01-08,"Scotland League 1","Airdrie Utd","East Fife",3,0,"H",10,10,8,6,5,8,8,1,4,2,0,0,0,0,0,3,20,14,13,9,6,0
"20220108CLYCOV",2022-01-08,"Scotland League 1","Clyde","Cove Rangers",0,1,"A",4,8,1,3,12,11,8,6,3,2,0,0,0,0,0,1,12,4,23,14,5,0
"20220108FALDUM",2022-01-08,"Scotland League 1","Falkirk","Dumbarton",6,2,"H",14,6,8,3,10,12,10,5,2,3,0,0,0,0,0,8,20,11,22,15,5,0
"20220108MONALL",2022-01-08,"Scotland League 1","Montrose","Alloa",1,1,"D",15,11,6,4,5,17,6,1,0,2,0,0,0,0,0,2,26,10,22,7,2,0
"20220115AIRFAL",2022-01-15,"Scotland League 1","Airdrie Utd","Falkirk",3,2,"H",9,9,4,6,12,10,6,3,1,4,0,0,0,0,0,5,18,10,22,9,5,0
"20220115ALLQUE",2022-01-15,"Scotland League 1","Alloa","Queens Park",1,1,"D",5,8,3,3,12,10,4,8,1,1,0,0,0,0,0,2,13,6,22,12,2,0
"20220115COVMON",2022-01-15,"Scotland League 1","Cove Rangers","Montrose",1,0,"H",14,7,4,2,10,15,5,3,0,3,0,0,0,0,0,1,21,6,25,8,3,0
"20220115DUMEAS",2022-01-15,"Scotland League 1","Dumbarton","East Fife",2,0,"H",12,15,6,2,7,9,5,9,2,1,0,0,0,0,0,2,27,8,16,14,3,0
"20220115PETCLY",2022-01-15,"Scotland League 1","Peterhead","Clyde",1,1,"D",18,5,8,2,9,19,9,2,0,2,0,0,0,0,0,2,23,10,28,11,2,0
"20220122CLYQUE",2022-01-22,"Scotland League 1","Clyde","Queens Park",1,1,"D",6,11,4,5,11,10,2,8,2,2,0,0,0,0,0,2,17,9,21,10,4,0
"20220122EASFAL",2022-01-22,"Scotland League 1","East Fife","Falkirk",0,2,"A",13,10,5,2,12,10,7,3,3,2,1,0,0,0,0,2,23,7,22,10,5,1
"20220125CLYAIR",2022-01-25,"Scotland League 1","Clyde","Airdrie Utd",2,2,"D",6,19,2,5,9,7,3,10,2,1,0,0,0,0,0,4,25,7,16,13,3,0
"20220129CLYALL",2022-01-29,"Scotland League 1","Clyde","Alloa",2,1,"H",7,13,4,6,10,6,1,6,1,2,0,0,0,0,0,3,20,10,16,7,3,0
"20220129DUMCOV",2022-01-29,"Scotland League 1","Dumbarton","Cove Rangers",2,2,"D",7,15,4,6,7,12,1,11,2,2,0,0,0,0,0,4,22,10,19,12,4,0
"20220129EASPET",2022-01-29,"Scotland League 1","East Fife","Peterhead",0,0,"D",10,9,3,1,17,16,3,5,3,3,0,0,0,0,0,0,19,4,33,8,6,0
"20220129MONFAL",2022-01-29,"Scotland League 1","Montrose","Falkirk",2,1,"H",13,9,6,4,8,19,2,5,2,3,0,0,0,0,0,3,22,10,27,7,5,0
"20220129QUEAIR",2022-01-29,"Scotland League 1","Queens Park","Airdrie Utd",1,1,"D",4,9,2,2,8,9,8,6,3,1,0,0,0,0,0,2,13,4,17,14,4,0
"20220205COVAIR",2022-02-05,"Scotland League 1","Cove Rangers","Airdrie Utd",1,1,"D",11,10,6,4,9,10,7,7,0,0,0,0,0,0,0,2,21,10,19,14,0,0
"20220205EASCLY",2022-02-05,"Scotland League 1","East Fife","Clyde",0,0,"D",4,3,4,1,8,8,4,6,3,0,0,0,0,0,0,0,7,5,16,10,3,0
"20220205FALQUE",2022-02-05,"Scotland League 1","Falkirk","Queens Park",1,1,"D",12,11,3,6,8,13,10,4,1,4,1,0,0,0,0,2,23,9,21,14,5,1
"20220205MONDUM",2022-02-05,"Scotland League 1","Montrose","Dumbarton",1,1,"D",14,5,4,2,12,10,7,0,3,3,0,1,0,0,0,2,19,6,22,7,6,1
"20220205PETALL",2022-02-05,"Scotland League 1","Peterhead","Alloa",0,1,"A",10,6,5,4,10,17,9,1,4,4,0,0,0,0,0,1,16,9,27,10,8,0
"20220208ALLFAL",2022-02-08,"Scotland League 1","Alloa","Falkirk",0,3,"A",11,10,5,5,11,3,2,5,2,0,0,0,0,0,0,3,21,10,14,7,2,0
"20220208QUEDUM",2022-02-08,"Scotland League 1","Queens Park","Dumbarton",2,1,"H",10,10,4,3,9,7,5,3,1,2,0,0,0,0,0,3,20,7,16,8,3,0
"20220212AIRMON",2022-02-12,"Scotland League 1","Airdrie Utd","Montrose",4,1,"H",6,11,5,5,14,8,0,6,0,4,0,0,0,0,0,5,17,10,22,6,4,0
"20220212ALLEAS",2022-02-12,"Scotland League 1","Alloa","East Fife",1,3,"A",5,9,2,7,12,9,5,3,2,2,1,0,0,0,0,4,14,9,21,8,4,1
"20220212CLYDUM",2022-02-12,"Scotland League 1","Clyde","Dumbarton",1,3,"A",4,7,2,4,20,10,2,11,3,1,1,0,0,0,0,4,11,6,30,13,4,1
"20220212COVQUE",2022-02-12,"Scotland League 1","Cove Rangers","Queens Park",0,0,"D",13,2,4,0,8,10,9,2,3,4,0,1,0,0,0,0,15,4,18,11,7,1
"20220219COVFAL",2022-02-19,"Scotland League 1","Cove Rangers","Falkirk",2,0,"H",20,8,8,2,12,5,8,7,3,1,0,1,0,0,0,2,28,10,17,15,4,1
"20220219DUMALL",2022-02-19,"Scotland League 1","Dumbarton","Alloa",1,2,"A",13,15,7,10,9,6,9,7,2,0,0,0,0,0,0,3,28,17,15,16,2,0
"20220219EASQUE",2022-02-19,"Scotland League 1","East Fife","Queens Park",1,1,"D",11,10,3,3,8,7,6,7,1,1,0,0,0,0,0,2,21,6,15,13,2,0
"20220219MONCLY",2022-02-19,"Scotland League 1","Montrose","Clyde",1,1,"D",14,8,6,2,9,14,8,1,5,4,1,0,0,0,0,2,22,8,23,9,9,1
"20220219PETAIR",2022-02-19,"Scotland League 1","Peterhead","Airdrie Utd",0,1,"A",14,4,2,2,10,12,8,3,1,2,0,0,0,0,0,1,18,4,22,11,3,0
"20220222FALPET",2022-02-22,"Scotland League 1","Falkirk","Peterhead",1,1,"D",8,15,3,7,9,14,7,4,2,3,0,0,0,0,0,2,23,10,23,11,5,0
"20220226AIRCLY",2022-02-26,"Scotland League 1","Airdrie Utd","Clyde",1,1,"D",21,7,9,4,5,15,3,0,2,3,0,0,0,0,0,2,28,13,20,3,5,0
"20220226ALLCOV",2022-02-26,"Scotland League 1","Alloa","Cove Rangers",2,2,"D",8,7,4,4,11,12,6,1,1,3,1,0,0,0,0,4,15,8,23,7,4,1
"20220226FALEAS",2022-02-26,"Scotland League 1","Falkirk","East Fife",3,1,"H",19,14,8,5,7,12,6,2,1,4,0,0,0,0,0,4,33,13,19,8,5,0
"20220226PETDUM",2022-02-26,"Scotland League 1","Peterhead","Dumbarton",4,3,"H",17,10,8,4,16,11,6,9,0,0,0,2,0,0,0,7,27,12,27,15,0,2
"20220226QUEMON",2022-02-26,"Scotland League 1","Queens Park","Montrose",0,1,"A",7,6,2,3,10,9,2,6,0,1,0,0,0,0,0,1,13,5,19,8,1,0
"20220301QUEPET",2022-03-01,"Scotland League 1","Queens Park","Peterhead",2,1,"H",9,7,3,3,10,11,1,7,4,4,0,0,0,0,0,3,16,6,21,8,8,0
"20220305ALLAIR",2022-03-05,"Scotland League 1","Alloa","Airdrie Utd",0,2,"A",5,11,2,5,8,8,7,4,0,1,0,0,0,0,0,2,16,7,16,11,1,0
"20220305CLYFAL",2022-03-05,"Scotland League 1","Clyde","Falkirk",1,1,"D",11,12,5,5,16,10,4,5,2,2,0,0,0,0,0,2,23,10,26,9,4,0
"20220305COVPET",2022-03-05,"Scotland League 1","Cove Rangers","Peterhead",5,2,"H",13,9,8,5,16,8,3,5,1,2,0,0,0,0,0,7,22,13,24,8,3,0
"20220305DUMQUE",2022-03-05,"Scotland League 1","Dumbarton","Queens Park",0,3,"A",7,8,3,5,8,9,3,3,0,1,0,0,0,0,0,3,15,8,17,6,1,0
"20220305MONEAS",2022-03-05,"Scotland League 1","Montrose","East Fife",0,0,"D",12,8,2,2,13,14,5,1,2,1,1,0,0,0,0,0,20,4,27,6,3,1
"20220312COVCLY",2022-03-12,"Scotland League 1","Cove Rangers","Clyde",4,1,"H",9,9,5,3,7,14,4,4,0,5,1,0,0,0,0,5,18,8,21,8,5,1
"20220312EASDUM",2022-03-12,"Scotland League 1","East Fife","Dumbarton",2,0,"H",4,5,2,3,NA,NA,4,5,3,1,0,1,0,0,0,2,9,5,NA,9,4,1
"20220312FALAIR",2022-03-12,"Scotland League 1","Falkirk","Airdrie Utd",1,4,"A",7,19,4,9,8,8,4,1,3,1,0,0,0,0,0,5,26,13,16,5,4,0
"20220312PETMON",2022-03-12,"Scotland League 1","Peterhead","Montrose",0,1,"A",12,4,4,1,9,22,3,3,2,3,0,2,0,0,0,1,16,5,31,6,5,2
"20220312QUEALL",2022-03-12,"Scotland League 1","Queens Park","Alloa",1,1,"D",13,9,5,6,9,5,5,4,2,0,0,0,0,0,0,2,22,11,14,9,2,0
"20220319AIRQUE",2022-03-19,"Scotland League 1","Airdrie Utd","Queens Park",2,0,"H",11,9,4,2,8,5,6,5,0,0,0,0,0,0,0,2,20,6,13,11,0,0
"20220319ALLPET",2022-03-19,"Scotland League 1","Alloa","Peterhead",1,0,"H",12,5,7,2,14,12,4,3,1,2,0,0,0,0,0,1,17,9,26,7,3,0
"20220319CLYEAS",2022-03-19,"Scotland League 1","Clyde","East Fife",2,0,"H",11,7,4,2,18,7,3,5,2,0,0,0,0,0,0,2,18,6,25,8,2,0
"20220319DUMFAL",2022-03-19,"Scotland League 1","Dumbarton","Falkirk",0,2,"A",2,14,1,3,11,11,4,8,0,4,0,0,0,0,0,2,16,4,22,12,4,0
"20220319MONCOV",2022-03-19,"Scotland League 1","Montrose","Cove Rangers",1,2,"A",7,13,3,6,15,7,3,8,3,3,0,0,0,0,0,3,20,9,22,11,6,0
"20220326AIRCOV",2022-03-26,"Scotland League 1","Airdrie Utd","Cove Rangers",1,1,"D",11,16,5,6,14,15,2,3,3,2,0,0,0,0,0,2,27,11,29,5,5,0
"20220326DUMMON",2022-03-26,"Scotland League 1","Dumbarton","Montrose",0,0,"D",6,8,0,2,14,7,5,5,2,1,0,1,0,0,0,0,14,2,21,10,3,1
"20220326EASALL",2022-03-26,"Scotland League 1","East Fife","Alloa",0,3,"A",4,14,0,7,9,14,1,3,2,1,0,0,0,0,0,3,18,7,23,4,3,0
"20220326PETFAL",2022-03-26,"Scotland League 1","Peterhead","Falkirk",1,0,"H",12,4,6,1,10,16,5,1,4,1,0,1,0,0,0,1,16,7,26,6,5,1
"20220326QUECLY",2022-03-26,"Scotland League 1","Queens Park","Clyde",1,0,"H",11,7,4,0,12,15,3,4,1,2,1,0,0,0,0,1,18,4,27,7,3,1
"20220402ALLDUM",2022-04-02,"Scotland League 1","Alloa","Dumbarton",2,3,"A",10,7,4,5,9,9,8,5,1,1,0,0,0,0,0,5,17,9,18,13,2,0
"20220402CLYPET",2022-04-02,"Scotland League 1","Clyde","Peterhead",0,3,"A",1,10,1,7,17,12,1,0,4,2,0,0,0,0,0,3,11,8,29,1,6,0
"20220402EASAIR",2022-04-02,"Scotland League 1","East Fife","Airdrie Utd",0,2,"A",11,18,6,8,9,8,3,7,2,1,0,0,0,0,0,2,29,14,17,10,3,0
"20220402FALMON",2022-04-02,"Scotland League 1","Falkirk","Montrose",0,3,"A",10,18,1,7,15,11,9,6,2,2,0,0,0,0,0,3,28,8,26,15,4,0
"20220403QUECOV",2022-04-03,"Scotland League 1","Queens Park","Cove Rangers",1,1,"D",12,10,4,6,2,12,5,2,0,1,0,0,0,0,0,2,22,10,14,7,1,0
"20220409ALLCLY",2022-04-09,"Scotland League 1","Alloa","Clyde",1,0,"H",19,1,6,0,13,15,4,0,1,3,0,0,0,0,0,1,20,6,28,4,4,0
"20220409DUMPET",2022-04-09,"Scotland League 1","Dumbarton","Peterhead",1,1,"D",7,9,4,5,9,12,9,2,0,5,0,0,0,0,0,2,16,9,21,11,5,0
"20220409FALCOV",2022-04-09,"Scotland League 1","Falkirk","Cove Rangers",0,2,"A",7,12,1,7,10,15,1,3,3,2,0,0,0,0,0,2,19,8,25,4,5,0
"20220409MONAIR",2022-04-09,"Scotland League 1","Montrose","Airdrie Utd",2,2,"D",15,20,9,9,11,8,7,6,1,1,0,0,0,0,0,4,35,18,19,13,2,0
"20220409QUEEAS",2022-04-09,"Scotland League 1","Queens Park","East Fife",1,0,"H",10,7,2,1,6,12,7,4,0,2,0,0,0,0,0,1,17,3,18,11,2,0
"20220416AIRDUM",2022-04-16,"Scotland League 1","Airdrie Utd","Dumbarton",3,2,"H",13,15,6,7,7,8,7,7,1,1,1,0,0,0,0,5,28,13,15,14,2,1
"20220416CLYMON",2022-04-16,"Scotland League 1","Clyde","Montrose",2,1,"H",8,11,5,5,10,9,4,10,2,1,0,0,0,0,0,3,19,10,19,14,3,0
"20220416COVALL",2022-04-16,"Scotland League 1","Cove Rangers","Alloa",3,0,"H",11,10,5,6,4,6,14,9,0,1,0,0,0,0,0,3,21,11,10,23,1,0
"20220416EASFAL",2022-04-16,"Scotland League 1","East Fife","Falkirk",1,3,"A",10,8,6,4,11,8,4,4,1,1,0,0,0,0,0,4,18,10,19,8,2,0
"20220416PETQUE",2022-04-16,"Scotland League 1","Peterhead","Queens Park",2,1,"H",5,5,3,2,9,8,4,2,2,2,1,0,0,0,0,3,10,5,17,6,4,1
"20220423CLYAIR",2022-04-23,"Scotland League 1","Clyde","Airdrie Utd",0,5,"A",9,11,4,8,12,11,5,4,5,2,0,0,0,0,0,5,20,12,23,9,7,0
"20220423COVDUM",2022-04-23,"Scotland League 1","Cove Rangers","Dumbarton",1,0,"H",13,6,4,2,9,10,9,2,3,1,0,0,0,0,0,1,19,6,19,11,4,0
"20220423FALALL",2022-04-23,"Scotland League 1","Falkirk","Alloa",1,2,"A",9,7,7,4,12,5,10,1,0,1,0,0,0,0,0,3,16,11,17,11,1,0
"20220423MONQUE",2022-04-23,"Scotland League 1","Montrose","Queens Park",2,1,"H",10,6,2,3,9,12,6,2,1,2,0,0,0,0,0,3,16,5,21,8,3,0
"20220423PETEAS",2022-04-23,"Scotland League 1","Peterhead","East Fife",1,0,"H",17,8,8,6,12,10,4,2,1,0,0,0,0,0,0,1,25,14,22,6,1,0
"20220430AIRPET",2022-04-30,"Scotland League 1","Airdrie Utd","Peterhead",1,1,"D",5,10,4,6,16,9,1,6,1,2,0,0,0,0,0,2,15,10,25,7,3,0
"20220430ALLMON",2022-04-30,"Scotland League 1","Alloa","Montrose",4,1,"H",12,8,11,4,4,6,7,6,0,0,1,0,0,0,0,5,20,15,10,13,0,1
"20220430DUMCLY",2022-04-30,"Scotland League 1","Dumbarton","Clyde",2,1,"H",11,7,6,2,12,12,8,5,0,0,0,1,0,0,0,3,18,8,24,13,0,1
"20220430EASCOV",2022-04-30,"Scotland League 1","East Fife","Cove Rangers",2,3,"A",8,11,5,5,7,6,2,4,1,1,0,0,0,0,0,5,19,10,13,6,2,0
"20220430QUEFAL",2022-04-30,"Scotland League 1","Queens Park","Falkirk",1,1,"D",10,9,3,4,12,8,4,5,2,2,0,0,0,0,0,2,19,7,20,9,4,0
"20220730DUNALL",2022-07-30,"Scotland League 1","Dunfermline","Alloa",1,0,"H",11,13,3,7,9,8,6,4,1,1,0,0,0,0,0,1,24,10,17,10,2,0
"20220730FALMON",2022-07-30,"Scotland League 1","Falkirk","Montrose",0,0,"D",14,14,5,4,11,11,3,9,1,3,0,0,0,0,0,0,28,9,22,12,4,0
"20220730KELFC ",2022-07-30,"Scotland League 1","Kelty Hearts","FC Edinburgh",0,2,"A",10,4,6,4,12,10,6,3,2,1,0,0,0,0,0,2,14,10,22,9,3,0
"20220730PETAIR",2022-07-30,"Scotland League 1","Peterhead","Airdrie Utd",0,2,"A",9,18,2,8,12,12,2,12,2,0,0,0,0,0,0,2,27,10,24,14,2,0
"20220730QUECLY",2022-07-30,"Scotland League 1","Queen of Sth","Clyde",1,4,"A",11,11,6,5,13,13,0,4,0,2,1,0,0,0,0,5,22,11,26,4,2,1
"20220806AIRFAL",2022-08-06,"Scotland League 1","Airdrie Utd","Falkirk",4,0,"H",15,12,8,5,8,10,3,2,2,3,0,0,0,0,0,4,27,13,18,5,5,0
"20220806ALLKEL",2022-08-06,"Scotland League 1","Alloa","Kelty Hearts",3,1,"H",10,6,6,1,16,8,2,5,2,2,0,0,0,0,0,4,16,7,24,7,4,0
"20220806CLYPET",2022-08-06,"Scotland League 1","Clyde","Peterhead",2,2,"D",7,10,6,6,9,10,6,5,1,3,1,0,0,0,0,4,17,12,19,11,4,1
"20220806FC DUN",2022-08-06,"Scotland League 1","FC Edinburgh","Dunfermline",0,3,"A",1,25,0,16,9,10,0,16,1,1,1,0,0,0,0,3,26,16,19,16,2,1
"20220806MONQUE",2022-08-06,"Scotland League 1","Montrose","Queen of Sth",0,0,"D",12,13,5,3,12,12,3,8,2,2,0,0,0,0,0,0,25,8,24,11,4,0
"20220813ALLFC ",2022-08-13,"Scotland League 1","Alloa","FC Edinburgh",2,4,"A",11,13,5,10,8,10,7,5,3,2,0,1,0,0,0,6,24,15,18,12,5,1
"20220813CLYKEL",2022-08-13,"Scotland League 1","Clyde","Kelty Hearts",3,0,"H",12,8,8,3,12,13,4,7,0,2,0,0,0,0,0,3,20,11,25,11,2,0
"20220813DUNMON",2022-08-13,"Scotland League 1","Dunfermline","Montrose",1,0,"H",8,5,3,1,12,9,3,5,2,2,0,0,0,0,0,1,13,4,21,8,4,0
"20220813FALPET",2022-08-13,"Scotland League 1","Falkirk","Peterhead",3,1,"H",24,4,16,1,13,13,11,1,1,3,0,1,0,0,0,4,28,17,26,12,4,1
"20220813QUEAIR",2022-08-13,"Scotland League 1","Queen of Sth","Airdrie Utd",1,1,"D",18,12,3,5,12,9,4,5,2,0,0,0,0,0,0,2,30,8,21,9,2,0
"20220820AIRALL",2022-08-20,"Scotland League 1","Airdrie Utd","Alloa",2,0,"H",20,4,9,2,6,9,6,3,0,2,0,0,0,0,0,2,24,11,15,9,2,0
"20220820FC FAL",2022-08-20,"Scotland League 1","FC Edinburgh","Falkirk",0,3,"A",10,17,3,9,16,13,1,8,2,2,0,0,0,0,0,3,27,12,29,9,4,0
"20220820KELDUN",2022-08-20,"Scotland League 1","Kelty Hearts","Dunfermline",0,0,"D",4,8,2,4,14,14,1,4,1,1,0,0,0,0,0,0,12,6,28,5,2,0
"20220820MONCLY",2022-08-20,"Scotland League 1","Montrose","Clyde",2,1,"H",12,6,4,3,14,13,9,5,3,0,0,0,0,0,0,3,18,7,27,14,3,0
"20220820PETQUE",2022-08-20,"Scotland League 1","Peterhead","Queen of Sth",1,4,"A",4,10,4,8,10,12,0,6,2,1,0,0,0,0,0,5,14,12,22,6,3,0
"20220827ALLPET",2022-08-27,"Scotland League 1","Alloa","Peterhead",5,0,"H",12,3,9,0,6,7,8,4,0,0,0,0,0,0,0,5,15,9,13,12,0,0
"20220827DUNAIR",2022-08-27,"Scotland League 1","Dunfermline","Airdrie Utd",1,1,"D",12,7,8,1,6,10,5,4,1,2,0,0,0,0,0,2,19,9,16,9,3,0
"20220827FALQUE",2022-08-27,"Scotland League 1","Falkirk","Queen of Sth",3,1,"H",14,8,7,5,15,11,7,2,1,2,0,1,0,0,0,4,22,12,26,9,3,1
"20220827FC CLY",2022-08-27,"Scotland League 1","FC Edinburgh","Clyde",2,0,"H",9,15,6,8,10,13,2,8,1,4,0,0,0,0,0,2,24,14,23,10,5,0
"20220827MONKEL",2022-08-27,"Scotland League 1","Montrose","Kelty Hearts",3,0,"H",12,12,7,5,13,19,10,3,2,2,0,0,0,0,0,3,24,12,32,13,4,0
"20220903AIRFC ",2022-09-03,"Scotland League 1","Airdrie Utd","FC Edinburgh",0,6,"A",10,14,3,9,3,6,6,3,1,1,1,0,0,0,0,6,24,12,9,9,2,1
"20220903CLYALL",2022-09-03,"Scotland League 1","Clyde","Alloa",2,4,"A",13,9,5,4,11,13,6,4,2,5,0,0,0,0,0,6,22,9,24,10,7,0
"20220903KELFAL",2022-09-03,"Scotland League 1","Kelty Hearts","Falkirk",2,0,"H",9,9,4,5,11,10,3,4,3,1,0,0,0,0,0,2,18,9,21,7,4,0
"20220903PETMON",2022-09-03,"Scotland League 1","Peterhead","Montrose",0,2,"A",9,9,2,3,10,14,7,3,3,2,0,1,0,0,0,2,18,5,24,10,5,1
"20220903QUEDUN",2022-09-03,"Scotland League 1","Queen of Sth","Dunfermline",0,2,"A",5,14,2,7,11,14,4,4,4,4,0,0,0,0,0,2,19,9,25,8,8,0
"20220917AIRCLY",2022-09-17,"Scotland League 1","Airdrie Utd","Clyde",5,0,"H",19,10,8,3,11,9,6,2,5,1,0,0,0,0,0,5,29,11,20,8,6,0
"20220917ALLMON",2022-09-17,"Scotland League 1","Alloa","Montrose",2,1,"H",9,10,5,4,14,14,2,8,3,2,0,0,0,0,0,3,19,9,28,10,5,0
"20220917DUNFAL",2022-09-17,"Scotland League 1","Dunfermline","Falkirk",1,1,"D",13,10,3,2,10,16,8,4,2,2,0,0,0,0,0,2,23,5,26,12,4,0
"20220917PETKEL",2022-09-17,"Scotland League 1","Peterhead","Kelty Hearts",2,1,"H",6,13,3,4,18,12,4,10,3,4,1,0,0,0,0,3,19,7,30,14,7,1
"20220917QUEFC ",2022-09-17,"Scotland League 1","Queen of Sth","FC Edinburgh",4,1,"H",17,1,9,1,7,7,3,1,2,1,0,0,0,0,0,5,18,10,14,4,3,0
"20221001DUNPET",2022-10-01,"Scotland League 1","Dunfermline","Peterhead",2,2,"D",16,4,5,2,9,9,6,1,3,4,0,0,0,0,0,4,20,7,18,7,7,0
"20221001FALCLY",2022-10-01,"Scotland League 1","Falkirk","Clyde",2,0,"H",21,8,6,3,10,9,11,5,1,1,0,0,0,0,0,2,29,9,19,16,2,0
"20221001KELAIR",2022-10-01,"Scotland League 1","Kelty Hearts","Airdrie Utd",1,0,"H",11,8,2,3,4,7,4,6,3,0,0,0,0,0,0,1,19,5,11,10,3,0
"20221001MONFC ",2022-10-01,"Scotland League 1","Montrose","FC Edinburgh",1,2,"A",10,13,3,7,11,14,1,9,1,3,0,0,0,0,0,3,23,10,25,10,4,0
"20221001QUEALL",2022-10-01,"Scotland League 1","Queen of Sth","Alloa",1,1,"D",13,3,7,2,13,11,9,2,2,2,0,0,0,0,0,2,16,9,24,11,4,0
"20221004MONAIR",2022-10-04,"Scotland League 1","Montrose","Airdrie Utd",4,2,"H",12,24,9,6,10,8,3,9,0,0,0,0,0,0,0,6,36,15,18,12,0,0
"20221005FC PET",2022-10-05,"Scotland League 1","FC Edinburgh","Peterhead",2,0,"H",16,8,9,1,10,5,6,2,1,0,0,0,0,0,0,2,24,10,15,8,1,0
"20221008AIRQUE",2022-10-08,"Scotland League 1","Airdrie Utd","Queen of Sth",3,3,"D",8,11,5,9,9,10,3,3,0,2,1,0,0,0,0,6,19,14,19,6,2,1
"20221008ALLDUN",2022-10-08,"Scotland League 1","Alloa","Dunfermline",0,3,"A",10,10,5,3,6,8,5,2,0,2,0,0,0,0,0,3,20,8,14,7,2,0
"20221008CLYMON",2022-10-08,"Scotland League 1","Clyde","Montrose",1,3,"A",5,13,3,6,15,14,4,2,4,1,1,0,0,0,0,4,18,9,29,6,5,1
"20221008FC KEL",2022-10-08,"Scotland League 1","FC Edinburgh","Kelty Hearts",2,0,"H",10,5,3,0,7,11,1,4,1,2,0,0,0,0,0,2,15,3,18,5,3,0
"20221008PETFAL",2022-10-08,"Scotland League 1","Peterhead","Falkirk",0,4,"A",3,16,1,7,14,9,3,5,3,2,0,1,0,0,0,4,19,8,23,8,5,1
"20221011KELQUE",2022-10-11,"Scotland League 1","Kelty Hearts","Queen of Sth",1,0,"H",6,8,2,0,16,16,4,8,2,4,0,0,0,0,0,1,14,2,32,12,6,0
"20221015ALLAIR",2022-10-15,"Scotland League 1","Alloa","Airdrie Utd",2,0,"H",9,6,4,2,6,8,4,5,3,1,0,0,0,0,0,2,15,6,14,9,4,0
"20221015DUNFC ",2022-10-15,"Scotland League 1","Dunfermline","FC Edinburgh",1,0,"H",15,6,3,1,6,12,8,2,1,3,0,0,0,0,0,1,21,4,18,10,4,0
"20221015KELCLY",2022-10-15,"Scotland League 1","Kelty Hearts","Clyde",2,1,"H",6,6,4,4,9,10,5,1,0,3,0,0,0,0,0,3,12,8,19,6,3,0
"20221015MONFAL",2022-10-15,"Scotland League 1","Montrose","Falkirk",1,1,"D",10,9,4,4,10,13,6,9,1,3,0,0,0,0,0,2,19,8,23,15,4,0
"20221015QUEPET",2022-10-15,"Scotland League 1","Queen of Sth","Peterhead",2,0,"H",12,6,7,1,11,10,10,2,0,2,0,0,0,0,0,2,18,8,21,12,2,0
"20221018CLYDUN",2022-10-18,"Scotland League 1","Clyde","Dunfermline",0,2,"A",4,15,2,5,12,12,2,7,4,4,0,0,0,0,0,2,19,7,24,9,8,0
"20221018FALALL",2022-10-18,"Scotland League 1","Falkirk","Alloa",3,1,"H",9,9,6,3,8,8,4,4,0,0,0,0,0,0,0,4,18,9,16,8,0,0
"20221022CLYQUE",2022-10-22,"Scotland League 1","Clyde","Queen of Sth",1,2,"A",12,7,3,3,17,10,1,2,3,3,0,0,0,0,0,3,19,6,27,3,6,0
"20221022FALKEL",2022-10-22,"Scotland League 1","Falkirk","Kelty Hearts",2,3,"A",15,10,6,6,10,13,7,4,1,4,0,0,0,0,0,5,25,12,23,11,5,0
"20221022FC AIR",2022-10-22,"Scotland League 1","FC Edinburgh","Airdrie Utd",3,1,"H",10,14,6,7,8,2,6,6,2,1,0,0,0,0,0,4,24,13,10,12,3,0
"20221022MONDUN",2022-10-22,"Scotland League 1","Montrose","Dunfermline",2,0,"H",7,10,4,4,19,8,1,6,1,2,0,0,0,0,0,2,17,8,27,7,3,0
"20221022PETALL",2022-10-22,"Scotland League 1","Peterhead","Alloa",0,2,"A",8,11,3,4,9,7,4,6,2,0,0,0,0,0,0,2,19,7,16,10,2,0
"20221029AIRMON",2022-10-29,"Scotland League 1","Airdrie Utd","Montrose",4,0,"H",7,2,4,0,4,6,7,4,0,3,0,0,0,0,0,4,9,4,10,11,3,0
"20221029ALLCLY",2022-10-29,"Scotland League 1","Alloa","Clyde",2,1,"H",8,8,4,4,11,18,3,5,1,3,0,1,0,0,0,3,16,8,29,8,4,1
"20221029DUNKEL",2022-10-29,"Scotland League 1","Dunfermline","Kelty Hearts",2,1,"H",5,9,4,5,11,14,5,4,4,4,0,0,0,0,0,3,14,9,25,9,8,0
"20221029PETFC ",2022-10-29,"Scotland League 1","Peterhead","FC Edinburgh",1,1,"D",12,6,4,2,12,10,6,4,2,4,1,0,0,0,0,2,18,6,22,10,6,1
"20221029QUEFAL",2022-10-29,"Scotland League 1","Queen of Sth","Falkirk",1,3,"A",5,12,3,7,12,15,6,7,1,2,0,0,0,0,0,4,17,10,27,13,3,0
"20221105CLYAIR",2022-11-05,"Scotland League 1","Clyde","Airdrie Utd",0,1,"A",11,13,2,4,12,9,6,3,1,1,0,0,0,0,0,1,24,6,21,9,2,0
"20221105FALDUN",2022-11-05,"Scotland League 1","Falkirk","Dunfermline",0,1,"A",9,7,1,4,10,4,11,3,1,1,0,0,0,0,0,1,16,5,14,14,2,0
"20221105FC QUE",2022-11-05,"Scotland League 1","FC Edinburgh","Queen of Sth",0,3,"A",8,14,1,6,12,8,6,10,1,2,0,0,0,0,0,3,22,7,20,16,3,0
"20221105KELALL",2022-11-05,"Scotland League 1","Kelty Hearts","Alloa",1,1,"D",10,10,5,6,9,12,2,7,0,3,0,0,0,0,0,2,20,11,21,9,3,0
"20221105MONPET",2022-11-05,"Scotland League 1","Montrose","Peterhead",3,0,"H",13,5,7,3,12,11,5,2,0,1,0,0,0,0,0,3,18,10,23,7,1,0
"20221112AIRPET",2022-11-12,"Scotland League 1","Airdrie Utd","Peterhead",1,1,"D",20,5,6,2,4,18,10,7,1,5,0,0,0,0,0,2,25,8,22,17,6,0
"20221112ALLQUE",2022-11-12,"Scotland League 1","Alloa","Queen of Sth",5,1,"H",12,8,5,4,4,5,7,6,1,2,0,1,0,0,0,6,20,9,9,13,3,1
"20221112DUNCLY",2022-11-12,"Scotland League 1","Dunfermline","Clyde",2,2,"D",11,5,6,3,7,16,9,9,1,4,0,0,0,0,0,4,16,9,23,18,5,0
"20221112FALFC ",2022-11-12,"Scotland League 1","Falkirk","FC Edinburgh",2,0,"H",16,5,7,2,9,15,7,1,1,4,0,0,0,0,0,2,21,9,24,8,5,0
"20221112KELMON",2022-11-12,"Scotland League 1","Kelty Hearts","Montrose",1,3,"A",11,10,5,7,20,16,3,4,1,3,0,0,0,0,0,4,21,12,36,7,4,0
"20221119AIRKEL",2022-11-19,"Scotland League 1","Airdrie Utd","Kelty Hearts",1,0,"H",14,6,6,2,11,9,9,3,3,1,0,0,0,0,0,1,20,8,20,12,4,0
"20221119CLYFAL",2022-11-19,"Scotland League 1","Clyde","Falkirk",3,3,"D",9,16,3,5,11,9,1,9,2,1,0,0,0,0,0,6,25,8,20,10,3,0
"20221119FC ALL",2022-11-19,"Scotland League 1","FC Edinburgh","Alloa",4,3,"H",9,9,5,5,8,9,4,7,2,1,0,1,0,0,0,7,18,10,17,11,3,1
"20221119PETDUN",2022-11-19,"Scotland League 1","Peterhead","Dunfermline",0,2,"A",3,4,2,2,7,5,4,8,4,3,0,0,0,0,0,2,7,4,12,12,7,0
"20221119QUEMON",2022-11-19,"Scotland League 1","Queen of Sth","Montrose",4,0,"H",9,4,5,1,10,8,5,3,2,4,1,0,0,0,0,4,13,6,18,8,6,1
"20221203CLYFC ",2022-12-03,"Scotland League 1","Clyde","FC Edinburgh",0,2,"A",8,9,4,4,8,13,4,5,1,0,0,0,0,0,0,2,17,8,21,9,1,0
"20221203DUNQUE",2022-12-03,"Scotland League 1","Dunfermline","Queen of Sth",1,1,"D",13,15,5,5,7,8,5,10,1,3,0,0,0,0,0,2,28,10,15,15,4,0
"20221203FALAIR",2022-12-03,"Scotland League 1","Falkirk","Airdrie Utd",1,1,"D",13,8,3,2,11,13,5,5,4,0,0,0,0,0,0,2,21,5,24,10,4,0
"20221203KELPET",2022-12-03,"Scotland League 1","Kelty Hearts","Peterhead",3,0,"H",9,3,7,1,14,12,8,2,3,1,0,1,0,0,0,3,12,8,26,10,4,1
"20221203MONALL",2022-12-03,"Scotland League 1","Montrose","Alloa",0,0,"D",10,12,2,6,14,9,2,6,0,1,0,0,0,0,0,0,22,8,23,8,1,0
"20221217FC MON",2022-12-17,"Scotland League 1","FC Edinburgh","Montrose",2,2,"D",6,8,2,3,8,8,2,7,0,0,0,0,0,0,0,4,14,5,16,9,0,0
"20221217QUEKEL",2022-12-17,"Scotland League 1","Queen of Sth","Kelty Hearts",1,2,"A",6,9,3,4,11,6,6,4,0,2,0,0,0,0,0,3,15,7,17,10,2,0
"20221223CLYALL",2022-12-23,"Scotland League 1","Clyde","Alloa",2,2,"D",10,8,4,5,6,8,7,3,1,1,0,0,0,0,0,4,18,9,14,10,2,0
"20221223FALQUE",2022-12-23,"Scotland League 1","Falkirk","Queen of Sth",5,2,"H",12,8,9,5,8,11,14,5,2,2,0,0,0,0,0,7,20,14,19,19,4,0
"20221223MONAIR",2022-12-23,"Scotland League 1","Montrose","Airdrie Utd",2,4,"A",13,21,3,11,10,9,4,10,2,1,1,0,0,0,0,6,34,14,19,14,3,1
"20221224KELDUN",2022-12-24,"Scotland League 1","Kelty Hearts","Dunfermline",1,2,"A",8,7,3,3,15,4,7,5,4,1,0,0,0,0,0,3,15,6,19,12,5,0
"20221224FC PET",2022-12-24,"Scotland League 1","FC Edinburgh","Peterhead",4,0,"H",16,2,11,1,8,7,5,3,0,0,0,1,0,0,0,4,18,12,15,8,0,1
"20221231ALLKEL",2022-12-31,"Scotland League 1","Alloa","Kelty Hearts",0,0,"D",1,9,0,4,9,12,5,12,0,1,0,0,0,0,0,0,10,4,21,17,1,0
"20221231QUECLY",2022-12-31,"Scotland League 1","Queen of Sth","Clyde",1,0,"H",5,5,2,0,14,10,2,5,3,0,0,0,0,0,0,1,10,2,24,7,3,0
"20230102AIRFC ",2023-01-02,"Scotland League 1","Airdrie Utd","FC Edinburgh",3,5,"A",8,13,4,6,10,12,4,8,1,6,1,0,0,0,0,8,21,10,22,12,7,1
"20230102PETMON",2023-01-02,"Scotland League 1","Peterhead","Montrose",0,0,"D",8,7,1,5,15,13,1,7,3,4,0,1,0,0,0,0,15,6,28,8,7,1
"20230107CLYKEL",2023-01-07,"Scotland League 1","Clyde","Kelty Hearts",1,2,"A",17,9,3,3,6,20,6,9,0,4,0,1,0,0,0,3,26,6,26,15,4,1
"20230107FALMON",2023-01-07,"Scotland League 1","Falkirk","Montrose",2,1,"H",16,9,7,5,20,17,4,6,4,3,0,0,0,0,0,3,25,12,37,10,7,0
"20230107FC DUN",2023-01-07,"Scotland League 1","FC Edinburgh","Dunfermline",0,1,"A",6,16,2,6,11,9,0,6,2,1,0,0,0,0,0,1,22,8,20,6,3,0
"20230107PETAIR",2023-01-07,"Scotland League 1","Peterhead","Airdrie Utd",0,3,"A",9,14,4,10,10,7,5,7,2,1,0,0,0,0,0,3,23,14,17,12,3,0
"20230107QUEALL",2023-01-07,"Scotland League 1","Queen of Sth","Alloa",1,2,"A",14,5,7,3,5,5,9,5,0,1,0,0,0,0,0,3,19,10,10,14,1,0
"20230114ALLFC ",2023-01-14,"Scotland League 1","Alloa","FC Edinburgh",2,1,"H",6,5,2,2,11,5,3,5,0,0,0,0,0,0,0,3,11,4,16,8,0,0
"20230114DUNPET",2023-01-14,"Scotland League 1","Dunfermline","Peterhead",4,0,"H",12,4,5,0,5,16,3,6,1,3,0,0,0,0,0,4,16,5,21,9,4,0
"20230114FALCLY",2023-01-14,"Scotland League 1","Falkirk","Clyde",4,0,"H",18,1,6,0,6,9,6,1,0,2,1,1,0,0,0,4,19,6,15,7,2,2
"20230114KELAIR",2023-01-14,"Scotland League 1","Kelty Hearts","Airdrie Utd",1,1,"D",11,7,3,2,9,4,5,7,1,0,0,0,0,0,0,2,18,5,13,12,1,0
"20230114MONQUE",2023-01-14,"Scotland League 1","Montrose","Queen of Sth",1,0,"H",7,16,2,4,7,13,2,8,1,1,0,0,0,0,0,1,23,6,20,10,2,0
"20230121PETCLY",2023-01-21,"Scotland League 1","Peterhead","Clyde",1,0,"H",7,7,3,3,9,11,6,5,1,0,0,0,0,0,0,1,14,6,20,11,1,0
"20230128AIRALL",2023-01-28,"Scotland League 1","Airdrie Utd","Alloa",4,0,"H",22,10,12,2,9,8,9,4,0,0,0,0,0,0,0,4,32,14,17,13,0,0
"20230128CLYDUN",2023-01-28,"Scotland League 1","Clyde","Dunfermline",1,1,"D",5,14,1,4,8,8,4,16,1,2,0,0,0,0,0,2,19,5,16,20,3,0
"20230128FC FAL",2023-01-28,"Scotland League 1","FC Edinburgh","Falkirk",1,2,"A",9,15,4,6,4,14,3,3,0,4,0,0,0,0,0,3,24,10,18,6,4,0
"20230128MONKEL",2023-01-28,"Scotland League 1","Montrose","Kelty Hearts",3,3,"D",10,11,3,4,8,18,3,5,1,2,0,0,0,0,0,6,21,7,26,8,3,0
"20230128PETQUE",2023-01-28,"Scotland League 1","Peterhead","Queen of Sth",1,3,"A",5,18,1,5,10,12,3,6,1,2,0,0,0,0,0,4,23,6,22,9,3,0
"20230204AIRCLY",2023-02-04,"Scotland League 1","Airdrie Utd","Clyde",1,0,"H",6,10,4,3,9,11,10,3,1,2,0,0,0,0,0,1,16,7,20,13,3,0
"20230204ALLPET",2023-02-04,"Scotland League 1","Alloa","Peterhead",1,0,"H",15,4,8,1,11,9,6,2,3,2,0,0,0,0,0,1,19,9,20,8,5,0
"20230204DUNMON",2023-02-04,"Scotland League 1","Dunfermline","Montrose",2,0,"H",10,9,5,6,11,11,10,8,1,2,0,0,0,0,0,2,19,11,22,18,3,0
"20230204KELFAL",2023-02-04,"Scotland League 1","Kelty Hearts","Falkirk",1,2,"A",14,10,5,6,15,6,7,6,6,2,0,0,0,0,0,3,24,11,21,13,8,0
"20230204QUEFC ",2023-02-04,"Scotland League 1","Queen of Sth","FC Edinburgh",1,0,"H",9,2,4,1,7,10,5,3,1,2,0,1,0,0,0,1,11,5,17,8,3,1
"20230207ALLFAL",2023-02-07,"Scotland League 1","Alloa","Falkirk",1,1,"D",8,4,2,2,15,10,5,5,2,4,0,0,0,0,0,2,12,4,25,10,6,0
"20230211AIRDUN",2023-02-11,"Scotland League 1","Airdrie Utd","Dunfermline",3,4,"A",10,16,4,8,10,10,3,6,1,1,1,0,0,0,0,7,26,12,20,9,2,1
"20230218CLYPET",2023-02-18,"Scotland League 1","Clyde","Peterhead",1,0,"H",16,17,8,9,9,15,8,7,3,1,0,0,0,0,0,1,33,17,24,15,4,0
"20230218DUNAIR",2023-02-18,"Scotland League 1","Dunfermline","Airdrie Utd",1,1,"D",13,9,6,4,11,15,6,8,2,3,0,1,0,0,0,2,22,10,26,14,5,1
"20230218FALALL",2023-02-18,"Scotland League 1","Falkirk","Alloa",1,0,"H",12,8,3,4,5,9,8,5,1,3,0,0,0,0,0,1,20,7,14,13,4,0
"20230218KELQUE",2023-02-18,"Scotland League 1","Kelty Hearts","Queen of Sth",3,0,"H",7,11,3,4,5,11,7,6,3,0,0,0,0,0,0,3,18,7,16,13,3,0
"20230218MONFC ",2023-02-18,"Scotland League 1","Montrose","FC Edinburgh",3,3,"D",14,10,8,6,15,18,7,5,2,5,0,0,0,0,0,6,24,14,33,12,7,0
"20230225AIRFAL",2023-02-25,"Scotland League 1","Airdrie Utd","Falkirk",1,3,"A",17,15,8,6,9,10,8,3,1,2,0,0,0,0,0,4,32,14,19,11,3,0
"20230225ALLMON",2023-02-25,"Scotland League 1","Alloa","Montrose",1,0,"H",9,4,4,2,11,9,1,10,2,1,0,0,0,0,0,1,13,6,20,11,3,0
"20230225FC CLY",2023-02-25,"Scotland League 1","FC Edinburgh","Clyde",3,0,"H",20,11,9,2,7,8,9,3,1,0,0,1,0,0,0,3,31,11,15,12,1,1
"20230225PETKEL",2023-02-25,"Scotland League 1","Peterhead","Kelty Hearts",1,1,"D",8,8,4,4,13,12,3,7,1,4,0,0,0,0,0,2,16,8,25,10,5,0
"20230225QUEDUN",2023-02-25,"Scotland League 1","Queen of Sth","Dunfermline",0,2,"A",7,9,3,4,8,10,4,4,1,1,0,0,0,0,0,2,16,7,18,8,2,0
"20230304DUNALL",2023-03-04,"Scotland League 1","Dunfermline","Alloa",2,0,"H",12,8,7,2,5,7,3,6,0,1,0,0,0,0,0,2,20,9,12,9,1,0
"20230304FALPET",2023-03-04,"Scotland League 1","Falkirk","Peterhead",5,0,"H",20,1,9,1,6,13,11,0,1,4,0,0,0,0,0,5,21,10,19,11,5,0
"20230304KELFC ",2023-03-04,"Scotland League 1","Kelty Hearts","FC Edinburgh",1,2,"A",12,9,6,4,11,8,7,7,2,1,0,0,0,0,0,3,21,10,19,14,3,0
"20230304MONCLY",2023-03-04,"Scotland League 1","Montrose","Clyde",2,0,"H",14,7,4,3,17,14,15,1,3,3,0,0,0,0,0,2,21,7,31,16,6,0
"20230304QUEAIR",2023-03-04,"Scotland League 1","Queen of Sth","Airdrie Utd",3,2,"H",7,14,5,7,7,14,5,5,3,2,0,0,0,0,0,5,21,12,21,10,5,0
"20230307DUNFAL",2023-03-07,"Scotland League 1","Dunfermline","Falkirk",2,0,"H",10,2,5,1,9,13,9,6,2,1,0,0,0,0,0,2,12,6,22,15,3,0
"20230311AIRKEL",2023-03-11,"Scotland League 1","Airdrie Utd","Kelty Hearts",6,1,"H",18,8,10,5,7,8,9,6,0,2,0,0,0,0,0,7,26,15,15,15,2,0
"20230311CLYQUE",2023-03-11,"Scotland League 1","Clyde","Queen of Sth",1,1,"D",10,16,3,8,9,13,6,8,4,3,0,0,0,0,0,2,26,11,22,14,7,0
"20230311FC ALL",2023-03-11,"Scotland League 1","FC Edinburgh","Alloa",0,2,"A",3,10,1,7,10,6,5,5,1,0,0,0,0,0,0,2,13,8,16,10,1,0
"20230318AIRPET",2023-03-18,"Scotland League 1","Airdrie Utd","Peterhead",7,0,"H",20,1,11,0,8,14,2,0,0,4,0,0,0,0,0,7,21,11,22,2,4,0
"20230318ALLCLY",2023-03-18,"Scotland League 1","Alloa","Clyde",3,1,"H",9,4,4,2,4,11,6,2,0,3,0,0,0,0,0,4,13,6,15,8,3,0
"20230318DUNFC ",2023-03-18,"Scotland League 1","Dunfermline","FC Edinburgh",0,0,"D",8,0,3,0,9,6,4,8,1,1,0,0,0,0,0,0,8,3,15,12,2,0
"20230318KELMON",2023-03-18,"Scotland League 1","Kelty Hearts","Montrose",1,2,"A",14,10,4,5,14,12,6,11,2,3,0,0,0,0,0,3,24,9,26,17,5,0
"20230318QUEFAL",2023-03-18,"Scotland League 1","Queen of Sth","Falkirk",1,0,"H",7,8,1,5,12,17,2,9,2,2,0,0,0,0,0,1,15,6,29,11,4,0
"20230324CLYAIR",2023-03-24,"Scotland League 1","Clyde","Airdrie Utd",1,5,"A",11,10,2,6,13,6,6,3,0,0,0,0,0,0,0,6,21,8,19,9,0,0
"20230324FALKEL",2023-03-24,"Scotland League 1","Falkirk","Kelty Hearts",0,0,"D",13,5,4,2,15,15,9,3,1,2,0,0,0,0,0,0,18,6,30,12,3,0
"20230324FC QUE",2023-03-24,"Scotland League 1","FC Edinburgh","Queen of Sth",1,3,"A",12,17,2,10,10,10,3,6,4,0,0,0,0,0,0,4,29,12,20,9,4,0
"20230325PETALL",2023-03-25,"Scotland League 1","Peterhead","Alloa",0,2,"A",3,9,0,2,16,9,5,4,2,1,0,0,0,0,0,2,12,2,25,9,3,0
"20230325MONDUN",2023-03-25,"Scotland League 1","Montrose","Dunfermline",1,3,"A",11,14,2,7,12,7,3,6,2,3,0,0,0,0,0,4,25,9,19,9,5,0
"20230401ALLAIR",2023-04-01,"Scotland League 1","Alloa","Airdrie Utd",0,1,"A",5,9,1,4,11,10,4,3,2,2,0,0,0,0,0,1,14,5,21,7,4,0
"20230401CLYFAL",2023-04-01,"Scotland League 1","Clyde","Falkirk",0,0,"D",10,9,1,4,4,10,2,9,0,1,0,0,0,0,0,0,19,5,14,11,1,0
"20230401DUNKEL",2023-04-01,"Scotland League 1","Dunfermline","Kelty Hearts",0,0,"D",12,1,2,0,9,13,6,4,1,5,0,0,0,0,0,0,13,2,22,10,6,0
"20230401FC MON",2023-04-01,"Scotland League 1","FC Edinburgh","Montrose",1,1,"D",12,15,4,6,15,13,5,6,5,2,0,0,0,0,0,2,27,10,28,11,7,0
"20230401QUEPET",2023-04-01,"Scotland League 1","Queen of Sth","Peterhead",2,1,"H",14,5,6,4,12,11,5,3,2,4,0,0,0,0,0,3,19,10,23,8,6,0
"20230408AIRMON",2023-04-08,"Scotland League 1","Airdrie Utd","Montrose",3,0,"H",13,7,7,1,5,8,3,5,1,4,0,0,0,0,0,3,20,8,13,8,5,0
"20230408ALLQUE",2023-04-08,"Scotland League 1","Alloa","Queen of Sth",1,2,"A",14,9,10,4,3,8,11,0,1,3,0,0,0,0,0,3,23,14,11,11,4,0
"20230408FALDUN",2023-04-08,"Scotland League 1","Falkirk","Dunfermline",2,2,"D",12,8,4,4,14,10,5,3,2,1,0,0,0,0,0,4,20,8,24,8,3,0
"20230408KELCLY",2023-04-08,"Scotland League 1","Kelty Hearts","Clyde",0,0,"D",14,6,2,1,12,11,7,2,3,0,0,0,0,0,0,0,20,3,23,9,3,0
"20230408PETFC ",2023-04-08,"Scotland League 1","Peterhead","FC Edinburgh",1,0,"H",11,7,5,2,17,10,0,3,2,1,0,0,0,0,0,1,18,7,27,3,3,0
"20230411MONFAL",2023-04-11,"Scotland League 1","Montrose","Falkirk",1,2,"A",8,14,2,6,12,11,2,3,3,3,0,0,0,0,0,3,22,8,23,5,6,0
"20230411PETDUN",2023-04-11,"Scotland League 1","Peterhead","Dunfermline",0,2,"A",6,9,1,4,16,13,1,5,4,1,0,0,0,0,0,2,15,5,29,6,5,0
"20230415CLYFC ",2023-04-15,"Scotland League 1","Clyde","FC Edinburgh",2,1,"H",18,7,7,4,16,6,4,4,1,1,0,0,0,0,0,3,25,11,22,8,2,0
"20230415DUNQUE",2023-04-15,"Scotland League 1","Dunfermline","Queen of Sth",5,0,"H",14,8,9,1,8,9,5,1,0,3,0,0,0,0,0,5,22,10,17,6,3,0
"20230415FALAIR",2023-04-15,"Scotland League 1","Falkirk","Airdrie Utd",2,2,"D",9,7,4,2,14,9,0,5,0,1,0,0,0,0,0,4,16,6,23,5,1,0
"20230415KELALL",2023-04-15,"Scotland League 1","Kelty Hearts","Alloa",0,1,"A",8,8,2,3,6,13,2,5,1,1,0,0,0,0,0,1,16,5,19,7,2,0
"20230415MONPET",2023-04-15,"Scotland League 1","Montrose","Peterhead",2,1,"H",15,8,8,3,16,13,12,2,1,2,0,0,0,0,0,3,23,11,29,14,3,0
"20230418FALFC ",2023-04-18,"Scotland League 1","Falkirk","FC Edinburgh",1,2,"A",15,9,7,4,9,4,6,4,0,1,0,0,0,0,0,3,24,11,13,10,1,0
"20230422AIRDUN",2023-04-22,"Scotland League 1","Airdrie Utd","Dunfermline",1,1,"D",16,3,7,1,8,6,14,2,0,1,0,2,0,0,0,2,19,8,14,16,1,2
"20230422ALLFAL",2023-04-22,"Scotland League 1","Alloa","Falkirk",1,4,"A",6,11,3,8,9,11,0,2,1,2,0,0,0,0,0,5,17,11,20,2,3,0
"20230422FC KEL",2023-04-22,"Scotland League 1","FC Edinburgh","Kelty Hearts",2,2,"D",14,9,5,4,5,11,10,2,1,0,0,0,0,0,0,4,23,9,16,12,1,0
"20230422PETCLY",2023-04-22,"Scotland League 1","Peterhead","Clyde",1,1,"D",10,10,6,3,11,10,4,10,4,4,0,0,0,0,0,2,20,9,21,14,8,0
"20230422QUEMON",2023-04-22,"Scotland League 1","Queen of Sth","Montrose",2,3,"A",5,11,2,6,8,5,2,4,0,3,2,0,0,0,0,5,16,8,13,6,3,2
"20230429AIRQUE",2023-04-29,"Scotland League 1","Airdrie Utd","Queen of Sth",1,3,"A",16,12,3,7,5,10,4,8,0,1,0,0,0,0,0,4,28,10,15,12,1,0
"20230429DUNCLY",2023-04-29,"Scotland League 1","Dunfermline","Clyde",2,1,"H",9,4,2,2,6,6,9,0,0,1,0,0,0,0,0,3,13,4,12,9,1,0
"20230429KELPET",2023-04-29,"Scotland League 1","Kelty Hearts","Peterhead",2,1,"H",11,19,6,11,17,11,6,6,0,0,0,0,0,0,0,3,30,17,28,12,0,0
"20230429MONALL",2023-04-29,"Scotland League 1","Montrose","Alloa",0,4,"A",9,15,3,9,7,8,6,2,2,1,0,0,0,0,0,4,24,12,15,8,3,0
"20230506ALLDUN",2023-05-06,"Scotland League 1","Alloa","Dunfermline",0,2,"A",7,13,1,8,6,8,2,9,0,1,0,0,0,0,0,2,20,9,14,11,1,0
"20230506CLYMON",2023-05-06,"Scotland League 1","Clyde","Montrose",2,1,"H",11,15,4,6,7,9,4,3,2,2,0,0,0,0,0,3,26,10,16,7,4,0
"20230506FC AIR",2023-05-06,"Scotland League 1","FC Edinburgh","Airdrie Utd",1,4,"A",6,16,2,7,9,10,4,4,2,1,0,0,0,0,0,5,22,9,19,8,3,0
"20230506PETFAL",2023-05-06,"Scotland League 1","Peterhead","Falkirk",1,3,"A",7,10,3,5,15,9,2,4,3,2,0,0,0,0,0,4,17,8,24,6,5,0
"20230506QUEKEL",2023-05-06,"Scotland League 1","Queen of Sth","Kelty Hearts",4,1,"H",11,5,4,4,6,11,6,5,1,1,0,0,0,0,0,5,16,8,17,11,2,0
"20230805FALANN",2023-08-05,"Scotland League 1","Falkirk","Annan Athletic",3,0,"H",17,4,8,0,14,5,11,1,3,1,0,0,0,0,0,3,21,8,19,12,4,0
"20230805HAMCOV",2023-08-05,"Scotland League 1","Hamilton","Cove Rangers",1,0,"H",9,4,6,0,8,2,7,5,2,1,0,1,0,0,0,1,13,6,10,12,3,1
"20230805MONKEL",2023-08-05,"Scotland League 1","Montrose","Kelty Hearts",0,2,"A",11,11,4,4,17,13,12,5,3,3,0,0,0,0,0,2,22,8,30,17,6,0
"20230805QUEALL",2023-08-05,"Scotland League 1","Queen of Sth","Alloa",3,4,"A",9,10,4,8,9,18,8,3,3,2,0,0,0,0,0,7,19,12,27,11,5,0
"20230805STIEDI",2023-08-05,"Scotland League 1","Stirling","Edinburgh City",1,0,"H",12,5,5,4,12,10,10,1,0,3,0,0,0,0,0,1,17,9,22,11,3,0
"20230812ALLSTI",2023-08-12,"Scotland League 1","Alloa","Stirling",0,1,"A",3,4,1,2,11,10,3,5,3,2,1,0,0,0,0,1,7,3,21,8,5,1
"20230812ANNMON",2023-08-12,"Scotland League 1","Annan Athletic","Montrose",1,3,"A",16,4,5,3,7,11,4,3,0,2,0,0,0,0,0,4,20,8,18,7,2,0
"20230812COVFAL",2023-08-12,"Scotland League 1","Cove Rangers","Falkirk",2,2,"D",7,13,4,7,17,11,3,8,3,3,0,0,0,0,0,4,20,11,28,11,6,0
"20230812EDIQUE",2023-08-12,"Scotland League 1","Edinburgh City","Queen of Sth",1,2,"A",8,14,3,8,14,8,3,10,1,1,0,1,0,0,0,3,22,11,22,13,2,1
"20230812KELHAM",2023-08-12,"Scotland League 1","Kelty Hearts","Hamilton",0,2,"A",5,16,1,11,6,6,3,7,0,2,0,0,0,0,0,2,21,12,12,10,2,0
"20230819EDIHAM",2023-08-19,"Scotland League 1","Edinburgh City","Hamilton",0,3,"A",9,23,1,9,11,6,3,8,0,2,1,0,0,0,0,3,32,10,17,11,2,1
"20230819KELALL",2023-08-19,"Scotland League 1","Kelty Hearts","Alloa",2,1,"H",7,9,3,3,16,9,2,2,2,6,0,0,0,0,0,3,16,6,25,4,8,0
"20230819MONCOV",2023-08-19,"Scotland League 1","Montrose","Cove Rangers",0,3,"A",8,19,5,8,8,9,6,3,0,0,0,0,0,0,0,3,27,13,17,9,0,0
"20230819QUEANN",2023-08-19,"Scotland League 1","Queen of Sth","Annan Athletic",3,1,"H",13,6,4,1,14,6,5,1,2,2,0,0,0,0,0,4,19,5,20,6,4,0
"20230822FALSTI",2023-08-22,"Scotland League 1","Falkirk","Stirling",3,0,"H",12,3,4,3,11,11,10,2,2,2,0,0,0,0,0,3,15,7,22,12,4,0
"20230826ANNEDI",2023-08-26,"Scotland League 1","Annan Athletic","Edinburgh City",3,2,"H",16,15,8,7,7,8,2,8,3,2,0,0,0,0,0,5,31,15,15,10,5,0
"20230826COVQUE",2023-08-26,"Scotland League 1","Cove Rangers","Queen of Sth",1,2,"A",15,6,3,2,12,14,6,5,1,2,1,1,0,0,0,3,21,5,26,11,3,2
"20230826HAMMON",2023-08-26,"Scotland League 1","Hamilton","Montrose",1,0,"H",7,4,4,2,13,8,10,1,2,3,0,0,0,0,0,1,11,6,21,11,5,0
"20230826STIKEL",2023-08-26,"Scotland League 1","Stirling","Kelty Hearts",1,0,"H",8,7,3,2,8,5,9,4,1,1,0,0,0,0,0,1,15,5,13,13,2,0
"20230826ALLFAL",2023-08-26,"Scotland League 1","Alloa","Falkirk",1,4,"A",6,14,4,7,9,13,2,9,3,2,0,0,0,0,0,5,20,11,22,11,5,0
"20230902ALLCOV",2023-09-02,"Scotland League 1","Alloa","Cove Rangers",1,0,"H",10,9,5,3,10,10,5,3,3,1,0,0,0,0,0,1,19,8,20,8,4,0
"20230902EDIFAL",2023-09-02,"Scotland League 1","Edinburgh City","Falkirk",0,2,"A",2,28,0,12,12,7,4,7,4,0,0,0,0,0,0,2,30,12,19,11,4,0
"20230902KELANN",2023-09-02,"Scotland League 1","Kelty Hearts","Annan Athletic",1,1,"D",6,11,3,2,8,6,2,3,1,2,0,0,0,0,0,2,17,5,14,5,3,0
"20230902QUEMON",2023-09-02,"Scotland League 1","Queen of Sth","Montrose",2,3,"A",10,6,6,4,6,8,4,5,1,1,0,0,0,0,0,5,16,10,14,9,2,0
"20230902STIHAM",2023-09-02,"Scotland League 1","Stirling","Hamilton",2,2,"D",8,17,5,7,15,7,1,7,2,0,0,0,0,0,0,4,25,12,22,8,2,0
"20230916ANNSTI",2023-09-16,"Scotland League 1","Annan Athletic","Stirling",3,0,"H",14,11,8,3,9,14,4,9,1,3,0,0,0,0,0,3,25,11,23,13,4,0
"20230916COVKEL",2023-09-16,"Scotland League 1","Cove Rangers","Kelty Hearts",2,2,"D",7,5,4,5,8,8,4,3,2,3,0,1,0,0,0,4,12,9,16,7,5,1
"20230916FALQUE",2023-09-16,"Scotland League 1","Falkirk","Queen of Sth",1,0,"H",11,4,4,0,9,9,5,1,0,2,0,0,0,0,0,1,15,4,18,6,2,0
"20230916HAMALL",2023-09-16,"Scotland League 1","Hamilton","Alloa",2,1,"H",15,9,8,4,9,13,11,3,2,2,0,0,0,0,0,3,24,12,22,14,4,0
"20230916MONEDI",2023-09-16,"Scotland League 1","Montrose","Edinburgh City",5,2,"H",15,14,8,7,9,18,7,5,2,4,0,0,0,0,0,7,29,15,27,12,6,0
"20230923ANNALL",2023-09-23,"Scotland League 1","Annan Athletic","Alloa",1,1,"D",15,8,8,2,9,15,7,0,2,1,0,0,0,0,0,2,23,10,24,7,3,0
"20230923EDICOV",2023-09-23,"Scotland League 1","Edinburgh City","Cove Rangers",2,2,"D",12,17,5,7,8,7,7,3,1,2,0,0,0,0,0,4,29,12,15,10,3,0
"20230923MONSTI",2023-09-23,"Scotland League 1","Montrose","Stirling",1,0,"H",5,4,3,0,11,13,5,5,3,4,0,0,0,0,0,1,9,3,24,10,7,0
"20230923QUEHAM",2023-09-23,"Scotland League 1","Queen of Sth","Hamilton",1,2,"A",7,16,1,8,21,11,1,6,5,1,0,0,0,0,0,3,23,9,32,7,6,0
"20230923KELFAL",2023-09-23,"Scotland League 1","Kelty Hearts","Falkirk",1,5,"A",2,22,1,14,9,13,3,6,2,2,0,0,0,0,0,6,24,15,22,9,4,0
"20230929HAMANN",2023-09-29,"Scotland League 1","Hamilton","Annan Athletic",5,0,"H",16,2,6,1,13,7,4,4,1,1,0,0,0,0,0,5,18,7,20,8,2,0
"20230930ALLEDI",2023-09-30,"Scotland League 1","Alloa","Edinburgh City",1,1,"D",14,6,6,3,11,8,7,5,2,2,0,0,0,0,0,2,20,9,19,12,4,0
"20230930FALMON",2023-09-30,"Scotland League 1","Falkirk","Montrose",3,2,"H",21,10,7,3,12,8,13,5,2,3,0,0,0,0,0,5,31,10,20,18,5,0
"20230930KELQUE",2023-09-30,"Scotland League 1","Kelty Hearts","Queen of Sth",3,1,"H",8,14,3,4,18,14,5,6,3,2,0,0,0,0,0,4,22,7,32,11,5,0
"20230930STICOV",2023-09-30,"Scotland League 1","Stirling","Cove Rangers",2,2,"D",11,9,7,4,8,7,2,4,2,0,0,1,0,0,0,4,20,11,15,6,2,1
"20231007COVANN",2023-10-07,"Scotland League 1","Cove Rangers","Annan Athletic",3,2,"H",15,8,8,4,12,10,3,1,3,2,0,0,0,0,0,5,23,12,22,4,5,0
"20231007EDIKEL",2023-10-07,"Scotland League 1","Edinburgh City","Kelty Hearts",1,4,"A",10,17,4,8,7,12,9,11,1,1,0,0,0,0,0,5,27,12,19,20,2,0
"20231007MONALL",2023-10-07,"Scotland League 1","Montrose","Alloa",2,1,"H",7,12,5,5,11,16,4,7,1,3,0,0,0,0,0,3,19,10,27,11,4,0
"20231007QUESTI",2023-10-07,"Scotland League 1","Queen of Sth","Stirling",0,1,"A",10,13,5,6,7,13,9,3,2,2,0,0,0,0,0,1,23,11,20,12,4,0
"20231007FALHAM",2023-10-07,"Scotland League 1","Falkirk","Hamilton",0,0,"D",9,7,1,3,10,16,1,2,1,3,0,0,0,0,0,0,16,4,26,3,4,0
"20231021ALLKEL",2023-10-21,"Scotland League 1","Alloa","Kelty Hearts",3,1,"H",9,7,6,3,16,11,2,5,1,2,0,0,0,0,0,4,16,9,27,7,3,0
"20231021ANNQUE",2023-10-21,"Scotland League 1","Annan Athletic","Queen of Sth",0,1,"A",16,9,4,4,12,10,5,2,3,4,0,0,0,0,0,1,25,8,22,7,7,0
"20231021HAMEDI",2023-10-21,"Scotland League 1","Hamilton","Edinburgh City",1,1,"D",16,7,5,1,6,8,13,0,3,2,0,0,0,0,0,2,23,6,14,13,5,0
"20231021STIFAL",2023-10-21,"Scotland League 1","Stirling","Falkirk",1,2,"A",2,16,1,7,16,16,2,6,6,5,0,0,0,0,0,3,18,8,32,8,11,0
"20231028EDIANN",2023-10-28,"Scotland League 1","Edinburgh City","Annan Athletic",3,2,"H",5,12,4,6,13,13,4,2,2,2,0,0,0,0,0,5,17,10,26,6,4,0
"20231028FALALL",2023-10-28,"Scotland League 1","Falkirk","Alloa",3,0,"H",21,3,8,0,9,12,12,1,1,3,0,0,0,0,0,3,24,8,21,13,4,0
"20231028KELSTI",2023-10-28,"Scotland League 1","Kelty Hearts","Stirling",1,0,"H",7,6,3,2,8,8,9,8,1,1,0,1,0,0,0,1,13,5,16,17,2,1
"20231028QUECOV",2023-10-28,"Scotland League 1","Queen of Sth","Cove Rangers",0,1,"A",7,13,2,5,13,8,2,4,1,0,0,0,0,0,0,1,20,7,21,6,1,0
"20231028MONHAM",2023-10-28,"Scotland League 1","Montrose","Hamilton",0,3,"A",10,12,1,7,10,13,3,3,4,3,0,0,0,0,0,3,22,8,23,6,7,0
"20231104ANNKEL",2023-11-04,"Scotland League 1","Annan Athletic","Kelty Hearts",2,2,"D",7,8,3,4,13,5,4,17,3,2,0,0,0,0,0,4,15,7,18,21,5,0
"20231104COVHAM",2023-11-04,"Scotland League 1","Cove Rangers","Hamilton",1,0,"H",5,13,2,4,10,7,4,9,0,0,0,0,0,0,0,1,18,6,17,13,0,0
"20231104EDIMON",2023-11-04,"Scotland League 1","Edinburgh City","Montrose",1,5,"A",4,13,1,8,17,15,5,7,5,2,0,0,0,0,0,6,17,9,32,12,7,0
"20231104QUEFAL",2023-11-04,"Scotland League 1","Queen of Sth","Falkirk",1,1,"D",10,15,3,4,10,9,6,6,1,0,0,0,0,0,0,2,25,7,19,12,1,0
"20231104STIALL",2023-11-04,"Scotland League 1","Stirling","Alloa",0,2,"A",8,14,2,6,12,7,5,6,2,1,0,0,0,0,0,2,22,8,19,11,3,0
"20231111ALLQUE",2023-11-11,"Scotland League 1","Alloa","Queen of Sth",1,0,"H",8,7,4,2,6,7,3,7,1,3,0,0,0,0,0,1,15,6,13,10,4,0
"20231111FALEDI",2023-11-11,"Scotland League 1","Falkirk","Edinburgh City",2,1,"H",18,6,7,1,15,14,5,2,1,7,0,0,0,0,0,3,24,8,29,7,8,0
"20231111HAMSTI",2023-11-11,"Scotland League 1","Hamilton","Stirling",5,0,"H",17,2,9,1,11,10,4,2,0,2,0,1,0,0,0,5,19,10,21,6,2,1
"20231111KELCOV",2023-11-11,"Scotland League 1","Kelty Hearts","Cove Rangers",0,1,"A",10,13,1,4,12,11,5,8,2,1,0,0,0,0,0,1,23,5,23,13,3,0
"20231111MONANN",2023-11-11,"Scotland League 1","Montrose","Annan Athletic",1,1,"D",15,12,2,4,9,10,4,4,4,3,0,0,0,0,0,2,27,6,19,8,7,0
"20231114COVMON",2023-11-14,"Scotland League 1","Cove Rangers","Montrose",1,0,"H",7,6,4,3,6,12,5,7,1,3,0,0,0,0,0,1,13,7,18,12,4,0
"20231118COVSTI",2023-11-18,"Scotland League 1","Cove Rangers","Stirling",3,1,"H",8,6,6,4,14,10,9,1,2,0,0,0,0,0,0,4,14,10,24,10,2,0
"20231118EDIALL",2023-11-18,"Scotland League 1","Edinburgh City","Alloa",3,0,"H",10,14,4,4,15,10,0,5,4,1,0,0,0,0,0,3,24,8,25,5,5,0
"20231118QUEKEL",2023-11-18,"Scotland League 1","Queen of Sth","Kelty Hearts",1,3,"A",11,11,6,4,9,10,7,5,2,1,0,0,0,0,0,4,22,10,19,12,3,0
"20231128ANNHAM",2023-11-28,"Scotland League 1","Annan Athletic","Hamilton",1,2,"A",9,17,2,5,7,13,1,6,2,2,0,1,0,0,0,3,26,7,20,7,4,1
"20231128MONFAL",2023-11-28,"Scotland League 1","Montrose","Falkirk",0,0,"D",5,10,1,3,13,16,5,7,2,4,0,0,0,0,0,0,15,4,29,12,6,0
"20231202HAMQUE",2023-12-02,"Scotland League 1","Hamilton","Queen of Sth",5,0,"H",20,5,11,1,2,8,12,2,1,3,0,1,0,0,0,5,25,12,10,14,4,1
"20231209ALLHAM",2023-12-09,"Scotland League 1","Alloa","Hamilton",0,0,"D",8,10,3,3,12,9,7,5,1,3,0,0,0,0,0,0,18,6,21,12,4,0
"20231209ANNCOV",2023-12-09,"Scotland League 1","Annan Athletic","Cove Rangers",1,3,"A",11,8,5,5,17,5,4,2,1,2,0,1,0,0,0,4,19,10,22,6,3,1
"20231209EDISTI",2023-12-09,"Scotland League 1","Edinburgh City","Stirling",1,3,"A",7,18,5,8,8,8,3,9,2,3,0,0,0,0,0,4,25,13,16,12,5,0
"20231209FALKEL",2023-12-09,"Scotland League 1","Falkirk","Kelty Hearts",2,1,"H",21,3,11,2,22,10,11,0,5,2,0,0,0,0,0,3,24,13,32,11,7,0
"20231209MONQUE",2023-12-09,"Scotland League 1","Montrose","Queen of Sth",1,4,"A",6,12,1,6,14,11,6,7,4,0,0,0,0,0,0,5,18,7,25,13,4,0
"20231216COVALL",2023-12-16,"Scotland League 1","Cove Rangers","Alloa",1,2,"A",5,7,2,5,15,8,2,6,1,2,0,0,0,0,0,3,12,7,23,8,3,0
"20231216HAMFAL",2023-12-16,"Scotland League 1","Hamilton","Falkirk",1,3,"A",9,9,5,5,16,11,6,4,2,4,0,0,0,0,0,4,18,10,27,10,6,0
"20231216KELMON",2023-12-16,"Scotland League 1","Kelty Hearts","Montrose",0,1,"A",6,7,3,4,9,17,2,2,1,1,0,0,0,0,0,1,13,7,26,4,2,0
"20231216QUEEDI",2023-12-16,"Scotland League 1","Queen of Sth","Edinburgh City",3,1,"H",16,4,6,2,10,14,2,3,1,3,0,0,0,0,0,4,20,8,24,5,4,0
"20231216STIANN",2023-12-16,"Scotland League 1","Stirling","Annan Athletic",1,1,"D",12,8,4,1,17,11,3,7,2,3,0,0,0,0,0,2,20,5,28,10,5,0
"20231223ALLMON",2023-12-23,"Scotland League 1","Alloa","Montrose",2,2,"D",12,5,5,2,11,6,5,1,2,3,0,0,0,0,0,4,17,7,17,6,5,0
"20231223ANNFAL",2023-12-23,"Scotland League 1","Annan Athletic","Falkirk",0,3,"A",2,16,2,8,7,14,1,12,3,3,0,0,0,0,0,3,18,10,21,13,6,0
"20231223HAMKEL",2023-12-23,"Scotland League 1","Hamilton","Kelty Hearts",1,1,"D",11,5,9,2,22,14,9,4,1,2,1,0,0,0,0,2,16,11,36,13,3,1
"20231223STIQUE",2023-12-23,"Scotland League 1","Stirling","Queen of Sth",1,1,"D",8,16,5,6,11,13,4,10,1,2,0,0,0,0,0,2,24,11,24,14,3,0
"20231223COVEDI",2023-12-23,"Scotland League 1","Cove Rangers","Edinburgh City",7,2,"H",21,7,13,5,9,12,12,1,1,0,0,1,0,0,0,9,28,18,21,13,1,1
"20231230EDIHAM",2023-12-30,"Scotland League 1","Edinburgh City","Hamilton",2,5,"A",5,23,3,9,7,10,1,13,3,0,0,0,0,0,0,7,28,12,17,14,3,0
"20231230FALSTI",2023-12-30,"Scotland League 1","Falkirk","Stirling",5,0,"H",14,2,8,2,6,6,12,2,0,1,0,0,0,0,0,5,16,10,12,14,1,0
"20231230MONCOV",2023-12-30,"Scotland League 1","Montrose","Cove Rangers",1,1,"D",9,11,4,5,5,5,10,5,1,2,0,0,0,0,0,2,20,9,10,15,3,0
"20231230QUEANN",2023-12-30,"Scotland League 1","Queen of Sth","Annan Athletic",2,1,"H",7,7,3,4,17,12,2,4,3,4,0,1,0,0,0,3,14,7,29,6,7,1
"20240106ALLEDI",2024-01-06,"Scotland League 1","Alloa","Edinburgh City",3,1,"H",11,4,4,2,7,9,6,0,1,2,0,0,0,0,0,4,15,6,16,6,3,0
"20240106ANNMON",2024-01-06,"Scotland League 1","Annan Athletic","Montrose",2,2,"D",10,9,4,5,11,10,5,4,2,2,0,2,0,0,0,4,19,9,21,9,4,2
"20240106COVKEL",2024-01-06,"Scotland League 1","Cove Rangers","Kelty Hearts",2,2,"D",9,6,4,5,11,9,6,3,1,0,0,0,0,0,0,4,15,9,20,9,1,0
"20240106FALQUE",2024-01-06,"Scotland League 1","Falkirk","Queen of Sth",1,0,"H",15,1,3,0,7,9,3,0,2,1,0,0,0,0,0,1,16,3,16,3,3,0
"20240109FALCOV",2024-01-09,"Scotland League 1","Falkirk","Cove Rangers",4,0,"H",16,2,10,0,12,5,9,0,1,1,0,0,0,0,0,4,18,10,17,9,2,0
"20240113HAMCOV",2024-01-13,"Scotland League 1","Hamilton","Cove Rangers",2,0,"H",10,17,5,5,12,9,1,2,1,0,1,1,0,0,0,2,27,10,21,3,1,2
"20240113KELANN",2024-01-13,"Scotland League 1","Kelty Hearts","Annan Athletic",1,1,"D",6,2,2,1,7,15,6,1,0,4,0,0,0,0,0,2,8,3,22,7,4,0
"20240113MONSTI",2024-01-13,"Scotland League 1","Montrose","Stirling",0,1,"A",9,9,3,3,6,15,8,2,2,1,0,1,0,0,0,1,18,6,21,10,3,1
"20240113QUEALL",2024-01-13,"Scotland League 1","Queen of Sth","Alloa",1,1,"D",10,6,5,1,10,10,4,2,2,2,0,0,0,0,0,2,16,6,20,6,4,0
"20240113EDIFAL",2024-01-13,"Scotland League 1","Edinburgh City","Falkirk",2,2,"D",8,25,2,7,14,13,1,15,5,1,0,0,0,0,0,4,33,9,27,16,6,0
"20240127ALLFAL",2024-01-27,"Scotland League 1","Alloa","Falkirk",0,5,"A",4,22,2,11,12,7,3,7,1,2,0,0,0,0,0,5,26,13,19,10,3,0
"20240127ANNEDI",2024-01-27,"Scotland League 1","Annan Athletic","Edinburgh City",3,0,"H",16,6,9,4,6,16,6,5,0,3,0,0,0,0,0,3,22,13,22,11,3,0
"20240127COVQUE",2024-01-27,"Scotland League 1","Cove Rangers","Queen of Sth",0,2,"A",4,6,2,4,9,12,4,6,1,2,0,0,0,0,0,2,10,6,21,10,3,0
"20240127HAMMON",2024-01-27,"Scotland League 1","Hamilton","Montrose",1,1,"D",5,3,3,2,1,11,8,3,0,2,0,0,0,0,0,2,8,5,12,11,2,0
"20240127STIKEL",2024-01-27,"Scotland League 1","Stirling","Kelty Hearts",5,0,"H",13,8,9,5,8,12,5,7,1,2,0,1,0,0,0,5,21,14,20,12,3,1
"20240203ANNALL",2024-02-03,"Scotland League 1","Annan Athletic","Alloa",2,3,"A",9,13,4,7,12,15,5,3,3,4,0,0,0,0,0,5,22,11,27,8,7,0
"20240203EDIKEL",2024-02-03,"Scotland League 1","Edinburgh City","Kelty Hearts",0,3,"A",11,14,0,7,14,8,0,6,1,2,0,0,0,0,0,3,25,7,22,6,3,0
"20240203QUEHAM",2024-02-03,"Scotland League 1","Queen of Sth","Hamilton",0,2,"A",10,13,2,5,11,4,2,6,0,1,0,0,0,0,0,2,23,7,15,8,1,0
"20240203STICOV",2024-02-03,"Scotland League 1","Stirling","Cove Rangers",2,2,"D",13,9,7,4,14,6,4,6,1,0,0,0,0,0,0,4,22,11,20,10,1,0
"20240206STIMON",2024-02-06,"Scotland League 1","Stirling","Montrose",0,2,"A",4,11,1,5,4,9,1,3,2,2,0,0,0,0,0,2,15,6,13,4,4,0
"20240210ALLSTI",2024-02-10,"Scotland League 1","Alloa","Stirling",1,0,"H",8,6,1,0,12,10,8,7,1,3,0,0,0,0,0,1,14,1,22,15,4,0
"20240210HAMANN",2024-02-10,"Scotland League 1","Hamilton","Annan Athletic",2,3,"A",19,8,7,4,13,7,9,6,4,3,0,0,0,0,0,5,27,11,20,15,7,0
"20240210KELQUE",2024-02-10,"Scotland League 1","Kelty Hearts","Queen of Sth",0,0,"D",4,9,1,4,13,15,8,6,3,2,0,0,0,0,0,0,13,5,28,14,5,0
"20240210MONEDI",2024-02-10,"Scotland League 1","Montrose","Edinburgh City",3,0,"H",15,13,6,2,12,3,8,1,1,1,0,0,0,0,0,3,28,8,15,9,2,0
"20240213ALLANN",2024-02-13,"Scotland League 1","Alloa","Annan Athletic",2,1,"H",11,11,7,9,11,10,5,6,3,2,0,0,0,0,0,3,22,16,21,11,5,0
"20240213KELEDI",2024-02-13,"Scotland League 1","Kelty Hearts","Edinburgh City",3,2,"H",15,14,5,4,10,17,6,2,2,4,0,0,0,0,0,5,29,9,27,8,6,0
"20240217ALLCOV",2024-02-17,"Scotland League 1","Alloa","Cove Rangers",4,1,"H",7,8,4,1,2,5,8,6,0,1,1,0,0,0,0,5,15,5,7,14,1,1
"20240217ANNSTI",2024-02-17,"Scotland League 1","Annan Athletic","Stirling",2,1,"H",12,5,5,3,9,12,8,5,1,0,0,0,0,0,0,3,17,8,21,13,1,0
"20240217EDIQUE",2024-02-17,"Scotland League 1","Edinburgh City","Queen of Sth",1,1,"D",6,12,3,4,10,15,4,4,2,3,0,0,0,0,0,2,18,7,25,8,5,0
"20240217FALHAM",2024-02-17,"Scotland League 1","Falkirk","Hamilton",3,2,"H",13,13,7,7,9,10,2,10,0,3,0,0,0,0,0,5,26,14,19,12,3,0
"20240217MONKEL",2024-02-17,"Scotland League 1","Montrose","Kelty Hearts",4,2,"H",13,11,5,4,14,7,7,3,1,1,0,0,0,0,0,6,24,9,21,10,2,0
"20240220FALMON",2024-02-20,"Scotland League 1","Falkirk","Montrose",3,0,"H",16,5,8,1,13,13,5,4,2,1,0,0,0,0,0,3,21,9,26,9,3,0
"20240224COVANN",2024-02-24,"Scotland League 1","Cove Rangers","Annan Athletic",2,1,"H",10,6,4,3,6,8,3,9,1,2,0,0,0,0,0,3,16,7,14,12,3,0
"20240224HAMALL",2024-02-24,"Scotland League 1","Hamilton","Alloa",1,2,"A",18,13,9,5,5,9,8,8,0,0,0,0,0,0,0,3,31,14,14,16,0,0
"20240224KELFAL",2024-02-24,"Scotland League 1","Kelty Hearts","Falkirk",0,1,"A",4,12,2,7,13,14,5,16,3,2,1,0,0,0,0,1,16,9,27,21,5,1
"20240224STIEDI",2024-02-24,"Scotland League 1","Stirling","Edinburgh City",4,0,"H",18,4,12,1,7,14,8,3,1,1,0,1,0,0,0,4,22,13,21,11,2,1
"20240224QUEMON",2024-02-24,"Scotland League 1","Queen of Sth","Montrose",2,3,"A",6,9,2,4,14,13,3,5,1,1,0,0,0,0,0,5,15,6,27,8,2,0
"20240227STIHAM",2024-02-27,"Scotland League 1","Stirling","Hamilton",0,0,"D",7,13,4,3,12,13,4,8,2,2,0,0,0,0,0,0,20,7,25,12,4,0
"20240302EDICOV",2024-03-02,"Scotland League 1","Edinburgh City","Cove Rangers",0,2,"A",14,13,7,10,8,11,4,5,1,2,0,0,0,0,0,2,27,17,19,9,3,0
"20240302FALANN",2024-03-02,"Scotland League 1","Falkirk","Annan Athletic",1,1,"D",19,5,6,3,11,10,13,1,1,2,0,0,0,0,0,2,24,9,21,14,3,0
"20240302KELHAM",2024-03-02,"Scotland League 1","Kelty Hearts","Hamilton",0,5,"A",6,13,3,8,9,10,4,6,1,0,0,0,0,0,0,5,19,11,19,10,1,0
"20240302MONALL",2024-03-02,"Scotland League 1","Montrose","Alloa",4,3,"H",14,13,7,7,8,4,2,5,1,2,0,1,0,0,0,7,27,14,12,7,3,1
"20240302QUESTI",2024-03-02,"Scotland League 1","Queen of Sth","Stirling",2,2,"D",7,6,3,4,12,13,7,7,4,4,0,0,0,0,0,4,13,7,25,14,8,0
"20240305COVFAL",2024-03-05,"Scotland League 1","Cove Rangers","Falkirk",0,1,"A",2,13,1,6,8,10,1,10,2,2,0,0,0,0,0,1,15,7,18,11,4,0
"20240309ALLKEL",2024-03-09,"Scotland League 1","Alloa","Kelty Hearts",3,0,"H",17,5,9,1,3,7,9,2,0,2,0,0,0,0,0,3,22,10,10,11,2,0
"20240309ANNQUE",2024-03-09,"Scotland League 1","Annan Athletic","Queen of Sth",2,1,"H",10,9,6,5,5,9,10,5,0,2,0,0,0,0,0,3,19,11,14,15,2,0
"20240309COVMON",2024-03-09,"Scotland League 1","Cove Rangers","Montrose",1,4,"A",9,10,2,7,11,13,4,2,1,1,0,0,0,0,0,5,19,9,24,6,2,0
"20240309HAMEDI",2024-03-09,"Scotland League 1","Hamilton","Edinburgh City",1,0,"H",10,9,4,5,11,15,6,4,1,2,0,0,0,0,0,1,19,9,26,10,3,0
"20240309STIFAL",2024-03-09,"Scotland League 1","Stirling","Falkirk",1,2,"A",11,12,3,7,13,8,2,9,2,2,0,0,0,0,0,3,23,10,21,11,4,0
"20240316EDIALL",2024-03-16,"Scotland League 1","Edinburgh City","Alloa",2,5,"A",11,12,7,6,13,6,4,6,2,0,0,0,0,0,0,7,23,13,19,10,2,0
"20240316HAMSTI",2024-03-16,"Scotland League 1","Hamilton","Stirling",3,0,"H",13,8,6,3,8,10,4,3,0,0,0,0,0,0,0,3,21,9,18,7,0,0
"20240316KELCOV",2024-03-16,"Scotland League 1","Kelty Hearts","Cove Rangers",0,1,"A",11,5,3,2,7,9,3,6,1,2,0,0,0,0,0,1,16,5,16,9,3,0
"20240316MONANN",2024-03-16,"Scotland League 1","Montrose","Annan Athletic",1,1,"D",10,9,4,4,13,6,5,8,3,4,0,0,0,0,0,2,19,8,19,13,7,0
"20240316QUEFAL",2024-03-16,"Scotland League 1","Queen of Sth","Falkirk",1,4,"A",12,15,7,7,11,9,5,5,4,1,0,0,0,0,0,5,27,14,20,10,5,0
"20240319KELALL",2024-03-19,"Scotland League 1","Kelty Hearts","Alloa",2,1,"H",17,3,7,1,8,15,4,8,1,2,0,0,0,0,0,3,20,8,23,12,3,0
"20240323ALLQUE",2024-03-23,"Scotland League 1","Alloa","Queen of Sth",0,2,"A",6,11,3,7,10,10,7,7,0,0,0,0,0,0,0,2,17,10,20,14,0,0
"20240323ANNKEL",2024-03-23,"Scotland League 1","Annan Athletic","Kelty Hearts",3,2,"H",8,10,6,4,15,8,2,6,0,2,0,1,0,0,0,5,18,10,23,8,2,1
"20240323COVHAM",2024-03-23,"Scotland League 1","Cove Rangers","Hamilton",1,3,"A",12,14,5,5,4,9,7,6,0,1,0,0,0,0,0,4,26,10,13,13,1,0
"20240323FALEDI",2024-03-23,"Scotland League 1","Falkirk","Edinburgh City",4,1,"H",19,7,7,6,8,11,9,2,2,1,0,0,0,0,0,5,26,13,19,11,3,0
"20240323STIMON",2024-03-23,"Scotland League 1","Stirling","Montrose",1,0,"H",11,4,5,1,7,8,5,5,2,1,0,0,0,0,0,1,15,6,15,10,3,0
"20240330ALLANN",2024-03-30,"Scotland League 1","Alloa","Annan Athletic",1,1,"D",12,7,5,3,11,9,2,3,2,0,0,0,0,0,0,2,19,8,20,5,2,0
"20240330COVSTI",2024-03-30,"Scotland League 1","Cove Rangers","Stirling",4,2,"H",5,5,3,4,8,7,7,1,2,3,0,0,0,0,0,6,10,7,15,8,5,0
"20240330HAMQUE",2024-03-30,"Scotland League 1","Hamilton","Queen of Sth",0,0,"D",8,9,3,5,11,8,3,2,1,1,1,0,0,0,0,0,17,8,19,5,2,1
"20240330KELEDI",2024-03-30,"Scotland League 1","Kelty Hearts","Edinburgh City",3,1,"H",10,10,6,2,9,13,5,3,0,1,0,0,0,0,0,4,20,8,22,8,1,0
"20240330MONFAL",2024-03-30,"Scotland League 1","Montrose","Falkirk",1,7,"A",4,17,2,10,7,13,4,6,2,1,0,0,0,0,0,8,21,12,20,10,3,0
"20240406ANNHAM",2024-04-06,"Scotland League 1","Annan Athletic","Hamilton",1,3,"A",13,9,7,4,8,16,5,5,2,3,0,0,0,0,0,4,22,11,24,10,5,0
"20240406QUEKEL",2024-04-06,"Scotland League 1","Queen of Sth","Kelty Hearts",1,2,"A",7,14,3,4,15,11,8,4,4,3,0,0,0,0,0,3,21,7,26,12,7,0
"20240406STIALL",2024-04-06,"Scotland League 1","Stirling","Alloa",1,5,"A",12,9,4,7,5,11,6,2,1,2,0,0,0,0,0,6,21,11,16,8,3,0
"20240406FALCOV",2024-04-06,"Scotland League 1","Falkirk","Cove Rangers",5,1,"H",19,7,8,4,6,5,10,6,0,1,0,0,0,0,0,6,26,12,11,16,1,0
"20240413ALLMON",2024-04-13,"Scotland League 1","Alloa","Montrose",0,0,"D",5,7,2,5,3,14,6,6,1,1,0,0,0,0,0,0,12,7,17,12,2,0
"20240413ANNCOV",2024-04-13,"Scotland League 1","Annan Athletic","Cove Rangers",4,2,"H",10,7,8,5,10,6,4,8,3,1,0,0,0,0,0,6,17,13,16,12,4,0
"20240413KELSTI",2024-04-13,"Scotland League 1","Kelty Hearts","Stirling",1,0,"H",9,9,1,4,12,11,4,5,4,5,0,0,0,0,0,1,18,5,23,9,9,0
"20240413QUEEDI",2024-04-13,"Scotland League 1","Queen of Sth","Edinburgh City",2,0,"H",17,9,10,3,11,11,11,2,1,2,0,0,0,0,0,2,26,13,22,13,3,0
"20240413HAMFAL",2024-04-13,"Scotland League 1","Hamilton","Falkirk",0,2,"A",7,12,2,7,18,11,3,9,2,2,0,0,0,0,0,2,19,9,29,12,4,0
"20240416EDIMON",2024-04-16,"Scotland League 1","Edinburgh City","Montrose",1,0,"H",12,6,5,2,9,8,2,7,2,2,0,0,0,0,0,1,18,7,17,9,4,0
"20240420EDIANN",2024-04-20,"Scotland League 1","Edinburgh City","Annan Athletic",1,2,"A",5,15,2,6,16,10,4,3,4,1,0,0,0,0,0,3,20,8,26,7,5,0
"20240420FALKEL",2024-04-20,"Scotland League 1","Falkirk","Kelty Hearts",2,2,"D",10,16,3,4,10,8,4,7,2,0,1,0,0,0,0,4,26,7,18,11,2,1
"20240420MONHAM",2024-04-20,"Scotland League 1","Montrose","Hamilton",1,2,"A",8,15,2,6,11,8,9,3,0,0,0,0,0,0,0,3,23,8,19,12,0,0
"20240420STIQUE",2024-04-20,"Scotland League 1","Stirling","Queen of Sth",0,0,"D",10,10,4,6,16,7,8,6,1,1,0,0,0,0,0,0,20,10,23,14,2,0
"20240420COVALL",2024-04-20,"Scotland League 1","Cove Rangers","Alloa",2,3,"A",11,9,9,6,7,5,7,8,4,1,0,0,0,0,0,5,20,15,12,15,5,0
"20240427ALLHAM",2024-04-27,"Scotland League 1","Alloa","Hamilton",0,1,"A",9,8,4,5,11,12,4,4,1,2,0,0,0,0,0,1,17,9,23,8,3,0
"20240427ANNFAL",2024-04-27,"Scotland League 1","Annan Athletic","Falkirk",3,3,"D",5,12,3,8,7,17,3,13,2,2,0,0,0,0,0,6,17,11,24,16,4,0
"20240427EDISTI",2024-04-27,"Scotland League 1","Edinburgh City","Stirling",1,3,"A",11,17,4,7,14,14,3,8,3,4,0,0,0,0,0,4,28,11,28,11,7,0
"20240427KELMON",2024-04-27,"Scotland League 1","Kelty Hearts","Montrose",0,2,"A",11,7,4,5,11,9,7,2,1,1,0,0,0,0,0,2,18,9,20,9,2,0
"20240427QUECOV",2024-04-27,"Scotland League 1","Queen of Sth","Cove Rangers",2,0,"H",15,4,10,1,11,13,11,5,2,0,0,0,0,0,0,2,19,11,24,16,2,0
"20240504COVEDI",2024-05-04,"Scotland League 1","Cove Rangers","Edinburgh City",3,1,"H",17,5,9,2,13,11,4,3,2,1,0,0,0,0,0,4,22,11,24,7,3,0
"20240504FALALL",2024-05-04,"Scotland League 1","Falkirk","Alloa",2,2,"D",24,7,11,3,10,10,13,1,1,3,0,0,0,0,0,4,31,14,20,14,4,0
"20240504HAMKEL",2024-05-04,"Scotland League 1","Hamilton","Kelty Hearts",4,1,"H",19,12,12,5,7,6,6,3,0,0,0,0,0,0,0,5,31,17,13,9,0,0
"20240504MONQUE",2024-05-04,"Scotland League 1","Montrose","Queen of Sth",3,2,"H",9,11,6,4,13,13,3,6,1,0,0,0,0,0,0,5,20,10,26,9,1,0
"20240504STIANN",2024-05-04,"Scotland League 1","Stirling","Annan Athletic",1,1,"D",15,5,6,2,20,11,10,0,3,2,0,0,0,0,0,2,20,8,31,10,5,0
"20240803ALLQUE",2024-08-03,"Scotland League 1","Alloa","Queen of Sth",0,0,"D",9,6,3,3,11,3,11,3,0,0,0,0,0,0,0,0,15,6,14,14,0,0
"20240803COVANN",2024-08-03,"Scotland League 1","Cove Rangers","Annan Athletic",1,3,"A",9,8,2,4,9,6,4,8,2,1,1,0,0,0,0,4,17,6,15,12,3,1
"20240803INVDUM",2024-08-03,"Scotland League 1","Inverness C","Dumbarton",1,1,"D",11,7,5,3,9,17,7,7,2,1,0,1,0,0,0,2,18,8,26,14,3,1
"20240803MONKEL",2024-08-03,"Scotland League 1","Montrose","Kelty Hearts",1,1,"D",10,14,4,4,9,10,12,4,2,1,0,0,0,0,0,2,24,8,19,16,3,0
"20240803STEARB",2024-08-03,"Scotland League 1","Stenhousemuir","Arbroath",2,1,"H",9,8,5,1,7,12,12,8,3,1,0,0,0,0,0,3,17,6,19,20,4,0
"20240810ANNINV",2024-08-10,"Scotland League 1","Annan Athletic","Inverness C",1,0,"H",5,5,2,1,13,9,6,6,2,1,0,0,0,0,0,1,10,3,22,12,3,0
"20240810ARBMON",2024-08-10,"Scotland League 1","Arbroath","Montrose",0,0,"D",11,2,5,2,10,13,3,2,1,2,0,1,0,0,0,0,13,7,23,5,3,1
"20240810DUMALL",2024-08-10,"Scotland League 1","Dumbarton","Alloa",3,3,"D",9,11,3,9,12,10,10,2,3,3,0,0,0,0,0,6,20,12,22,12,6,0
"20240810KELSTE",2024-08-10,"Scotland League 1","Kelty Hearts","Stenhousemuir",2,0,"H",11,13,7,2,14,8,6,8,2,0,0,0,0,0,0,2,24,9,22,14,2,0
"20240810QUECOV",2024-08-10,"Scotland League 1","Queen of Sth","Cove Rangers",2,1,"H",10,13,6,7,6,4,2,7,3,1,0,0,0,0,0,3,23,13,10,9,4,0
"20240817ALLSTE",2024-08-17,"Scotland League 1","Alloa","Stenhousemuir",1,0,"H",12,10,8,4,13,13,7,4,3,3,0,0,0,0,0,1,22,12,26,11,6,0
"20240817ARBKEL",2024-08-17,"Scotland League 1","Arbroath","Kelty Hearts",0,3,"A",10,15,5,7,8,11,3,7,1,2,0,0,0,0,0,3,25,12,19,10,3,0
"20240817COVDUM",2024-08-17,"Scotland League 1","Cove Rangers","Dumbarton",1,1,"D",12,12,6,5,7,11,6,4,2,1,0,0,0,0,0,2,24,11,18,10,3,0
"20240817INVMON",2024-08-17,"Scotland League 1","Inverness C","Montrose",1,1,"D",17,2,7,1,10,11,7,4,2,4,0,1,0,0,0,2,19,8,21,11,6,1
"20240817QUEANN",2024-08-17,"Scotland League 1","Queen of Sth","Annan Athletic",2,0,"H",9,7,5,2,9,7,4,10,3,5,0,0,0,0,0,2,16,7,16,14,8,0
"20240824ANNALL",2024-08-24,"Scotland League 1","Annan Athletic","Alloa",0,1,"A",12,7,2,5,7,10,4,6,3,3,0,0,0,0,0,1,19,7,17,10,6,0
"20240824DUMARB",2024-08-24,"Scotland League 1","Dumbarton","Arbroath",2,2,"D",15,10,7,5,8,10,14,11,1,3,0,0,0,0,0,4,25,12,18,25,4,0
"20240824KELINV",2024-08-24,"Scotland League 1","Kelty Hearts","Inverness C",0,0,"D",6,6,3,1,6,14,5,3,3,3,0,0,0,0,0,0,12,4,20,8,6,0
"20240824STECOV",2024-08-24,"Scotland League 1","Stenhousemuir","Cove Rangers",3,2,"H",8,5,4,2,7,13,6,5,2,1,0,0,0,0,0,5,13,6,20,11,3,0
"20240824MONQUE",2024-08-24,"Scotland League 1","Montrose","Queen of Sth",1,0,"H",6,10,1,2,10,16,7,4,1,2,0,1,0,0,0,1,16,3,26,11,3,1
"20240831ARBALL",2024-08-31,"Scotland League 1","Arbroath","Alloa",0,0,"D",9,3,2,2,11,11,8,1,3,2,0,0,0,0,0,0,12,4,22,9,5,0
"20240831COVMON",2024-08-31,"Scotland League 1","Cove Rangers","Montrose",1,0,"H",9,3,3,2,12,12,5,8,2,2,0,0,0,0,0,1,12,5,24,13,4,0
"20240831DUMKEL",2024-08-31,"Scotland League 1","Dumbarton","Kelty Hearts",2,2,"D",14,7,6,4,10,6,13,3,2,0,0,0,0,0,0,4,21,10,16,16,2,0
"20240831INVQUE",2024-08-31,"Scotland League 1","Inverness C","Queen of Sth",1,0,"H",7,7,3,1,12,10,1,2,2,2,0,0,0,0,0,1,14,4,22,3,4,0
"20240831STEANN",2024-08-31,"Scotland League 1","Stenhousemuir","Annan Athletic",5,1,"H",11,13,6,7,14,6,3,5,2,1,0,0,0,0,0,6,24,13,20,8,3,0
"20240914ALLINV",2024-09-14,"Scotland League 1","Alloa","Inverness C",2,2,"D",6,10,5,6,10,10,6,4,1,2,0,0,0,0,0,4,16,11,20,10,3,0
"20240914ANNDUM",2024-09-14,"Scotland League 1","Annan Athletic","Dumbarton",1,1,"D",16,10,6,7,6,11,12,7,2,3,0,1,0,0,0,2,26,13,17,19,5,1
"20240914KELCOV",2024-09-14,"Scotland League 1","Kelty Hearts","Cove Rangers",1,3,"A",9,13,5,5,5,7,2,4,0,0,0,0,0,0,0,4,22,10,12,6,0,0
"20240914MONSTE",2024-09-14,"Scotland League 1","Montrose","Stenhousemuir",3,0,"H",10,10,4,2,12,14,2,6,3,3,0,0,0,0,0,3,20,6,26,8,6,0
"20240914QUEARB",2024-09-14,"Scotland League 1","Queen of Sth","Arbroath",2,1,"H",11,6,6,2,14,8,4,5,3,0,0,0,0,0,0,3,17,8,22,9,3,0
"20240921ALLKEL",2024-09-21,"Scotland League 1","Alloa","Kelty Hearts",1,0,"H",8,8,4,5,21,11,7,7,2,5,0,0,0,0,0,1,16,9,32,14,7,0
"20240921ARBANN",2024-09-21,"Scotland League 1","Arbroath","Annan Athletic",2,0,"H",8,3,3,1,12,8,8,1,4,0,0,0,0,0,0,2,11,4,20,9,4,0
"20240921DUMMON",2024-09-21,"Scotland League 1","Dumbarton","Montrose",0,1,"A",11,1,2,1,7,12,15,0,0,1,0,0,0,0,0,1,12,3,19,15,1,0
"20240921INVCOV",2024-09-21,"Scotland League 1","Inverness C","Cove Rangers",1,1,"D",6,5,3,2,6,20,2,3,1,4,0,0,0,0,0,2,11,5,26,5,5,0
"20240921STEQUE",2024-09-21,"Scotland League 1","Stenhousemuir","Queen of Sth",0,0,"D",4,14,1,10,20,8,3,6,6,3,0,0,0,0,0,0,18,11,28,9,9,0
"20240928INVSTE",2024-09-28,"Scotland League 1","Inverness C","Stenhousemuir",0,0,"D",8,6,3,1,11,15,3,1,2,1,0,0,0,0,0,0,14,4,26,4,3,0
"20240928KELANN",2024-09-28,"Scotland League 1","Kelty Hearts","Annan Athletic",3,0,"H",7,3,5,2,13,7,8,2,1,0,0,1,0,0,0,3,10,7,20,10,1,1
"20240928MONALL",2024-09-28,"Scotland League 1","Montrose","Alloa",2,2,"D",7,11,4,5,8,10,6,11,2,2,0,0,0,0,0,4,18,9,18,17,4,0
"20240928QUEDUM",2024-09-28,"Scotland League 1","Queen of Sth","Dumbarton",2,0,"H",12,16,5,2,7,9,5,3,1,3,0,1,0,0,0,2,28,7,16,8,4,1
"20240928COVARB",2024-09-28,"Scotland League 1","Cove Rangers","Arbroath",2,4,"A",9,8,4,7,18,9,10,4,2,1,0,0,0,0,0,6,17,11,27,14,3,0
"20241005ALLCOV",2024-10-05,"Scotland League 1","Alloa","Cove Rangers",0,2,"A",1,8,0,3,17,10,2,3,1,2,1,0,0,0,0,2,9,3,27,5,3,1
"20241005ANNMON",2024-10-05,"Scotland League 1","Annan Athletic","Montrose",1,0,"H",10,4,3,0,10,14,4,0,1,2,0,0,0,0,0,1,14,3,24,4,3,0
"20241005ARBINV",2024-10-05,"Scotland League 1","Arbroath","Inverness C",1,0,"H",4,11,2,3,14,7,3,3,0,1,1,0,0,0,0,1,15,5,21,6,1,1
"20241005DUMSTE",2024-10-05,"Scotland League 1","Dumbarton","Stenhousemuir",1,3,"A",7,20,2,10,10,13,3,12,0,0,1,0,0,0,0,4,27,12,23,15,0,1
"20241005QUEKEL",2024-10-05,"Scotland League 1","Queen of Sth","Kelty Hearts",1,5,"A",7,11,4,6,11,9,5,6,3,1,1,0,0,0,0,6,18,10,20,11,4,1
"20241019ARBDUM",2024-10-19,"Scotland League 1","Arbroath","Dumbarton",1,3,"A",4,11,1,8,7,12,3,6,2,4,0,0,0,0,0,4,15,9,19,9,6,0
"20241019COVQUE",2024-10-19,"Scotland League 1","Cove Rangers","Queen of Sth",2,0,"H",9,5,3,4,12,7,3,5,0,0,0,0,0,0,0,2,14,7,19,8,0,0
"20241019INVANN",2024-10-19,"Scotland League 1","Inverness C","Annan Athletic",1,0,"H",7,2,3,2,9,15,5,1,3,3,0,0,0,0,0,1,9,5,24,6,6,0
"20241019KELMON",2024-10-19,"Scotland League 1","Kelty Hearts","Montrose",0,2,"A",2,7,0,5,14,13,3,6,2,2,1,0,0,0,0,2,9,5,27,9,4,1
"20241019STEALL",2024-10-19,"Scotland League 1","Stenhousemuir","Alloa",0,1,"A",17,12,7,4,8,11,6,7,2,1,0,0,0,0,0,1,29,11,19,13,3,0
"20241026ALLARB",2024-10-26,"Scotland League 1","Alloa","Arbroath",0,1,"A",5,10,1,5,11,12,4,10,0,1,2,0,0,0,0,1,15,6,23,14,1,2
"20241026DUMINV",2024-10-26,"Scotland League 1","Dumbarton","Inverness C",3,1,"H",10,10,5,4,9,10,1,4,1,2,0,0,0,0,0,4,20,9,19,5,3,0
"20241026MONCOV",2024-10-26,"Scotland League 1","Montrose","Cove Rangers",0,2,"A",9,12,2,6,10,8,12,2,4,2,0,0,0,0,0,2,21,8,18,14,6,0
"20241026STEKEL",2024-10-26,"Scotland League 1","Stenhousemuir","Kelty Hearts",2,1,"H",14,6,5,5,13,14,13,6,3,3,0,0,0,0,0,3,20,10,27,19,6,0
"20241026ANNQUE",2024-10-26,"Scotland League 1","Annan Athletic","Queen of Sth",1,0,"H",6,12,2,4,16,16,5,5,4,3,0,0,0,0,0,1,18,6,32,10,7,0
"20241102DUMCOV",2024-11-02,"Scotland League 1","Dumbarton","Cove Rangers",0,3,"A",10,6,4,3,8,7,9,1,1,0,0,0,0,0,0,3,16,7,15,10,1,0
"20241102ALLANN",2024-11-02,"Scotland League 1","Alloa","Annan Athletic",5,0,"H",10,9,8,2,7,10,7,2,1,3,0,0,0,0,0,5,19,10,17,9,4,0
"20241102ARBSTE",2024-11-02,"Scotland League 1","Arbroath","Stenhousemuir",1,0,"H",11,9,4,1,10,12,6,6,0,4,0,0,0,0,0,1,20,5,22,12,4,0
"20241102INVKEL",2024-11-02,"Scotland League 1","Inverness C","Kelty Hearts",1,1,"D",9,8,5,3,11,7,8,6,2,0,0,0,0,0,0,2,17,8,18,14,2,0
"20241102QUEMON",2024-11-02,"Scotland League 1","Queen of Sth","Montrose",1,0,"H",NA,NA,NA,NA,NA,NA,NA,NA,3,2,0,2,0,0,0,1,NA,NA,NA,NA,5,2
"20241109ANNSTE",2024-11-09,"Scotland League 1","Annan Athletic","Stenhousemuir",1,1,"D",9,11,4,3,5,13,2,3,0,1,0,0,0,0,0,2,20,7,18,5,1,0
"20241109COVINV",2024-11-09,"Scotland League 1","Cove Rangers","Inverness C",1,2,"A",5,12,3,6,13,11,6,2,1,0,0,0,0,0,0,3,17,9,24,8,1,0
"20241109KELDUM",2024-11-09,"Scotland League 1","Kelty Hearts","Dumbarton",2,0,"H",15,9,4,3,6,9,10,5,0,0,0,0,0,0,0,2,24,7,15,15,0,0
"20241109MONARB",2024-11-09,"Scotland League 1","Montrose","Arbroath",1,1,"D",15,23,8,8,12,9,8,4,3,1,1,0,0,0,0,2,38,16,21,12,4,1
"20241109QUEALL",2024-11-09,"Scotland League 1","Queen of Sth","Alloa",1,1,"D",10,13,5,5,6,14,5,4,1,3,0,0,0,0,0,2,23,10,20,9,4,0
"20241116ANNKEL",2024-11-16,"Scotland League 1","Annan Athletic","Kelty Hearts",0,2,"A",9,7,1,4,7,15,4,1,0,4,0,0,0,0,0,2,16,5,22,5,4,0
"20241116ARBCOV",2024-11-16,"Scotland League 1","Arbroath","Cove Rangers",2,1,"H",7,10,5,3,9,8,9,3,3,3,0,0,0,0,0,3,17,8,17,12,6,0
"20241116DUMQUE",2024-11-16,"Scotland League 1","Dumbarton","Queen of Sth",2,1,"H",16,4,5,3,11,13,9,7,3,5,0,0,0,0,0,3,20,8,24,16,8,0
"20241116INVALL",2024-11-16,"Scotland League 1","Inverness C","Alloa",1,0,"H",10,5,5,2,11,11,5,2,3,2,0,0,0,0,0,1,15,7,22,7,5,0
"20241116STEMON",2024-11-16,"Scotland League 1","Stenhousemuir","Montrose",1,0,"H",12,6,4,3,9,9,4,5,0,1,0,0,0,0,0,1,18,7,18,9,1,0
"20241123MONANN",2024-11-23,"Scotland League 1","Montrose","Annan Athletic",2,1,"H",6,8,3,2,15,5,5,3,1,1,0,0,0,0,0,3,14,5,20,8,2,0
"20241203ALLDUM",2024-12-03,"Scotland League 1","Alloa","Dumbarton",2,2,"D",6,9,6,6,13,14,4,2,3,3,0,0,0,0,0,4,15,12,27,6,6,0
"20241203COVSTE",2024-12-03,"Scotland League 1","Cove Rangers","Stenhousemuir",0,3,"A",9,13,4,9,7,12,0,6,1,1,0,0,0,0,0,3,22,13,19,6,2,0
"20241207ANNCOV",2024-12-07,"Scotland League 1","Annan Athletic","Cove Rangers",1,1,"D",5,11,5,5,10,17,5,6,1,1,0,0,0,0,0,2,16,10,27,11,2,0
"20241207KELALL",2024-12-07,"Scotland League 1","Kelty Hearts","Alloa",0,2,"A",6,9,0,5,9,3,7,1,3,3,0,0,0,0,0,2,15,5,12,8,6,0
"20241207MONINV",2024-12-07,"Scotland League 1","Montrose","Inverness C",2,3,"A",3,19,2,13,11,9,3,10,3,0,1,0,0,0,0,5,22,15,20,13,3,1
"20241207STEDUM",2024-12-07,"Scotland League 1","Stenhousemuir","Dumbarton",4,0,"H",11,4,7,2,3,13,7,2,1,3,0,1,0,0,0,4,15,9,16,9,4,1
"20241207ARBQUE",2024-12-07,"Scotland League 1","Arbroath","Queen of Sth",2,1,"H",12,5,6,2,14,13,6,0,2,1,0,0,0,0,0,3,17,8,27,6,3,0
"20241214ALLMON",2024-12-14,"Scotland League 1","Alloa","Montrose",1,2,"A",8,5,4,3,13,12,5,1,4,1,0,0,0,0,0,3,13,7,25,6,5,0
"20241214COVKEL",2024-12-14,"Scotland League 1","Cove Rangers","Kelty Hearts",0,0,"D",7,8,3,1,14,6,4,5,2,1,0,0,0,0,0,0,15,4,20,9,3,0
"20241214DUMANN",2024-12-14,"Scotland League 1","Dumbarton","Annan Athletic",1,5,"A",15,15,5,9,11,8,7,5,1,2,0,0,0,0,0,6,30,14,19,12,3,0
"20241214INVARB",2024-12-14,"Scotland League 1","Inverness C","Arbroath",0,2,"A",8,7,0,4,10,14,6,5,1,1,1,0,0,0,0,2,15,4,24,11,2,1
"20241214QUESTE",2024-12-14,"Scotland League 1","Queen of Sth","Stenhousemuir",2,1,"H",12,8,3,5,8,18,2,5,2,5,0,0,0,0,0,3,20,8,26,7,7,0
"20241217KELARB",2024-12-17,"Scotland League 1","Kelty Hearts","Arbroath",3,2,"H",8,7,5,5,10,10,9,4,1,1,0,0,0,0,0,5,15,10,20,13,2,0
"20241221ANNARB",2024-12-21,"Scotland League 1","Annan Athletic","Arbroath",0,4,"A",3,11,1,6,8,7,6,6,1,1,0,0,0,0,0,4,14,7,15,12,2,0
"20241221COVALL",2024-12-21,"Scotland League 1","Cove Rangers","Alloa",2,0,"H",7,10,4,4,7,7,2,8,1,1,0,0,0,0,0,2,17,8,14,10,2,0
"20241221KELQUE",2024-12-21,"Scotland League 1","Kelty Hearts","Queen of Sth",2,0,"H",10,5,7,2,10,14,2,4,2,0,0,0,0,0,0,2,15,9,24,6,2,0
"20241221MONDUM",2024-12-21,"Scotland League 1","Montrose","Dumbarton",1,2,"A",7,7,5,2,12,5,4,3,4,1,1,0,0,0,0,3,14,7,17,7,5,1
"20241221STEINV",2024-12-21,"Scotland League 1","Stenhousemuir","Inverness C",0,1,"A",6,18,4,9,15,7,1,8,1,1,0,0,0,0,0,1,24,13,22,9,2,0
"20241228ALLSTE",2024-12-28,"Scotland League 1","Alloa","Stenhousemuir",1,3,"A",6,9,2,7,12,7,6,4,1,0,0,0,0,0,0,4,15,9,19,10,1,0
"20241228ARBMON",2024-12-28,"Scotland League 1","Arbroath","Montrose",3,0,"H",6,9,3,2,12,12,5,6,2,1,0,0,0,0,0,3,15,5,24,11,3,0
"20241228DUMKEL",2024-12-28,"Scotland League 1","Dumbarton","Kelty Hearts",2,0,"H",5,4,4,0,4,9,5,0,2,2,0,1,0,0,0,2,9,4,13,5,4,1
"20241228INVCOV",2024-12-28,"Scotland League 1","Inverness C","Cove Rangers",1,4,"A",10,12,5,9,11,9,6,6,1,1,0,0,0,0,0,5,22,14,20,12,2,0
"20241228QUEANN",2024-12-28,"Scotland League 1","Queen of Sth","Annan Athletic",1,1,"D",8,8,2,2,11,9,4,4,1,3,0,0,0,0,0,2,16,4,20,8,4,0
"20220102ELGFOR",2022-01-02,"Scotland League Two","Elgin","Forfar",1,0,"H",14,8,4,1,9,19,4,1,3,5,0,0,0,0,0,1,22,5,28,5,8,0
"20220102STESTI",2022-01-02,"Scotland League Two","Stenhousemuir","Stirling",1,2,"A",5,11,5,4,15,11,3,3,4,3,1,0,0,0,0,3,16,9,26,6,7,1
"20220102STRANN",2022-01-02,"Scotland League Two","Stranraer","Annan Athletic",1,1,"D",9,9,4,2,10,15,2,8,3,5,0,2,0,0,0,2,18,6,25,10,8,2
"20220107EDIELG",2022-01-07,"Scotland League Two","Edinburgh City","Elgin",2,2,"D",12,14,5,4,4,10,1,2,0,3,0,0,0,0,0,4,26,9,14,3,3,0
"20220108STIKEL",2022-01-08,"Scotland League Two","Stirling","Kelty Hearts",0,3,"A",6,11,3,7,10,14,2,4,2,0,0,0,0,0,0,3,17,10,24,6,2,0
"20220108ALBSTE",2022-01-08,"Scotland League Two","Albion Rvs","Stenhousemuir",1,2,"A",6,13,2,5,9,12,4,3,0,1,0,0,0,0,0,3,19,7,21,7,1,0
"20220108COWANN",2022-01-08,"Scotland League Two","Cowdenbeath","Annan Athletic",1,3,"A",13,14,3,6,13,10,7,2,4,3,1,0,0,0,0,4,27,9,23,9,7,1
"20220108FORSTR",2022-01-08,"Scotland League Two","Forfar","Stranraer",3,2,"H",11,13,4,4,12,8,9,8,2,2,0,0,0,0,0,5,24,8,20,17,4,0
"20220115ANNFOR",2022-01-15,"Scotland League Two","Annan Athletic","Forfar",2,2,"D",7,15,2,7,7,13,1,9,1,1,0,0,0,0,0,4,22,9,20,10,2,0
"20220115ELGALB",2022-01-15,"Scotland League Two","Elgin","Albion Rvs",1,1,"D",14,3,5,3,13,9,6,2,1,1,0,1,0,0,0,2,17,8,22,8,2,1
"20220115KELEDI",2022-01-15,"Scotland League Two","Kelty Hearts","Edinburgh City",2,2,"D",8,11,3,4,11,10,3,4,3,2,0,0,0,0,0,4,19,7,21,7,5,0
"20220115STECOW",2022-01-15,"Scotland League Two","Stenhousemuir","Cowdenbeath",0,2,"A",13,12,2,6,10,10,10,7,3,2,0,0,0,0,0,2,25,8,20,17,5,0
"20220115STRSTI",2022-01-15,"Scotland League Two","Stranraer","Stirling",3,3,"D",14,10,8,4,9,12,5,3,3,1,0,0,0,0,0,6,24,12,21,8,4,0
"20220122COWSTR",2022-01-22,"Scotland League Two","Cowdenbeath","Stranraer",0,1,"A",4,7,2,4,15,11,4,5,2,2,0,0,0,0,0,1,11,6,26,9,4,0
"20220125ELGKEL",2022-01-25,"Scotland League Two","Elgin","Kelty Hearts",2,0,"H",6,6,4,3,14,10,2,6,3,4,0,0,0,0,0,2,12,7,24,8,7,0
"20220129ALBCOW",2022-01-29,"Scotland League Two","Albion Rvs","Cowdenbeath",0,1,"A",5,5,4,3,11,18,8,1,5,2,0,1,0,0,0,1,10,7,29,9,7,1
"20220129KELSTR",2022-01-29,"Scotland League Two","Kelty Hearts","Stranraer",3,2,"H",4,10,4,4,12,10,3,9,1,1,0,0,0,0,0,5,14,8,22,12,2,0
"20220129STEELG",2022-01-29,"Scotland League Two","Stenhousemuir","Elgin",2,1,"H",13,9,8,5,9,15,4,6,0,2,1,0,0,0,0,3,22,13,24,10,2,1
"20220129ANNSTI",2022-01-29,"Scotland League Two","Annan Athletic","Stirling",0,0,"D",5,12,3,6,8,12,4,3,1,0,0,0,0,0,0,0,17,9,20,7,1,0
"20220131FOREDI",2022-01-31,"Scotland League Two","Forfar","Edinburgh City",2,3,"A",11,11,6,8,12,7,8,3,2,3,0,0,0,0,0,5,22,14,19,11,5,0
"20220205ANNSTE",2022-02-05,"Scotland League Two","Annan Athletic","Stenhousemuir",0,2,"A",11,6,4,2,14,13,10,5,3,2,0,0,0,0,0,2,17,6,27,15,5,0
"20220205FORALB",2022-02-05,"Scotland League Two","Forfar","Albion Rvs",2,0,"H",4,9,2,4,13,11,7,7,0,0,0,0,0,0,0,2,13,6,24,14,0,0
"20220205KELELG",2022-02-05,"Scotland League Two","Kelty Hearts","Elgin",4,0,"H",12,4,7,1,10,8,5,4,0,3,0,0,1,0,1,4,16,8,18,9,3,0
"20220205STREDI",2022-02-05,"Scotland League Two","Stranraer","Edinburgh City",0,2,"A",12,4,4,2,6,11,4,4,1,1,1,0,0,0,0,2,16,6,17,8,2,1
"20220211EDISTI",2022-02-11,"Scotland League Two","Edinburgh City","Stirling",1,0,"H",8,12,4,5,8,12,6,6,3,5,0,0,0,0,0,1,20,9,20,12,8,0
"20220212ELGSTR",2022-02-12,"Scotland League Two","Elgin","Stranraer",1,2,"A",12,9,8,4,9,10,2,5,3,2,0,0,0,0,0,3,21,12,19,7,5,0
"20220215EDIALB",2022-02-15,"Scotland League Two","Edinburgh City","Albion Rvs",1,2,"A",9,8,3,6,12,5,3,5,1,0,0,0,0,0,0,3,17,9,17,8,1,0
"20220215ELGANN",2022-02-15,"Scotland League Two","Elgin","Annan Athletic",0,2,"A",17,7,3,4,12,14,5,0,3,0,0,0,0,0,0,2,24,7,26,5,3,0
"20220215STIFOR",2022-02-15,"Scotland League Two","Stirling","Forfar",1,1,"D",14,8,6,2,6,10,5,4,2,2,0,0,0,0,0,2,22,8,16,9,4,0
"20220219ANNEDI",2022-02-19,"Scotland League Two","Annan Athletic","Edinburgh City",2,1,"H",14,10,6,4,10,10,3,8,0,2,0,0,0,0,0,3,24,10,20,11,2,0
"20220219COWELG",2022-02-19,"Scotland League Two","Cowdenbeath","Elgin",2,0,"H",7,9,5,4,18,12,3,5,2,2,0,0,0,0,0,2,16,9,30,8,4,0
"20220219FORKEL",2022-02-19,"Scotland League Two","Forfar","Kelty Hearts",1,0,"H",5,16,2,2,10,10,7,3,2,1,0,0,0,0,0,1,21,4,20,10,3,0
"20220219STRSTE",2022-02-19,"Scotland League Two","Stranraer","Stenhousemuir",1,1,"D",7,9,3,3,12,10,5,2,2,1,0,0,0,0,0,2,16,6,22,7,3,0
"20220222KELCOW",2022-02-22,"Scotland League Two","Kelty Hearts","Cowdenbeath",1,0,"H",12,1,4,0,6,7,15,0,1,4,0,0,0,0,0,1,13,4,13,15,5,0
"20220225EDICOW",2022-02-25,"Scotland League Two","Edinburgh City","Cowdenbeath",1,0,"H",6,9,1,5,9,10,1,2,3,3,0,0,0,0,0,1,15,6,19,3,6,0
"20220226ELGSTI",2022-02-26,"Scotland League Two","Elgin","Stirling",3,1,"H",19,4,8,2,11,9,4,3,2,2,0,1,0,0,0,4,23,10,20,7,4,1
"20220226KELANN",2022-02-26,"Scotland League Two","Kelty Hearts","Annan Athletic",3,1,"H",8,8,4,2,14,10,4,1,2,4,0,0,0,0,0,4,16,6,24,5,6,0
"20220226STEFOR",2022-02-26,"Scotland League Two","Stenhousemuir","Forfar",2,0,"H",9,6,4,1,11,10,6,8,1,4,0,0,0,0,0,2,15,5,21,14,5,0
"20220226STRALB",2022-02-26,"Scotland League Two","Stranraer","Albion Rvs",0,0,"D",3,7,1,3,9,15,2,0,0,2,0,0,0,0,0,0,10,4,24,2,2,0
"20220302ALBANN",2022-03-02,"Scotland League Two","Albion Rvs","Annan Athletic",1,4,"A",12,12,5,6,7,13,4,5,1,2,0,0,0,0,0,5,24,11,20,9,3,0
"20220302EDISTE",2022-03-02,"Scotland League Two","Edinburgh City","Stenhousemuir",1,1,"D",12,15,6,5,9,8,5,7,0,1,0,0,0,0,0,2,27,11,17,12,1,0
"20220305ALBEDI",2022-03-05,"Scotland League Two","Albion Rvs","Edinburgh City",0,1,"A",11,7,3,1,9,7,6,6,1,0,0,0,0,0,0,1,18,4,16,12,1,0
"20220305ANNSTR",2022-03-05,"Scotland League Two","Annan Athletic","Stranraer",4,1,"H",13,9,7,5,9,10,4,4,1,3,0,0,0,0,0,5,22,12,19,8,4,0
"20220305COWKEL",2022-03-05,"Scotland League Two","Cowdenbeath","Kelty Hearts",0,1,"A",10,6,2,2,11,16,5,4,3,5,0,0,0,0,0,1,16,4,27,9,8,0
"20220305FORELG",2022-03-05,"Scotland League Two","Forfar","Elgin",0,0,"D",7,8,3,2,15,9,6,4,3,0,0,0,0,0,0,0,15,5,24,10,3,0
"20220305STISTE",2022-03-05,"Scotland League Two","Stirling","Stenhousemuir",0,1,"A",4,10,1,7,12,7,6,4,0,0,1,0,0,0,0,1,14,8,19,10,0,1
"20220308STEKEL",2022-03-08,"Scotland League Two","Stenhousemuir","Kelty Hearts",0,1,"A",4,14,1,6,3,2,3,9,0,1,0,0,0,0,0,1,18,7,5,12,1,0
"20220308STICOW",2022-03-08,"Scotland League Two","Stirling","Cowdenbeath",2,1,"H",8,5,3,4,13,12,4,2,0,2,0,0,0,0,0,3,13,7,25,6,2,0
"20220312ANNELG",2022-03-12,"Scotland League Two","Annan Athletic","Elgin",2,1,"H",9,3,3,1,NA,NA,7,5,0,3,0,0,0,0,0,3,12,4,NA,12,3,0
"20220312FORSTI",2022-03-12,"Scotland League Two","Forfar","Stirling",0,1,"A",8,6,4,2,11,8,3,4,2,0,0,0,0,0,0,1,14,6,19,7,2,0
"20220312KELALB",2022-03-12,"Scotland League Two","Kelty Hearts","Albion Rvs",3,1,"H",9,12,5,7,8,7,2,5,2,1,0,0,0,0,0,4,21,12,15,7,3,0
"20220312STEEDI",2022-03-12,"Scotland League Two","Stenhousemuir","Edinburgh City",0,0,"D",24,5,6,2,5,4,4,2,1,1,0,1,0,0,0,0,29,8,9,6,2,1
"20220312STRCOW",2022-03-12,"Scotland League Two","Stranraer","Cowdenbeath",3,0,"H",9,4,6,0,6,8,14,2,0,2,0,0,0,0,0,3,13,6,14,16,2,0
"20220315COWFOR",2022-03-15,"Scotland League Two","Cowdenbeath","Forfar",1,2,"A",4,8,1,2,14,9,4,6,3,1,0,0,0,0,0,3,12,3,23,10,4,0
"20220316ALBKEL",2022-03-16,"Scotland League Two","Albion Rvs","Kelty Hearts",0,0,"D",13,9,3,4,11,9,3,5,0,1,0,1,0,0,0,0,22,7,20,8,1,1
"20220318EDISTR",2022-03-18,"Scotland League Two","Edinburgh City","Stranraer",1,2,"A",9,14,4,5,7,7,3,10,2,0,0,0,0,0,0,3,23,9,14,13,2,0
"20220319ALBFOR",2022-03-19,"Scotland League Two","Albion Rvs","Forfar",0,0,"D",13,8,3,3,9,12,8,7,2,1,0,0,0,0,0,0,21,6,21,15,3,0
"20220319COWSTE",2022-03-19,"Scotland League Two","Cowdenbeath","Stenhousemuir",1,1,"D",11,7,6,2,11,14,6,2,4,1,0,0,0,0,0,2,18,8,25,8,5,0
"20220319ELGKEL",2022-03-19,"Scotland League Two","Elgin","Kelty Hearts",0,0,"D",4,12,2,5,12,11,1,6,1,0,1,0,0,0,0,0,16,7,23,7,1,1
"20220319STIANN",2022-03-19,"Scotland League Two","Stirling","Annan Athletic",0,3,"A",7,10,1,6,8,9,7,5,0,0,0,0,0,0,0,3,17,7,17,12,0,0
"20220322STIALB",2022-03-22,"Scotland League Two","Stirling","Albion Rvs",0,1,"A",7,7,2,3,10,12,5,5,1,2,1,1,0,0,0,1,14,5,22,10,3,2
"20220326ANNALB",2022-03-26,"Scotland League Two","Annan Athletic","Albion Rvs",2,4,"A",10,11,4,8,11,10,4,4,0,0,0,0,0,0,0,6,21,12,21,8,0,0
"20220326ELGEDI",2022-03-26,"Scotland League Two","Elgin","Edinburgh City",2,0,"H",12,3,3,0,9,10,6,2,1,3,0,2,0,0,0,2,15,3,19,8,4,2
"20220326FORCOW",2022-03-26,"Scotland League Two","Forfar","Cowdenbeath",1,1,"D",9,7,1,1,14,9,7,4,1,2,0,0,0,0,0,2,16,2,23,11,3,0
"20220326KELSTE",2022-03-26,"Scotland League Two","Kelty Hearts","Stenhousemuir",1,0,"H",10,5,6,3,7,9,7,3,2,3,0,0,0,0,0,1,15,9,16,10,5,0
"20220326STISTR",2022-03-26,"Scotland League Two","Stirling","Stranraer",1,0,"H",8,11,3,1,9,8,2,5,3,0,0,0,0,0,0,1,19,4,17,7,3,0
"20220401EDIKEL",2022-04-01,"Scotland League Two","Edinburgh City","Kelty Hearts",1,1,"D",11,14,5,4,8,13,6,5,1,1,0,0,0,0,0,2,25,9,21,11,2,0
"20220402ALBELG",2022-04-02,"Scotland League Two","Albion Rvs","Elgin",0,0,"D",4,6,1,2,13,7,0,5,1,2,0,0,0,0,0,0,10,3,20,5,3,0
"20220402COWSTI",2022-04-02,"Scotland League Two","Cowdenbeath","Stirling",0,0,"D",3,6,1,2,8,12,4,5,1,2,0,0,0,0,0,0,9,3,20,9,3,0
"20220402STEANN",2022-04-02,"Scotland League Two","Stenhousemuir","Annan Athletic",0,1,"A",19,4,5,3,11,12,12,1,1,3,0,0,0,0,0,1,23,8,23,13,4,0
"20220402STRFOR",2022-04-02,"Scotland League Two","Stranraer","Forfar",0,2,"A",4,9,0,3,9,14,2,8,3,1,0,0,0,0,0,2,13,3,23,10,4,0
"20220409ALBSTR",2022-04-09,"Scotland League Two","Albion Rvs","Stranraer",0,5,"A",5,15,1,8,12,10,4,3,9,2,0,0,0,0,0,5,20,9,22,7,11,0
"20220409ANNCOW",2022-04-09,"Scotland League Two","Annan Athletic","Cowdenbeath",2,3,"A",12,10,7,5,14,12,5,5,2,3,0,0,0,0,0,5,22,12,26,10,5,0
"20220409EDIFOR",2022-04-09,"Scotland League Two","Edinburgh City","Forfar",2,0,"H",6,16,2,6,8,12,1,10,0,0,0,0,0,0,0,2,22,8,20,11,0,0
"20220409ELGSTE",2022-04-09,"Scotland League Two","Elgin","Stenhousemuir",0,2,"A",8,7,3,4,14,5,6,3,2,2,0,0,0,0,0,2,15,7,19,9,4,0
"20220409KELSTI",2022-04-09,"Scotland League Two","Kelty Hearts","Stirling",1,1,"D",5,7,2,3,10,8,3,6,3,1,0,0,0,0,0,2,12,5,18,9,4,0
"20220416COWEDI",2022-04-16,"Scotland League Two","Cowdenbeath","Edinburgh City",0,0,"D",10,8,0,2,15,9,5,4,3,2,0,0,0,0,0,0,18,2,24,9,5,0
"20220416FORANN",2022-04-16,"Scotland League Two","Forfar","Annan Athletic",5,1,"H",18,8,8,4,13,12,4,2,1,2,0,0,0,0,0,6,26,12,25,6,3,0
"20220416STEALB",2022-04-16,"Scotland League Two","Stenhousemuir","Albion Rvs",4,1,"H",15,6,5,4,14,8,7,1,1,3,0,1,0,0,0,5,21,9,22,8,4,1
"20220416STIELG",2022-04-16,"Scotland League Two","Stirling","Elgin",0,2,"A",9,5,4,3,13,18,2,3,1,2,0,0,0,0,0,2,14,7,31,5,3,0
"20220416STRKEL",2022-04-16,"Scotland League Two","Stranraer","Kelty Hearts",0,3,"A",12,10,1,6,4,14,3,4,1,2,0,0,0,0,0,3,22,7,18,7,3,0
"20220422EDIANN",2022-04-22,"Scotland League Two","Edinburgh City","Annan Athletic",2,1,"H",15,6,5,2,7,9,8,2,1,0,0,0,0,0,0,3,21,7,16,10,1,0
"20220423ALBSTI",2022-04-23,"Scotland League Two","Albion Rvs","Stirling",1,1,"D",6,10,3,4,6,9,5,3,1,3,0,0,0,0,0,2,16,7,15,8,4,0
"20220423ELGCOW",2022-04-23,"Scotland League Two","Elgin","Cowdenbeath",1,4,"A",11,10,4,5,12,6,6,6,1,0,0,0,0,0,0,5,21,9,18,12,1,0
"20220423KELFOR",2022-04-23,"Scotland League Two","Kelty Hearts","Forfar",1,1,"D",7,6,5,4,9,11,7,2,0,2,0,1,0,0,0,2,13,9,20,9,2,1
"20220423STESTR",2022-04-23,"Scotland League Two","Stenhousemuir","Stranraer",1,3,"A",11,9,4,5,15,11,2,4,4,4,1,0,0,0,0,4,20,9,26,6,8,1
"20220430ANNKEL",2022-04-30,"Scotland League Two","Annan Athletic","Kelty Hearts",1,2,"A",2,9,0,5,8,13,4,3,1,1,0,0,0,0,0,3,11,5,21,7,2,0
"20220430COWALB",2022-04-30,"Scotland League Two","Cowdenbeath","Albion Rvs",0,1,"A",2,7,0,4,11,5,7,3,3,1,0,0,0,0,0,1,9,4,16,10,4,0
"20220430FORSTE",2022-04-30,"Scotland League Two","Forfar","Stenhousemuir",0,0,"D",16,7,4,3,7,12,7,3,0,1,0,0,0,0,0,0,23,7,19,10,1,0
"20220430STIEDI",2022-04-30,"Scotland League Two","Stirling","Edinburgh City",5,0,"H",12,5,8,0,10,3,3,2,0,1,0,0,0,0,0,5,17,8,13,5,1,0
"20220430STRELG",2022-04-30,"Scotland League Two","Stranraer","Elgin",2,0,"H",16,9,9,3,5,20,5,5,1,3,0,0,0,0,0,2,25,12,25,10,4,0
"20220730BONFOR",2022-07-30,"Scotland League Two","Bonnyrigg Rose","Forfar",2,0,"H",12,4,6,0,8,10,7,6,2,0,0,0,0,0,0,2,16,6,18,13,2,0
"20220730DUMSTI",2022-07-30,"Scotland League Two","Dumbarton","Stirling",2,0,"H",8,8,4,3,13,8,3,3,6,3,0,1,0,0,0,2,16,7,21,6,9,1
"20220730ELGEAS",2022-07-30,"Scotland League Two","Elgin","East Fife",1,3,"A",14,7,4,3,11,12,3,3,1,0,0,0,0,0,0,4,21,7,23,6,1,0
"20220730STEALB",2022-07-30,"Scotland League Two","Stenhousemuir","Albion Rvs",1,0,"H",12,10,5,2,16,15,2,5,4,3,0,0,0,0,0,1,22,7,31,7,7,0
"20220730STRANN",2022-07-30,"Scotland League Two","Stranraer","Annan Athletic",1,0,"H",10,8,5,3,18,10,4,5,3,1,0,0,0,0,0,1,18,8,28,9,4,0
"20220806ALBDUM",2022-08-06,"Scotland League Two","Albion Rvs","Dumbarton",1,2,"A",8,13,4,7,9,16,2,2,2,4,1,0,0,0,0,3,21,11,25,4,6,1
"20220806ANNSTE",2022-08-06,"Scotland League Two","Annan Athletic","Stenhousemuir",2,1,"H",15,11,9,2,15,11,5,6,3,2,0,0,0,0,0,3,26,11,26,11,5,0
"20220806EASBON",2022-08-06,"Scotland League Two","East Fife","Bonnyrigg Rose",0,3,"A",5,6,2,4,15,10,0,2,0,2,0,1,0,0,0,3,11,6,25,2,2,1
"20220806FORSTR",2022-08-06,"Scotland League Two","Forfar","Stranraer",2,0,"H",11,8,7,4,18,4,9,5,1,1,0,0,0,0,0,2,19,11,22,14,2,0
"20220806STIELG",2022-08-06,"Scotland League Two","Stirling","Elgin",2,2,"D",10,8,6,3,14,12,4,4,1,1,0,1,0,0,0,4,18,9,26,8,2,1
"20220813ALBEAS",2022-08-13,"Scotland League Two","Albion Rvs","East Fife",0,1,"A",13,9,6,2,5,14,5,4,1,2,0,0,0,0,0,1,22,8,19,9,3,0
"20220813DUMANN",2022-08-13,"Scotland League Two","Dumbarton","Annan Athletic",4,0,"H",11,16,7,5,13,11,2,12,3,3,0,0,0,0,0,4,27,12,24,14,6,0
"20220813FORELG",2022-08-13,"Scotland League Two","Forfar","Elgin",2,2,"D",20,2,10,2,9,15,10,1,4,1,0,2,0,0,0,4,22,12,24,11,5,2
"20220813STISTE",2022-08-13,"Scotland League Two","Stirling","Stenhousemuir",3,0,"H",21,5,10,1,16,5,10,0,3,0,0,1,0,0,0,3,26,11,21,10,3,1
"20220813STRBON",2022-08-13,"Scotland League Two","Stranraer","Bonnyrigg Rose",2,2,"D",8,8,4,4,8,8,7,6,4,2,1,0,0,0,0,4,16,8,16,13,6,1
"20220820ANNSTI",2022-08-20,"Scotland League Two","Annan Athletic","Stirling",1,2,"A",4,18,2,10,10,18,0,8,3,1,0,0,0,0,0,3,22,12,28,8,4,0
"20220820BONALB",2022-08-20,"Scotland League Two","Bonnyrigg Rose","Albion Rvs",0,2,"A",5,12,4,4,13,9,1,4,1,1,0,0,0,0,0,2,17,8,22,5,2,0
"20220820EASFOR",2022-08-20,"Scotland League Two","East Fife","Forfar",1,0,"H",9,7,7,2,10,15,11,5,2,2,0,0,0,0,0,1,16,9,25,16,4,0
"20220820ELGSTR",2022-08-20,"Scotland League Two","Elgin","Stranraer",2,2,"D",15,11,6,6,10,20,6,12,1,4,0,0,0,0,0,4,26,12,30,18,5,0
"20220820STEDUM",2022-08-20,"Scotland League Two","Stenhousemuir","Dumbarton",1,3,"A",6,8,3,4,14,8,6,8,2,3,0,0,0,0,0,4,14,7,22,14,5,0
"20220827ALBANN",2022-08-27,"Scotland League Two","Albion Rvs","Annan Athletic",2,2,"D",8,10,2,4,10,12,6,3,2,2,0,0,0,0,0,4,18,6,22,9,4,0
"20220827BONSTI",2022-08-27,"Scotland League Two","Bonnyrigg Rose","Stirling",1,0,"H",10,10,4,4,12,12,4,8,2,2,0,0,0,0,0,1,20,8,24,12,4,0
"20220827DUMELG",2022-08-27,"Scotland League Two","Dumbarton","Elgin",2,1,"H",8,11,4,3,11,14,4,1,6,4,0,0,0,0,0,3,19,7,25,5,10,0
"20220827FORSTE",2022-08-27,"Scotland League Two","Forfar","Stenhousemuir",1,2,"A",17,10,6,6,11,10,5,5,2,2,0,0,0,0,0,3,27,12,21,10,4,0
"20220827STREAS",2022-08-27,"Scotland League Two","Stranraer","East Fife",2,2,"D",7,10,2,4,15,14,2,0,3,1,1,0,0,0,0,4,17,6,29,2,4,1
"20220903ANNFOR",2022-09-03,"Scotland League Two","Annan Athletic","Forfar",2,1,"H",4,16,2,4,11,18,0,5,1,3,0,0,0,0,0,3,20,6,29,5,4,0
"20220903EASDUM",2022-09-03,"Scotland League Two","East Fife","Dumbarton",0,1,"A",5,6,1,1,6,8,1,2,2,2,0,0,0,0,0,1,11,2,14,3,4,0
"20220903ELGBON",2022-09-03,"Scotland League Two","Elgin","Bonnyrigg Rose",2,0,"H",15,8,10,1,9,7,5,7,1,1,0,0,0,0,0,2,23,11,16,12,2,0
"20220903STESTR",2022-09-03,"Scotland League Two","Stenhousemuir","Stranraer",3,1,"H",13,11,5,2,11,15,5,5,2,2,0,1,0,0,0,4,24,7,26,10,4,1
"20220903STIALB",2022-09-03,"Scotland League Two","Stirling","Albion Rvs",1,1,"D",16,5,5,2,11,16,6,3,1,3,0,0,0,0,0,2,21,7,27,9,4,0
"20220917ALBFOR",2022-09-17,"Scotland League Two","Albion Rvs","Forfar",0,2,"A",4,15,2,9,8,9,3,10,2,3,0,0,0,0,0,2,19,11,17,13,5,0
"20220917ANNEAS",2022-09-17,"Scotland League Two","Annan Athletic","East Fife",2,2,"D",12,3,5,1,5,18,6,1,1,2,0,0,0,0,0,4,15,6,23,7,3,0
"20220917DUMBON",2022-09-17,"Scotland League Two","Dumbarton","Bonnyrigg Rose",1,0,"H",8,7,4,1,11,11,3,3,2,4,0,0,0,0,0,1,15,5,22,6,6,0
"20220917STEELG",2022-09-17,"Scotland League Two","Stenhousemuir","Elgin",3,3,"D",15,8,4,6,8,8,12,3,1,4,0,0,0,0,0,6,23,10,16,15,5,0
"20220917STISTR",2022-09-17,"Scotland League Two","Stirling","Stranraer",4,1,"H",19,6,9,3,12,8,9,5,1,0,0,0,0,0,0,5,25,12,20,14,1,0
"20220920EASSTE",2022-09-20,"Scotland League Two","East Fife","Stenhousemuir",1,2,"A",6,13,2,7,10,9,7,5,0,4,1,0,0,0,0,3,19,9,19,12,4,1
"20220920STRDUM",2022-09-20,"Scotland League Two","Stranraer","Dumbarton",3,2,"H",8,5,5,2,4,7,2,4,4,2,1,0,0,0,0,5,13,7,11,6,6,1
"20220924FORSTI",2022-09-24,"Scotland League Two","Forfar","Stirling",1,4,"A",13,16,6,8,14,14,3,2,2,1,0,0,0,0,0,5,29,14,28,5,3,0
"20221001BONSTE",2022-10-01,"Scotland League Two","Bonnyrigg Rose","Stenhousemuir",2,4,"A",12,11,6,7,9,17,8,4,2,2,0,0,0,0,0,6,23,13,26,12,4,0
"20221001EASSTI",2022-10-01,"Scotland League Two","East Fife","Stirling",1,2,"A",2,11,2,7,10,14,2,6,4,4,0,0,0,0,0,3,13,9,24,8,8,0
"20221001ELGANN",2022-10-01,"Scotland League Two","Elgin","Annan Athletic",5,1,"H",11,9,7,3,9,9,4,6,2,2,0,0,0,0,0,6,20,10,18,10,4,0
"20221001FORDUM",2022-10-01,"Scotland League Two","Forfar","Dumbarton",0,0,"D",12,16,4,5,12,6,4,5,3,2,0,0,0,0,0,0,28,9,18,9,5,0
"20221001STRALB",2022-10-01,"Scotland League Two","Stranraer","Albion Rvs",2,1,"H",15,9,5,1,20,13,6,5,4,0,0,0,0,0,0,3,24,6,33,11,4,0
"20221008ALBBON",2022-10-08,"Scotland League Two","Albion Rvs","Bonnyrigg Rose",2,1,"H",14,9,5,3,7,15,3,5,3,2,0,1,0,0,0,3,23,8,22,8,5,1
"20221008FOREAS",2022-10-08,"Scotland League Two","Forfar","East Fife",1,3,"A",15,14,4,8,10,8,3,9,2,2,0,0,0,0,0,4,29,12,18,12,4,0
"20221008STEANN",2022-10-08,"Scotland League Two","Stenhousemuir","Annan Athletic",2,2,"D",26,10,10,5,5,8,8,5,2,2,0,1,0,0,0,4,36,15,13,13,4,1
"20221008STIDUM",2022-10-08,"Scotland League Two","Stirling","Dumbarton",6,0,"H",13,3,9,0,9,6,10,1,0,1,0,0,0,0,0,6,16,9,15,11,1,0
"20221008STRELG",2022-10-08,"Scotland League Two","Stranraer","Elgin",2,3,"A",13,8,4,4,13,12,12,2,1,3,1,0,0,0,0,5,21,8,25,14,4,1
"20221011BONANN",2022-10-11,"Scotland League Two","Bonnyrigg Rose","Annan Athletic",2,0,"H",11,6,5,1,15,9,4,1,2,1,0,0,0,0,0,2,17,6,24,5,3,0
"20221011ELGALB",2022-10-11,"Scotland League Two","Elgin","Albion Rvs",1,0,"H",7,12,5,5,19,11,6,5,4,2,0,0,0,0,0,1,19,10,30,11,6,0
"20221015ANNSTR",2022-10-15,"Scotland League Two","Annan Athletic","Stranraer",1,1,"D",9,10,4,4,9,13,2,3,3,3,0,0,0,0,0,2,19,8,22,5,6,0
"20221015BONEAS",2022-10-15,"Scotland League Two","Bonnyrigg Rose","East Fife",1,4,"A",7,10,2,8,6,12,4,5,2,3,0,0,0,0,0,5,17,10,18,9,5,0
"20221015DUMALB",2022-10-15,"Scotland League Two","Dumbarton","Albion Rvs",1,1,"D",7,12,3,5,12,12,6,5,2,4,1,0,0,0,0,2,19,8,24,11,6,1
"20221015ELGFOR",2022-10-15,"Scotland League Two","Elgin","Forfar",0,1,"A",7,7,3,4,14,14,3,3,3,4,0,1,0,0,0,1,14,7,28,6,7,1
"20221015STESTI",2022-10-15,"Scotland League Two","Stenhousemuir","Stirling",1,3,"A",10,7,5,4,14,9,10,3,3,2,0,0,0,0,0,4,17,9,23,13,5,0
"20221029ALBSTE",2022-10-29,"Scotland League Two","Albion Rvs","Stenhousemuir",2,2,"D",11,8,6,4,4,14,5,8,1,1,1,0,0,0,0,4,19,10,18,13,2,1
"20221029ANNDUM",2022-10-29,"Scotland League Two","Annan Athletic","Dumbarton",0,1,"A",5,4,1,2,12,6,5,2,2,2,0,0,0,0,0,1,9,3,18,7,4,0
"20221029EASELG",2022-10-29,"Scotland League Two","East Fife","Elgin",2,1,"H",5,5,2,3,13,15,2,3,2,5,0,1,0,0,0,3,10,5,28,5,7,1
"20221029STIBON",2022-10-29,"Scotland League Two","Stirling","Bonnyrigg Rose",2,1,"H",11,1,4,1,17,11,6,0,5,4,0,1,0,0,0,3,12,5,28,6,9,1
"20221029STRFOR",2022-10-29,"Scotland League Two","Stranraer","Forfar",1,0,"H",12,12,6,4,12,19,2,6,1,3,0,0,0,0,0,1,24,10,31,8,4,0
"20221105ALBSTI",2022-11-05,"Scotland League Two","Albion Rvs","Stirling",1,1,"D",3,6,1,3,13,11,3,6,2,1,0,1,0,0,0,2,9,4,24,9,3,1
"20221105BONELG",2022-11-05,"Scotland League Two","Bonnyrigg Rose","Elgin",2,3,"A",10,5,6,3,15,6,10,2,3,1,0,0,0,0,0,5,15,9,21,12,4,0
"20221105DUMSTR",2022-11-05,"Scotland League Two","Dumbarton","Stranraer",2,0,"H",11,19,4,6,9,5,9,6,1,0,0,0,0,0,0,2,30,10,14,15,1,0
"20221105FORANN",2022-11-05,"Scotland League Two","Forfar","Annan Athletic",1,4,"A",6,22,4,12,8,10,2,7,2,0,0,0,0,0,0,5,28,16,18,9,2,0
"20221105STEEAS",2022-11-05,"Scotland League Two","Stenhousemuir","East Fife",2,2,"D",10,14,6,8,15,13,5,10,2,3,1,0,0,0,0,4,24,14,28,15,5,1
"20221112EASALB",2022-11-12,"Scotland League Two","East Fife","Albion Rvs",2,3,"A",8,7,5,3,15,15,3,2,4,2,1,0,0,0,0,5,15,8,30,5,6,1
"20221112ELGDUM",2022-11-12,"Scotland League Two","Elgin","Dumbarton",0,4,"A",4,7,2,5,11,8,3,3,3,2,0,0,0,0,0,4,11,7,19,6,5,0
"20221112FORBON",2022-11-12,"Scotland League Two","Forfar","Bonnyrigg Rose",1,1,"D",12,9,4,3,7,5,8,9,2,2,0,0,0,0,0,2,21,7,12,17,4,0
"20221112STIANN",2022-11-12,"Scotland League Two","Stirling","Annan Athletic",0,2,"A",10,13,0,5,5,9,6,9,0,2,1,0,0,0,0,2,23,5,14,15,2,1
"20221112STRSTE",2022-11-12,"Scotland League Two","Stranraer","Stenhousemuir",3,2,"H",11,9,5,4,10,12,2,3,0,1,1,0,0,0,0,5,20,9,22,5,1,1
"20221119ALBSTR",2022-11-19,"Scotland League Two","Albion Rvs","Stranraer",1,0,"H",14,10,4,3,5,14,7,6,2,2,0,0,0,0,0,1,24,7,19,13,4,0
"20221119ANNELG",2022-11-19,"Scotland League Two","Annan Athletic","Elgin",1,3,"A",9,8,2,5,5,7,7,6,2,2,0,0,0,0,0,4,17,7,12,13,4,0
"20221119DUMFOR",2022-11-19,"Scotland League Two","Dumbarton","Forfar",2,2,"D",6,3,3,2,4,8,6,2,1,3,0,1,0,0,0,4,9,5,12,8,4,1
"20221119STEBON",2022-11-19,"Scotland League Two","Stenhousemuir","Bonnyrigg Rose",1,1,"D",16,16,6,5,12,17,5,3,3,4,0,0,0,0,0,2,32,11,29,8,7,0
"20221119STIEAS",2022-11-19,"Scotland League Two","Stirling","East Fife",3,1,"H",8,12,6,5,10,9,5,4,2,1,0,0,0,0,0,4,20,11,19,9,3,0
"20221126STRANN",2022-11-26,"Scotland League Two","Stranraer","Annan Athletic",1,1,"D",2,2,1,2,0,4,7,6,1,2,0,0,0,0,0,2,4,3,4,13,3,0
"20221203BONDUM",2022-12-03,"Scotland League Two","Bonnyrigg Rose","Dumbarton",1,1,"D",9,3,5,2,7,8,7,4,2,4,0,0,0,0,0,2,12,7,15,11,6,0
"20221203EASANN",2022-12-03,"Scotland League Two","East Fife","Annan Athletic",1,3,"A",7,5,3,4,4,3,6,8,1,2,0,0,0,0,0,4,12,7,7,14,3,0
"20221203ELGSTE",2022-12-03,"Scotland League Two","Elgin","Stenhousemuir",2,1,"H",9,10,4,3,7,9,1,5,1,1,0,0,0,0,0,3,19,7,16,6,2,0
"20221203FORALB",2022-12-03,"Scotland League Two","Forfar","Albion Rvs",1,0,"H",15,6,5,3,11,9,10,6,3,3,0,0,0,0,0,1,21,8,20,16,6,0
"20221203STRSTI",2022-12-03,"Scotland League Two","Stranraer","Stirling",3,1,"H",17,12,5,5,12,13,3,4,0,3,0,0,0,0,0,4,29,10,25,7,3,0
"20221210EASBON",2022-12-10,"Scotland League Two","East Fife","Bonnyrigg Rose",0,0,"D",6,7,3,3,11,14,6,2,1,2,0,1,0,0,0,0,13,6,25,8,3,1
"20221210STEFOR",2022-12-10,"Scotland League Two","Stenhousemuir","Forfar",1,2,"A",10,11,6,3,13,15,4,3,1,2,0,0,0,0,0,3,21,9,28,7,3,0
"20221223ANNALB",2022-12-23,"Scotland League Two","Annan Athletic","Albion Rvs",5,1,"H",11,9,7,5,12,8,5,5,0,0,0,0,0,0,0,6,20,12,20,10,0,0
"20221223BONSTR",2022-12-23,"Scotland League Two","Bonnyrigg Rose","Stranraer",3,2,"H",9,6,6,6,13,12,3,3,1,2,0,0,0,0,0,5,15,12,25,6,3,0
"20221223ELGSTI",2022-12-23,"Scotland League Two","Elgin","Stirling",1,2,"A",4,12,3,4,11,15,2,10,1,3,1,0,0,0,0,3,16,7,26,12,4,1
"20221224DUMEAS",2022-12-24,"Scotland League Two","Dumbarton","East Fife",2,0,"H",9,4,3,2,11,5,7,2,0,2,0,0,0,0,0,2,13,5,16,9,2,0
"20221231ALBDUM",2022-12-31,"Scotland League Two","Albion Rvs","Dumbarton",0,1,"A",12,3,2,3,17,17,12,4,4,5,0,0,0,0,0,1,15,5,34,16,9,0
"20221231STISTE",2022-12-31,"Scotland League Two","Stirling","Stenhousemuir",3,1,"H",8,9,5,3,8,13,8,4,0,3,0,0,0,0,0,4,17,8,21,12,3,0
"20230102FORELG",2023-01-02,"Scotland League Two","Forfar","Elgin",0,1,"A",9,11,1,4,10,9,5,9,2,0,1,0,0,0,0,1,20,5,19,14,2,1
"20230107ANNFOR",2023-01-07,"Scotland League Two","Annan Athletic","Forfar",0,2,"A",13,6,3,2,16,21,5,4,1,4,0,0,0,0,0,2,19,5,37,9,5,0
"20230107BONALB",2023-01-07,"Scotland League Two","Bonnyrigg Rose","Albion Rvs",0,4,"A",5,11,3,6,18,11,5,6,3,1,0,0,0,0,0,4,16,9,29,11,4,0
"20230107ELGEAS",2023-01-07,"Scotland League Two","Elgin","East Fife",1,2,"A",10,13,3,6,10,17,5,8,1,5,0,0,0,0,0,3,23,9,27,13,6,0
"20230107STESTR",2023-01-07,"Scotland League Two","Stenhousemuir","Stranraer",2,1,"H",6,11,4,3,10,7,5,6,2,2,0,0,0,0,0,3,17,7,17,11,4,0
"20230114EASSTE",2023-01-14,"Scotland League Two","East Fife","Stenhousemuir",1,1,"D",7,7,2,4,14,7,6,8,4,0,0,0,0,0,0,2,14,6,21,14,4,0
"20230114ELGANN",2023-01-14,"Scotland League Two","Elgin","Annan Athletic",1,1,"D",10,13,4,4,8,11,2,6,0,0,0,0,0,0,0,2,23,8,19,8,0,0
"20230114FORDUM",2023-01-14,"Scotland League Two","Forfar","Dumbarton",2,1,"H",12,6,5,2,12,15,8,4,2,4,0,1,0,0,0,3,18,7,27,12,6,1
"20230114STRALB",2023-01-14,"Scotland League Two","Stranraer","Albion Rvs",0,4,"A",5,21,0,11,13,7,3,11,3,0,0,0,0,0,0,4,26,11,20,14,3,0
"20230121ANNBON",2023-01-21,"Scotland League Two","Annan Athletic","Bonnyrigg Rose",4,0,"H",10,1,7,1,6,8,1,3,1,4,0,0,0,0,0,4,11,8,14,4,5,0
"20230121EASSTR",2023-01-21,"Scotland League Two","East Fife","Stranraer",1,3,"A",10,10,3,9,7,11,5,3,3,4,0,0,0,0,0,4,20,12,18,8,7,0
"20230128ALBFOR",2023-01-28,"Scotland League Two","Albion Rvs","Forfar",0,1,"A",7,7,2,3,8,19,4,4,1,3,0,0,0,0,0,1,14,5,27,8,4,0
"20230128ANNEAS",2023-01-28,"Scotland League Two","Annan Athletic","East Fife",3,0,"H",10,4,6,2,10,17,4,6,2,0,0,1,0,0,0,3,14,8,27,10,2,1
"20230128DUMBON",2023-01-28,"Scotland League Two","Dumbarton","Bonnyrigg Rose",1,0,"H",7,7,2,2,5,9,5,9,0,2,0,0,0,0,0,1,14,4,14,14,2,0
"20230128STEELG",2023-01-28,"Scotland League Two","Stenhousemuir","Elgin",2,0,"H",10,13,4,1,9,14,4,2,2,4,0,0,0,0,0,2,23,5,23,6,6,0
"20230128STISTR",2023-01-28,"Scotland League Two","Stirling","Stranraer",1,0,"H",16,8,7,2,8,13,6,5,1,1,0,0,0,0,0,1,24,9,21,11,2,0
"20230204BONANN",2023-02-04,"Scotland League Two","Bonnyrigg Rose","Annan Athletic",1,2,"A",5,6,4,4,15,6,9,7,2,1,0,0,0,0,0,3,11,8,21,16,3,0
"20230204EASSTI",2023-02-04,"Scotland League Two","East Fife","Stirling",1,1,"D",8,5,2,3,11,17,10,3,1,4,0,1,0,0,0,2,13,5,28,13,5,1
"20230204ELGALB",2023-02-04,"Scotland League Two","Elgin","Albion Rvs",1,1,"D",6,5,3,3,13,16,5,3,2,4,0,0,0,0,0,2,11,6,29,8,6,0
"20230204FORSTR",2023-02-04,"Scotland League Two","Forfar","Stranraer",2,1,"H",5,8,3,3,12,11,2,4,1,1,0,0,0,0,0,3,13,6,23,6,2,0
"20230204STEDUM",2023-02-04,"Scotland League Two","Stenhousemuir","Dumbarton",1,1,"D",7,10,1,3,9,7,11,2,2,2,0,0,0,0,0,2,17,4,16,13,4,0
"20230211ALBEAS",2023-02-11,"Scotland League Two","Albion Rvs","East Fife",0,1,"A",5,9,1,5,10,8,4,6,2,2,0,0,0,0,0,1,14,6,18,10,4,0
"20230211DUMANN",2023-02-11,"Scotland League Two","Dumbarton","Annan Athletic",2,1,"H",7,13,3,3,9,9,3,8,2,2,0,0,0,0,0,3,20,6,18,11,4,0
"20230211FORSTE",2023-02-11,"Scotland League Two","Forfar","Stenhousemuir",1,1,"D",11,12,5,5,7,10,6,9,0,1,0,0,0,0,0,2,23,10,17,15,1,0
"20230211STRBON",2023-02-11,"Scotland League Two","Stranraer","Bonnyrigg Rose",0,1,"A",10,13,3,3,9,13,4,8,1,1,1,0,0,0,0,1,23,6,22,12,2,1
"20230214BONSTI",2023-02-14,"Scotland League Two","Bonnyrigg Rose","Stirling",1,2,"A",10,8,3,4,14,13,5,4,3,2,0,0,0,0,0,3,18,7,27,9,5,0
"20230218ANNSTI",2023-02-18,"Scotland League Two","Annan Athletic","Stirling",2,2,"D",13,5,5,4,13,6,10,2,3,3,0,1,0,0,0,4,18,9,19,12,6,1
"20230218EASDUM",2023-02-18,"Scotland League Two","East Fife","Dumbarton",2,0,"H",3,9,3,2,12,10,2,10,2,0,0,0,0,0,0,2,12,5,22,12,2,0
"20230218ELGSTR",2023-02-18,"Scotland League Two","Elgin","Stranraer",0,1,"A",9,7,2,1,7,11,4,3,3,3,0,0,0,0,0,1,16,3,18,7,6,0
"20230218STEALB",2023-02-18,"Scotland League Two","Stenhousemuir","Albion Rvs",2,0,"H",10,13,8,3,14,5,6,8,2,1,0,0,0,0,0,2,23,11,19,14,3,0
"20230221ALBELG",2023-02-21,"Scotland League Two","Albion Rvs","Elgin",3,0,"H",10,5,4,2,10,10,3,1,2,2,0,0,0,0,0,3,15,6,20,4,4,0
"20230225ALBANN",2023-02-25,"Scotland League Two","Albion Rvs","Annan Athletic",0,2,"A",7,6,2,3,12,7,4,0,2,0,0,0,0,0,0,2,13,5,19,4,2,0
"20230225BONSTE",2023-02-25,"Scotland League Two","Bonnyrigg Rose","Stenhousemuir",0,1,"A",8,7,5,4,11,7,5,6,1,1,1,0,0,0,0,1,15,9,18,11,2,1
"20230225DUMELG",2023-02-25,"Scotland League Two","Dumbarton","Elgin",1,2,"A",7,14,4,7,15,15,2,3,3,3,0,0,0,0,0,3,21,11,30,5,6,0
"20230225FORSTI",2023-02-25,"Scotland League Two","Forfar","Stirling",0,0,"D",6,14,3,5,9,8,2,10,1,1,0,0,0,0,0,0,20,8,17,12,2,0
"20230225STREAS",2023-02-25,"Scotland League Two","Stranraer","East Fife",2,0,"H",6,5,2,3,8,12,3,6,1,2,0,0,0,0,0,2,11,5,20,9,3,0
"20230228BONFOR",2023-02-28,"Scotland League Two","Bonnyrigg Rose","Forfar",1,1,"D",6,7,2,2,15,20,5,3,2,5,0,0,0,0,0,2,13,4,35,8,7,0
"20230228DUMSTE",2023-02-28,"Scotland League Two","Dumbarton","Stenhousemuir",1,0,"H",11,12,6,6,11,9,6,6,0,2,0,0,0,0,0,1,23,12,20,12,2,0
"20230304ANNSTE",2023-03-04,"Scotland League Two","Annan Athletic","Stenhousemuir",2,3,"A",9,11,2,3,5,15,11,13,1,3,0,0,0,0,0,5,20,5,20,24,4,0
"20230304EASFOR",2023-03-04,"Scotland League Two","East Fife","Forfar",3,2,"H",8,7,5,3,11,5,6,5,5,1,0,0,0,0,0,5,15,8,16,11,6,0
"20230304ELGBON",2023-03-04,"Scotland League Two","Elgin","Bonnyrigg Rose",0,1,"A",9,4,3,1,8,12,5,2,1,0,0,0,0,0,0,1,13,4,20,7,1,0
"20230304STIALB",2023-03-04,"Scotland League Two","Stirling","Albion Rvs",3,2,"H",9,7,3,3,9,6,8,7,4,2,0,1,0,0,0,5,16,6,15,15,6,1
"20230304STRDUM",2023-03-04,"Scotland League Two","Stranraer","Dumbarton",0,2,"A",8,9,1,4,14,11,3,4,3,2,0,0,0,0,0,2,17,5,25,7,5,0
"20230311ANNELG",2023-03-11,"Scotland League Two","Annan Athletic","Elgin",4,1,"H",13,7,9,2,15,10,6,0,2,4,0,1,0,0,0,5,20,11,25,6,6,1
"20230311STEEAS",2023-03-11,"Scotland League Two","Stenhousemuir","East Fife",1,2,"A",5,6,1,5,6,14,5,4,0,2,0,0,0,0,0,3,11,6,20,9,2,0
"20230311STIBON",2023-03-11,"Scotland League Two","Stirling","Bonnyrigg Rose",2,1,"H",10,4,5,2,11,14,2,2,4,2,0,0,0,0,0,3,14,7,25,4,6,0
"20230318BONEAS",2023-03-18,"Scotland League Two","Bonnyrigg Rose","East Fife",1,1,"D",12,7,5,2,6,12,13,8,1,3,0,0,0,0,0,2,19,7,18,21,4,0
"20230318DUMALB",2023-03-18,"Scotland League Two","Dumbarton","Albion Rvs",1,5,"A",6,13,1,9,12,9,7,3,4,1,0,0,0,0,0,6,19,10,21,10,5,0
"20230318FORANN",2023-03-18,"Scotland League Two","Forfar","Annan Athletic",2,1,"H",2,8,2,2,12,17,8,5,2,4,0,0,0,0,0,3,10,4,29,13,6,0
"20230318STRSTI",2023-03-18,"Scotland League Two","Stranraer","Stirling",1,1,"D",7,4,5,2,5,9,9,5,2,0,0,0,0,0,0,2,11,7,14,14,2,0
"20230321ALBSTR",2023-03-21,"Scotland League Two","Albion Rvs","Stranraer",0,1,"A",15,5,5,2,4,10,3,5,0,2,0,1,0,0,0,1,20,7,14,8,2,1
"20230321STIFOR",2023-03-21,"Scotland League Two","Stirling","Forfar",2,0,"H",9,6,5,0,8,9,6,2,3,1,0,0,0,0,0,2,15,5,17,8,4,0
"20230324EASELG",2023-03-24,"Scotland League Two","East Fife","Elgin",2,0,"H",15,4,6,1,15,17,3,4,1,3,0,0,0,0,0,2,19,7,32,7,4,0
"20230325ALBBON",2023-03-25,"Scotland League Two","Albion Rvs","Bonnyrigg Rose",0,1,"A",12,9,4,3,13,14,1,7,2,2,0,0,0,0,0,1,21,7,27,8,4,0
"20230325ANNSTR",2023-03-25,"Scotland League Two","Annan Athletic","Stranraer",0,0,"D",10,8,1,2,13,5,6,7,2,1,0,0,0,0,0,0,18,3,18,13,3,0
"20230325STEFOR",2023-03-25,"Scotland League Two","Stenhousemuir","Forfar",1,1,"D",10,9,6,3,13,6,5,9,2,2,0,0,0,0,0,2,19,9,19,14,4,0
"20230325STIDUM",2023-03-25,"Scotland League Two","Stirling","Dumbarton",2,2,"D",15,6,9,3,12,10,5,2,5,4,0,0,0,0,0,4,21,12,22,7,9,0
"20230329DUMFOR",2023-03-29,"Scotland League Two","Dumbarton","Forfar",0,1,"A",11,10,3,2,15,5,8,5,1,0,0,0,0,0,0,1,21,5,20,13,1,0
"20230401BONSTR",2023-04-01,"Scotland League Two","Bonnyrigg Rose","Stranraer",1,0,"H",9,7,3,5,13,14,8,3,4,2,0,0,0,0,0,1,16,8,27,11,6,0
"20230401DUMSTE",2023-04-01,"Scotland League Two","Dumbarton","Stenhousemuir",1,2,"A",9,14,4,3,10,8,2,7,4,1,0,0,0,0,0,3,23,7,18,9,5,0
"20230401EASANN",2023-04-01,"Scotland League Two","East Fife","Annan Athletic",0,1,"A",3,8,0,4,11,12,1,5,5,5,0,0,0,0,0,1,11,4,23,6,10,0
"20230401ELGSTI",2023-04-01,"Scotland League Two","Elgin","Stirling",0,3,"A",8,8,1,7,7,7,3,7,3,3,0,0,0,0,0,3,16,8,14,10,6,0
"20230401FORALB",2023-04-01,"Scotland League Two","Forfar","Albion Rvs",2,1,"H",10,7,5,4,14,8,12,2,2,0,0,0,0,0,0,3,17,9,22,14,2,0
"20230404STIELG",2023-04-04,"Scotland League Two","Stirling","Elgin",1,0,"H",12,11,4,3,7,10,2,5,1,1,0,0,0,0,0,1,23,7,17,7,2,0
"20230408ALBELG",2023-04-08,"Scotland League Two","Albion Rvs","Elgin",3,0,"H",11,3,7,3,6,4,6,1,1,3,0,0,0,0,0,3,14,10,10,7,4,0
"20230408ANNDUM",2023-04-08,"Scotland League Two","Annan Athletic","Dumbarton",3,1,"H",18,6,13,2,10,14,6,1,0,6,0,0,0,0,0,4,24,15,24,7,6,0
"20230408STEBON",2023-04-08,"Scotland League Two","Stenhousemuir","Bonnyrigg Rose",0,0,"D",4,5,2,1,12,9,5,5,1,1,0,0,0,0,0,0,9,3,21,10,2,0
"20230408STIEAS",2023-04-08,"Scotland League Two","Stirling","East Fife",2,2,"D",11,8,4,4,11,10,6,3,3,1,0,1,0,0,0,4,19,8,21,9,4,1
"20230408STRFOR",2023-04-08,"Scotland League Two","Stranraer","Forfar",0,0,"D",12,5,3,0,12,11,2,3,1,0,0,0,0,0,0,0,17,3,23,5,1,0
"20230411ELGSTE",2023-04-11,"Scotland League Two","Elgin","Stenhousemuir",1,1,"D",10,4,2,2,6,12,4,8,0,2,0,0,0,0,0,2,14,4,18,12,2,0
"20230415ANNALB",2023-04-15,"Scotland League Two","Annan Athletic","Albion Rvs",4,0,"H",10,4,7,1,6,6,10,4,1,1,0,1,0,0,0,4,14,8,12,14,2,1
"20230415BONDUM",2023-04-15,"Scotland League Two","Bonnyrigg Rose","Dumbarton",0,2,"A",5,9,2,3,14,14,1,2,4,3,1,0,0,0,0,2,14,5,28,3,7,1
"20230415EASSTR",2023-04-15,"Scotland League Two","East Fife","Stranraer",8,0,"H",18,2,9,0,8,12,4,4,1,2,0,1,0,0,0,8,20,9,20,8,3,1
"20230415ELGFOR",2023-04-15,"Scotland League Two","Elgin","Forfar",2,0,"H",8,7,6,1,10,13,2,3,0,1,0,0,0,0,0,2,15,7,23,5,1,0
"20230415STESTI",2023-04-15,"Scotland League Two","Stenhousemuir","Stirling",0,1,"A",9,14,1,6,11,14,3,3,1,1,0,0,0,0,0,1,23,7,25,6,2,0
"20230418DUMSTI",2023-04-18,"Scotland League Two","Dumbarton","Stirling",0,0,"D",11,11,3,1,18,7,5,7,2,2,0,0,0,0,0,0,22,4,25,12,4,0
"20230422ALBSTE",2023-04-22,"Scotland League Two","Albion Rvs","Stenhousemuir",3,1,"H",13,9,7,3,12,5,9,3,1,1,0,0,0,0,0,4,22,10,17,12,2,0
"20230422DUMEAS",2023-04-22,"Scotland League Two","Dumbarton","East Fife",1,0,"H",6,3,3,2,8,13,4,5,1,1,0,0,0,0,0,1,9,5,21,9,2,0
"20230422FORBON",2023-04-22,"Scotland League Two","Forfar","Bonnyrigg Rose",0,1,"A",7,2,5,2,13,13,3,7,0,2,0,0,0,0,0,1,9,7,26,10,2,0
"20230422STIANN",2023-04-22,"Scotland League Two","Stirling","Annan Athletic",3,1,"H",8,7,4,3,11,4,4,4,1,2,0,1,0,0,0,4,15,7,15,8,3,1
"20230422STRELG",2023-04-22,"Scotland League Two","Stranraer","Elgin",3,1,"H",12,5,7,2,14,8,4,2,0,0,0,0,0,0,0,4,17,9,22,6,0,0
"20230429ANNBON",2023-04-29,"Scotland League Two","Annan Athletic","Bonnyrigg Rose",0,0,"D",8,6,3,2,11,12,2,4,2,5,0,0,0,0,0,0,14,5,23,6,7,0
"20230429EASALB",2023-04-29,"Scotland League Two","East Fife","Albion Rvs",2,1,"H",6,9,4,2,10,8,4,8,4,2,0,0,0,0,0,3,15,6,18,12,6,0
"20230429ELGDUM",2023-04-29,"Scotland League Two","Elgin","Dumbarton",1,0,"H",7,4,6,3,11,13,1,3,0,2,0,0,0,0,0,1,11,9,24,4,2,0
"20230429STIFOR",2023-04-29,"Scotland League Two","Stirling","Forfar",2,1,"H",7,16,6,6,5,10,2,10,1,1,0,0,0,0,0,3,23,12,15,12,2,0
"20230429STRSTE",2023-04-29,"Scotland League Two","Stranraer","Stenhousemuir",2,0,"H",6,6,3,2,7,13,3,3,4,3,0,0,0,0,0,2,12,5,20,6,7,0
"20230506ALBSTI",2023-05-06,"Scotland League Two","Albion Rvs","Stirling",2,0,"H",11,4,5,1,9,9,3,2,0,1,0,0,0,0,0,2,15,6,18,5,1,0
"20230506BONELG",2023-05-06,"Scotland League Two","Bonnyrigg Rose","Elgin",3,0,"H",14,4,8,2,10,2,7,5,1,1,0,0,0,0,0,3,18,10,12,12,2,0
"20230506DUMSTR",2023-05-06,"Scotland League Two","Dumbarton","Stranraer",1,1,"D",8,5,6,1,7,8,5,10,2,1,0,0,0,0,0,2,13,7,15,15,3,0
"20230506FOREAS",2023-05-06,"Scotland League Two","Forfar","East Fife",1,0,"H",8,16,3,5,5,6,5,11,0,1,1,0,0,0,0,1,24,8,11,16,1,1
"20230506STEANN",2023-05-06,"Scotland League Two","Stenhousemuir","Annan Athletic",2,1,"H",11,13,5,7,8,7,5,5,7,2,0,0,0,0,0,3,24,12,15,10,9,0
"20230805BONDUM",2023-08-05,"Scotland League Two","Bonnyrigg Rose","Dumbarton",1,1,"D",9,13,4,6,13,12,10,4,3,2,0,0,0,0,0,2,22,10,25,14,5,0
"20230805EASPET",2023-08-05,"Scotland League Two","East Fife","Peterhead",0,3,"A",5,10,3,6,10,12,4,4,2,3,0,0,0,0,0,3,15,9,22,8,5,0
"20230805ELGSTR",2023-08-05,"Scotland League Two","Elgin","Stranraer",0,1,"A",10,6,3,2,12,18,5,6,0,1,0,0,0,0,0,1,16,5,30,11,1,0
"20230805SPACLY",2023-08-05,"Scotland League Two","Spartans","Clyde",1,1,"D",6,7,2,3,3,7,6,2,1,1,0,0,0,0,0,2,13,5,10,8,2,0
"20230805STEFOR",2023-08-05,"Scotland League Two","Stenhousemuir","Forfar",0,0,"D",12,9,3,5,12,10,6,7,2,2,0,0,0,0,0,0,21,8,22,13,4,0
"20230812CLYBON",2023-08-12,"Scotland League Two","Clyde","Bonnyrigg Rose",0,2,"A",6,9,1,5,6,10,4,5,0,2,0,0,0,0,0,2,15,6,16,9,2,0
"20230812DUMSPA",2023-08-12,"Scotland League Two","Dumbarton","Spartans",1,1,"D",3,2,2,1,7,5,4,7,1,3,0,0,0,0,0,2,5,3,12,11,4,0
"20230812FORELG",2023-08-12,"Scotland League Two","Forfar","Elgin",0,0,"D",11,7,3,3,15,14,4,6,1,3,0,0,0,0,0,0,18,6,29,10,4,0
"20230812PETSTE",2023-08-12,"Scotland League Two","Peterhead","Stenhousemuir",0,0,"D",9,8,2,1,10,14,4,6,1,2,1,0,0,0,0,0,17,3,24,10,3,1
"20230812STREAS",2023-08-12,"Scotland League Two","Stranraer","East Fife",1,1,"D",3,14,3,8,8,11,6,6,2,1,1,0,0,0,0,2,17,11,19,12,3,1
"20230819BONSTR",2023-08-19,"Scotland League Two","Bonnyrigg Rose","Stranraer",1,1,"D",5,5,3,2,12,8,2,4,2,1,0,0,0,0,0,2,10,5,20,6,3,0
"20230819CLYPET",2023-08-19,"Scotland League Two","Clyde","Peterhead",1,2,"A",3,11,3,5,13,4,2,1,2,1,1,1,0,0,0,3,14,8,17,3,3,2
"20230819DUMFOR",2023-08-19,"Scotland League Two","Dumbarton","Forfar",3,1,"H",14,6,4,3,7,9,9,5,0,1,0,0,0,0,0,4,20,7,16,14,1,0
"20230819EASSTE",2023-08-19,"Scotland League Two","East Fife","Stenhousemuir",0,2,"A",6,6,3,4,9,14,6,3,2,3,0,0,0,0,0,2,12,7,23,9,5,0
"20230819SPAELG",2023-08-19,"Scotland League Two","Spartans","Elgin",2,1,"H",11,8,6,3,11,8,5,3,0,0,0,0,0,0,0,3,19,9,19,8,0,0
"20230826ELGEAS",2023-08-26,"Scotland League Two","Elgin","East Fife",1,1,"D",8,10,3,4,12,7,2,5,4,2,0,0,0,0,0,2,18,7,19,7,6,0
"20230826FORBON",2023-08-26,"Scotland League Two","Forfar","Bonnyrigg Rose",1,2,"A",9,8,4,3,21,20,3,4,2,1,1,0,0,0,0,3,17,7,41,7,3,1
"20230826PETSPA",2023-08-26,"Scotland League Two","Peterhead","Spartans",0,1,"A",5,11,2,6,10,8,3,5,4,1,0,0,0,0,0,1,16,8,18,8,5,0
"20230826STEDUM",2023-08-26,"Scotland League Two","Stenhousemuir","Dumbarton",2,4,"A",10,12,5,8,9,12,9,7,4,5,0,1,0,0,0,6,22,13,21,16,9,1
"20230826STRCLY",2023-08-26,"Scotland League Two","Stranraer","Clyde",1,0,"H",15,9,3,4,11,9,7,3,1,1,0,0,0,0,0,1,24,7,20,10,2,0
"20230902BONELG",2023-09-02,"Scotland League Two","Bonnyrigg Rose","Elgin",5,1,"H",13,11,6,3,22,11,6,3,1,1,0,0,0,0,0,6,24,9,33,9,2,0
"20230902CLYFOR",2023-09-02,"Scotland League Two","Clyde","Forfar",0,0,"D",7,7,5,1,14,12,3,2,2,2,0,0,0,0,0,0,14,6,26,5,4,0
"20230902DUMEAS",2023-09-02,"Scotland League Two","Dumbarton","East Fife",1,0,"H",10,7,3,2,13,15,3,4,1,2,0,0,0,0,0,1,17,5,28,7,3,0
"20230902SPASTE",2023-09-02,"Scotland League Two","Spartans","Stenhousemuir",0,1,"A",7,9,2,4,6,7,10,3,1,0,0,1,0,0,0,1,16,6,13,13,1,1
"20230902STRPET",2023-09-02,"Scotland League Two","Stranraer","Peterhead",2,1,"H",14,11,7,5,11,18,6,5,3,3,0,0,0,0,0,3,25,12,29,11,6,0
"20230916EASCLY",2023-09-16,"Scotland League Two","East Fife","Clyde",2,0,"H",9,6,4,3,10,17,4,0,2,2,0,0,0,0,0,2,15,7,27,4,4,0
"20230916ELGDUM",2023-09-16,"Scotland League Two","Elgin","Dumbarton",2,0,"H",11,11,4,2,9,11,7,7,1,0,0,0,0,0,0,2,22,6,20,14,1,0
"20230916FORSPA",2023-09-16,"Scotland League Two","Forfar","Spartans",2,2,"D",8,12,6,7,11,8,5,4,3,2,0,0,0,0,0,4,20,13,19,9,5,0
"20230916PETBON",2023-09-16,"Scotland League Two","Peterhead","Bonnyrigg Rose",2,1,"H",10,8,4,2,21,12,2,3,5,2,0,0,0,0,0,3,18,6,33,5,7,0
"20230916STESTR",2023-09-16,"Scotland League Two","Stenhousemuir","Stranraer",5,0,"H",10,3,8,2,9,10,8,3,2,3,0,0,0,0,0,5,13,10,19,11,5,0
"20230923BONSTE",2023-09-23,"Scotland League Two","Bonnyrigg Rose","Stenhousemuir",0,1,"A",8,11,3,5,13,15,4,2,5,3,0,0,0,0,0,1,19,8,28,6,8,0
"20230923CLYELG",2023-09-23,"Scotland League Two","Clyde","Elgin",2,1,"H",11,13,4,2,7,8,7,2,2,2,0,0,0,0,0,3,24,6,15,9,4,0
"20230923DUMPET",2023-09-23,"Scotland League Two","Dumbarton","Peterhead",0,1,"A",11,16,3,5,14,9,11,7,2,2,1,0,0,0,0,1,27,8,23,18,4,1
"20230923SPAEAS",2023-09-23,"Scotland League Two","Spartans","East Fife",2,2,"D",7,10,2,8,8,10,5,2,2,2,0,0,0,0,0,4,17,10,18,7,4,0
"20230923STRFOR",2023-09-23,"Scotland League Two","Stranraer","Forfar",0,2,"A",9,11,5,6,7,18,9,8,1,2,0,0,1,0,1,2,20,11,25,17,3,0
"20230930DUMSTR",2023-09-30,"Scotland League Two","Dumbarton","Stranraer",3,1,"H",10,6,5,1,11,10,8,3,2,3,0,0,0,0,0,4,16,6,21,11,5,0
"20230930EASFOR",2023-09-30,"Scotland League Two","East Fife","Forfar",1,1,"D",2,9,1,3,15,17,4,3,1,2,0,0,0,0,0,2,11,4,32,7,3,0
"20230930PETELG",2023-09-30,"Scotland League Two","Peterhead","Elgin",6,0,"H",13,4,8,1,9,15,4,2,0,5,0,0,0,0,0,6,17,9,24,6,5,0
"20230930SPABON",2023-09-30,"Scotland League Two","Spartans","Bonnyrigg Rose",2,2,"D",7,9,3,4,15,11,6,4,2,1,0,0,0,0,0,4,16,7,26,10,3,0
"20230930STECLY",2023-09-30,"Scotland League Two","Stenhousemuir","Clyde",2,2,"D",13,12,8,4,7,12,5,4,2,4,0,0,0,0,0,4,25,12,19,9,6,0
"20231007CLYDUM",2023-10-07,"Scotland League Two","Clyde","Dumbarton",0,4,"A",10,11,4,6,11,11,6,5,2,2,0,0,0,0,0,4,21,10,22,11,4,0
"20231007FORPET",2023-10-07,"Scotland League Two","Forfar","Peterhead",1,3,"A",12,10,6,5,8,14,8,2,2,1,0,0,0,0,0,4,22,11,22,10,3,0
"20231007STRSPA",2023-10-07,"Scotland League Two","Stranraer","Spartans",3,4,"A",10,14,5,6,13,9,11,4,1,0,0,0,0,0,0,7,24,11,22,15,1,0
"20231021BONCLY",2023-10-21,"Scotland League Two","Bonnyrigg Rose","Clyde",3,2,"H",9,13,6,6,7,14,2,7,1,2,0,0,0,0,0,5,22,12,21,9,3,0
"20231021EASSTR",2023-10-21,"Scotland League Two","East Fife","Stranraer",4,0,"H",12,0,6,0,10,11,5,7,2,1,0,0,0,0,0,4,12,6,21,12,3,0
"20231021SPADUM",2023-10-21,"Scotland League Two","Spartans","Dumbarton",2,0,"H",8,7,3,1,8,8,4,11,1,1,0,0,0,0,0,2,15,4,16,15,2,0
"20231024ELGSTE",2023-10-24,"Scotland League Two","Elgin","Stenhousemuir",1,1,"D",11,11,2,4,13,15,5,5,3,2,0,1,0,0,0,2,22,6,28,10,5,1
"20231104CLYSPA",2023-11-04,"Scotland League Two","Clyde","Spartans",1,2,"A",10,7,3,2,13,8,5,3,3,1,0,0,0,0,0,3,17,5,21,8,4,0
"20231104DUMBON",2023-11-04,"Scotland League Two","Dumbarton","Bonnyrigg Rose",4,0,"H",12,15,7,3,8,10,6,9,3,1,0,0,0,0,0,4,27,10,18,15,4,0
"20231104FORSTE",2023-11-04,"Scotland League Two","Forfar","Stenhousemuir",1,3,"A",4,12,2,7,11,8,4,5,2,1,0,0,0,0,0,4,16,9,19,9,3,0
"20231104PETEAS",2023-11-04,"Scotland League Two","Peterhead","East Fife",2,0,"H",11,5,6,2,11,14,7,6,1,3,0,0,0,0,0,2,16,8,25,13,4,0
"20231104STRELG",2023-11-04,"Scotland League Two","Stranraer","Elgin",3,1,"H",8,6,6,3,12,12,8,4,2,2,0,0,0,0,0,4,14,9,24,12,4,0
"20231111EASDUM",2023-11-11,"Scotland League Two","East Fife","Dumbarton",0,1,"A",5,6,2,4,10,11,4,9,1,3,0,0,0,0,0,1,11,6,21,13,4,0
"20231111ELGBON",2023-11-11,"Scotland League Two","Elgin","Bonnyrigg Rose",2,0,"H",12,9,6,6,12,9,1,6,5,4,0,0,0,0,0,2,21,12,21,7,9,0
"20231111FORCLY",2023-11-11,"Scotland League Two","Forfar","Clyde",1,1,"D",15,13,6,4,13,14,4,5,1,0,0,0,0,0,0,2,28,10,27,9,1,0
"20231111PETSTR",2023-11-11,"Scotland League Two","Peterhead","Stranraer",3,2,"H",9,8,5,6,14,14,3,7,4,3,0,0,0,0,0,5,17,11,28,10,7,0
"20231111STESPA",2023-11-11,"Scotland League Two","Stenhousemuir","Spartans",3,2,"H",12,9,5,4,13,14,6,6,4,1,0,0,0,0,0,5,21,9,27,12,5,0
"20231114STEPET",2023-11-14,"Scotland League Two","Stenhousemuir","Peterhead",2,0,"H",16,10,4,3,14,16,1,5,2,4,0,0,0,0,0,2,26,7,30,6,6,0
"20231118BONFOR",2023-11-18,"Scotland League Two","Bonnyrigg Rose","Forfar",0,2,"A",6,8,2,5,7,11,4,4,0,2,0,0,0,0,0,2,14,7,18,8,2,0
"20231118CLYEAS",2023-11-18,"Scotland League Two","Clyde","East Fife",0,4,"A",7,10,2,7,8,7,5,2,1,3,0,0,0,0,0,4,17,9,15,7,4,0
"20231118DUMELG",2023-11-18,"Scotland League Two","Dumbarton","Elgin",1,0,"H",8,7,2,2,11,11,2,2,1,3,0,0,0,0,0,1,15,4,22,4,4,0
"20231118SPAPET",2023-11-18,"Scotland League Two","Spartans","Peterhead",1,2,"A",9,10,5,4,7,17,3,1,2,4,0,0,0,0,0,3,19,9,24,4,6,0
"20231118STRSTE",2023-11-18,"Scotland League Two","Stranraer","Stenhousemuir",0,3,"A",6,6,3,3,8,7,10,2,2,1,0,0,0,0,0,3,12,6,15,12,3,0
"20231121BONEAS",2023-11-21,"Scotland League Two","Bonnyrigg Rose","East Fife",4,2,"H",15,5,10,2,9,18,5,4,3,2,0,0,0,0,0,6,20,12,27,9,5,0
"20231121ELGFOR",2023-11-21,"Scotland League Two","Elgin","Forfar",1,0,"H",6,10,3,3,19,10,5,3,2,0,0,0,0,0,0,1,16,6,29,8,2,0
"20231202FORSTR",2023-12-02,"Scotland League Two","Forfar","Stranraer",1,1,"D",16,4,5,1,16,12,9,3,2,3,0,0,0,0,0,2,20,6,28,12,5,0
"20231202STEBON",2023-12-02,"Scotland League Two","Stenhousemuir","Bonnyrigg Rose",1,0,"H",12,7,6,2,11,17,5,3,2,2,1,1,0,0,0,1,19,8,28,8,4,2
"20231209BONPET",2023-12-09,"Scotland League Two","Bonnyrigg Rose","Peterhead",1,1,"D",7,9,3,2,19,15,9,4,2,3,0,0,0,0,0,2,16,5,34,13,5,0
"20231209CLYSTR",2023-12-09,"Scotland League Two","Clyde","Stranraer",2,2,"D",5,5,4,2,6,7,4,6,2,1,0,0,0,0,0,4,10,6,13,10,3,0
"20231209DUMSTE",2023-12-09,"Scotland League Two","Dumbarton","Stenhousemuir",0,1,"A",8,9,2,4,12,10,7,4,3,1,0,0,0,0,0,1,17,6,22,11,4,0
"20231209EASELG",2023-12-09,"Scotland League Two","East Fife","Elgin",4,0,"H",10,1,6,1,13,6,8,2,0,1,0,0,0,0,0,4,11,7,19,10,1,0
"20231209SPAFOR",2023-12-09,"Scotland League Two","Spartans","Forfar",1,0,"H",5,7,2,1,15,10,2,3,5,3,0,0,0,0,0,1,12,3,25,5,8,0
"20231216ELGSPA",2023-12-16,"Scotland League Two","Elgin","Spartans",0,4,"A",13,9,4,7,12,19,3,4,1,4,0,0,0,0,0,4,22,11,31,7,5,0
"20231216FORDUM",2023-12-16,"Scotland League Two","Forfar","Dumbarton",2,4,"A",8,12,6,6,11,7,3,5,0,0,0,0,0,0,0,6,20,12,18,8,0,0
"20231216PETCLY",2023-12-16,"Scotland League Two","Peterhead","Clyde",2,1,"H",9,6,3,3,12,14,5,0,2,2,1,0,0,0,0,3,15,6,26,5,4,1
"20231216STEEAS",2023-12-16,"Scotland League Two","Stenhousemuir","East Fife",2,1,"H",9,10,5,4,7,12,5,5,2,4,0,0,0,0,0,3,19,9,19,10,6,0
"20231216STRBON",2023-12-16,"Scotland League Two","Stranraer","Bonnyrigg Rose",3,1,"H",11,11,5,3,8,8,3,5,0,2,0,0,0,0,0,4,22,8,16,8,2,0
"20231222EASBON",2023-12-22,"Scotland League Two","East Fife","Bonnyrigg Rose",0,3,"A",6,8,2,4,11,11,3,4,2,2,0,0,0,0,0,3,14,6,22,7,4,0
"20231223DUMCLY",2023-12-23,"Scotland League Two","Dumbarton","Clyde",4,4,"D",11,14,7,6,11,11,8,6,2,3,0,0,0,0,0,8,25,13,22,14,5,0
"20231223PETFOR",2023-12-23,"Scotland League Two","Peterhead","Forfar",1,2,"A",14,9,5,6,11,20,5,2,0,3,0,1,0,0,0,3,23,11,31,7,3,1
"20231223SPASTR",2023-12-23,"Scotland League Two","Spartans","Stranraer",3,0,"H",8,4,3,0,14,7,6,3,2,0,0,0,0,0,0,3,12,3,21,9,2,0
"20231223STEELG",2023-12-23,"Scotland League Two","Stenhousemuir","Elgin",2,0,"H",8,5,3,2,13,16,6,3,0,1,0,0,0,0,0,2,13,5,29,9,1,0
"20231230CLYSTE",2023-12-30,"Scotland League Two","Clyde","Stenhousemuir",1,2,"A",7,6,2,2,13,9,0,0,1,2,0,1,0,0,0,3,13,4,22,0,3,1
"20231230ELGPET",2023-12-30,"Scotland League Two","Elgin","Peterhead",2,1,"H",11,13,6,5,18,16,1,6,6,3,0,0,0,0,0,3,24,11,34,7,9,0
"20231230FOREAS",2023-12-30,"Scotland League Two","Forfar","East Fife",0,0,"D",7,6,2,4,9,13,2,5,1,2,1,0,0,0,0,0,13,6,22,7,3,1
"20240106CLYBON",2024-01-06,"Scotland League Two","Clyde","Bonnyrigg Rose",3,2,"H",10,11,4,4,5,6,7,7,1,1,0,0,0,0,0,5,21,8,11,14,2,0
"20240106DUMEAS",2024-01-06,"Scotland League Two","Dumbarton","East Fife",1,2,"A",9,9,3,3,8,9,8,5,3,3,0,0,0,0,0,3,18,6,17,13,6,0
"20240106ELGSTR",2024-01-06,"Scotland League Two","Elgin","Stranraer",2,1,"H",9,13,5,6,13,12,3,2,1,2,0,0,0,0,0,3,22,11,25,5,3,0
"20240106PETSPA",2024-01-06,"Scotland League Two","Peterhead","Spartans",0,1,"A",4,4,3,2,11,13,5,2,3,1,0,0,0,0,0,1,8,5,24,7,4,0
"20240106STEFOR",2024-01-06,"Scotland League Two","Stenhousemuir","Forfar",2,1,"H",7,4,4,2,10,11,8,3,2,0,0,0,0,0,0,3,11,6,21,11,2,0
"20240109PETDUM",2024-01-09,"Scotland League Two","Peterhead","Dumbarton",3,1,"H",16,6,6,3,9,12,4,1,3,3,0,0,0,0,0,4,22,9,21,5,6,0
"20240113BONDUM",2024-01-13,"Scotland League Two","Bonnyrigg Rose","Dumbarton",1,1,"D",9,17,5,8,9,11,6,9,3,2,0,0,1,1,0,2,26,13,20,15,5,0
"20240113EASCLY",2024-01-13,"Scotland League Two","East Fife","Clyde",1,1,"D",5,9,1,5,12,9,3,4,0,2,0,0,0,0,0,2,14,6,21,7,2,0
"20240113FORELG",2024-01-13,"Scotland League Two","Forfar","Elgin",2,1,"H",14,4,5,1,11,20,6,3,2,3,0,1,0,0,0,3,18,6,31,9,5,1
"20240113SPASTE",2024-01-13,"Scotland League Two","Spartans","Stenhousemuir",0,2,"A",8,8,0,6,9,13,5,3,0,0,0,0,0,0,0,2,16,6,22,8,0,0
"20240113STRPET",2024-01-13,"Scotland League Two","Stranraer","Peterhead",2,0,"H",7,6,4,1,13,10,3,4,2,2,0,1,0,0,0,2,13,5,23,7,4,1
"20240120EASPET",2024-01-20,"Scotland League Two","East Fife","Peterhead",2,2,"D",7,9,3,4,18,12,7,6,2,3,0,0,0,0,0,4,16,7,30,13,5,0
"20240120STESTR",2024-01-20,"Scotland League Two","Stenhousemuir","Stranraer",1,0,"H",7,9,4,1,12,9,4,6,3,0,1,0,0,0,0,1,16,5,21,10,3,1
"20240127ELGDUM",2024-01-27,"Scotland League Two","Elgin","Dumbarton",0,1,"A",12,11,3,5,13,13,5,4,1,0,0,0,0,0,0,1,23,8,26,9,1,0
"20240127FORBON",2024-01-27,"Scotland League Two","Forfar","Bonnyrigg Rose",0,0,"D",7,8,2,3,12,12,4,7,1,4,0,0,0,0,0,0,15,5,24,11,5,0
"20240127PETSTE",2024-01-27,"Scotland League Two","Peterhead","Stenhousemuir",2,1,"H",12,6,5,2,9,17,3,6,3,4,0,0,0,0,0,3,18,7,26,9,7,0
"20240127SPACLY",2024-01-27,"Scotland League Two","Spartans","Clyde",1,1,"D",6,8,1,4,11,11,0,10,2,0,0,0,0,0,0,2,14,5,22,10,2,0
"20240127STREAS",2024-01-27,"Scotland League Two","Stranraer","East Fife",0,1,"A",7,8,1,4,11,7,9,2,2,0,0,0,0,0,0,1,15,5,18,11,2,0
"20240130EASSPA",2024-01-30,"Scotland League Two","East Fife","Spartans",0,3,"A",5,8,3,4,7,11,2,3,0,1,0,0,0,0,0,3,13,7,18,5,1,0
"20240130ELGCLY",2024-01-30,"Scotland League Two","Elgin","Clyde",2,1,"H",11,7,5,4,10,13,8,4,0,2,0,0,0,0,0,3,18,9,23,12,2,0
"20240203BONSTR",2024-02-03,"Scotland League Two","Bonnyrigg Rose","Stranraer",0,0,"D",9,9,1,5,12,10,7,6,5,1,0,0,0,0,0,0,18,6,22,13,6,0
"20240203CLYPET",2024-02-03,"Scotland League Two","Clyde","Peterhead",1,1,"D",7,9,5,5,11,12,4,4,1,3,0,0,0,0,0,2,16,10,23,8,4,0
"20240203ELGEAS",2024-02-03,"Scotland League Two","Elgin","East Fife",1,0,"H",12,4,5,1,12,11,8,6,1,1,0,0,0,0,0,1,16,6,23,14,2,0
"20240203FORSPA",2024-02-03,"Scotland League Two","Forfar","Spartans",1,0,"H",7,5,5,2,9,7,2,5,2,0,0,0,0,0,0,1,12,7,16,7,2,0
"20240203STEDUM",2024-02-03,"Scotland League Two","Stenhousemuir","Dumbarton",1,0,"H",11,8,3,4,8,13,5,12,3,4,0,1,0,0,0,1,19,7,21,17,7,1
"20240206BONELG",2024-02-06,"Scotland League Two","Bonnyrigg Rose","Elgin",2,0,"H",12,7,5,2,18,10,6,5,1,3,0,0,0,0,0,2,19,7,28,11,4,0
"20240210DUMFOR",2024-02-10,"Scotland League Two","Dumbarton","Forfar",2,2,"D",12,10,7,3,15,13,3,5,2,3,0,0,0,0,0,4,22,10,28,8,5,0
"20240210EASSTE",2024-02-10,"Scotland League Two","East Fife","Stenhousemuir",1,1,"D",4,6,1,2,15,9,5,3,3,1,0,0,0,0,0,2,10,3,24,8,4,0
"20240210SPAELG",2024-02-10,"Scotland League Two","Spartans","Elgin",1,2,"A",7,7,1,5,11,11,5,5,2,1,0,0,0,0,0,3,14,6,22,10,3,0
"20240210STRCLY",2024-02-10,"Scotland League Two","Stranraer","Clyde",2,0,"H",9,7,5,1,10,14,5,5,3,5,0,1,0,0,0,2,16,6,24,10,8,1
"20240213DUMSPA",2024-02-13,"Scotland League Two","Dumbarton","Spartans",0,0,"D",13,6,4,2,10,8,7,3,4,2,0,0,1,0,1,0,19,6,18,10,6,0
"20240217BONEAS",2024-02-17,"Scotland League Two","Bonnyrigg Rose","East Fife",0,2,"A",15,9,6,4,15,15,2,2,2,1,1,0,0,0,0,2,24,10,30,4,3,1
"20240217CLYDUM",2024-02-17,"Scotland League Two","Clyde","Dumbarton",2,0,"H",14,8,4,1,10,12,5,5,3,3,1,0,0,0,0,2,22,5,22,10,6,1
"20240217ELGSTE",2024-02-17,"Scotland League Two","Elgin","Stenhousemuir",2,2,"D",12,9,3,5,8,10,5,4,1,2,0,0,0,0,0,4,21,8,18,9,3,0
"20240217FORPET",2024-02-17,"Scotland League Two","Forfar","Peterhead",3,3,"D",11,13,6,5,13,13,7,8,2,3,0,0,0,0,0,6,24,11,26,15,5,0
"20240217STRSPA",2024-02-17,"Scotland League Two","Stranraer","Spartans",1,2,"A",4,4,2,3,7,8,4,6,2,2,0,0,0,0,0,3,8,5,15,10,4,0
"20240220CLYFOR",2024-02-20,"Scotland League Two","Clyde","Forfar",0,2,"A",9,8,4,3,10,13,8,5,3,2,0,0,0,0,0,2,17,7,23,13,5,0
"20240220PETBON",2024-02-20,"Scotland League Two","Peterhead","Bonnyrigg Rose",0,0,"D",11,6,6,1,9,10,4,3,1,1,1,0,0,0,0,0,17,7,19,7,2,1
"20240224DUMSTR",2024-02-24,"Scotland League Two","Dumbarton","Stranraer",2,1,"H",10,12,3,4,6,7,4,5,0,1,0,0,0,0,0,3,22,7,13,9,1,0
"20240224EASFOR",2024-02-24,"Scotland League Two","East Fife","Forfar",1,1,"D",6,3,2,2,12,10,11,1,1,1,0,0,0,0,0,2,9,4,22,12,2,0
"20240224PETELG",2024-02-24,"Scotland League Two","Peterhead","Elgin",1,1,"D",8,10,4,3,20,12,4,4,5,2,0,0,0,0,0,2,18,7,32,8,7,0
"20240224SPABON",2024-02-24,"Scotland League Two","Spartans","Bonnyrigg Rose",2,1,"H",9,8,5,5,10,15,11,6,3,5,0,0,0,0,0,3,17,10,25,17,8,0
"20240224STECLY",2024-02-24,"Scotland League Two","Stenhousemuir","Clyde",1,6,"A",16,14,8,10,9,11,8,5,0,2,0,0,0,0,0,7,30,18,20,13,2,0
"20240302BONSTE",2024-03-02,"Scotland League Two","Bonnyrigg Rose","Stenhousemuir",0,1,"A",6,15,2,4,11,15,6,5,0,3,0,0,0,0,0,1,21,6,26,11,3,0
"20240302CLYELG",2024-03-02,"Scotland League Two","Clyde","Elgin",2,1,"H",12,13,4,4,9,11,6,4,1,1,0,1,0,0,0,3,25,8,20,10,2,1
"20240302DUMPET",2024-03-02,"Scotland League Two","Dumbarton","Peterhead",1,0,"H",14,6,5,1,10,16,7,2,2,3,0,0,0,0,0,1,20,6,26,9,5,0
"20240302SPAEAS",2024-03-02,"Scotland League Two","Spartans","East Fife",1,3,"A",4,7,3,3,9,11,6,3,2,2,0,0,0,0,0,4,11,6,20,9,4,0
"20240302STRFOR",2024-03-02,"Scotland League Two","Stranraer","Forfar",0,0,"D",9,8,5,6,8,14,6,6,1,1,0,1,0,0,0,0,17,11,22,12,2,1
"20240305BONSPA",2024-03-05,"Scotland League Two","Bonnyrigg Rose","Spartans",2,2,"D",12,15,4,6,14,17,5,1,0,1,1,0,0,0,0,4,27,10,31,6,1,1
"20240305STRDUM",2024-03-05,"Scotland League Two","Stranraer","Dumbarton",5,0,"H",15,14,8,7,6,5,3,6,1,2,0,0,0,0,0,5,29,15,11,9,3,0
"20240309EASDUM",2024-03-09,"Scotland League Two","East Fife","Dumbarton",3,2,"H",8,7,5,3,7,13,8,3,1,2,0,0,0,0,0,5,15,8,20,11,3,0
"20240309ELGBON",2024-03-09,"Scotland League Two","Elgin","Bonnyrigg Rose",1,0,"H",14,3,6,2,15,17,2,5,2,1,0,0,1,0,1,1,17,8,32,7,3,0
"20240309FORCLY",2024-03-09,"Scotland League Two","Forfar","Clyde",2,1,"H",11,10,5,4,9,13,7,3,0,0,0,0,0,0,0,3,21,9,22,10,0,0
"20240309PETSTR",2024-03-09,"Scotland League Two","Peterhead","Stranraer",2,0,"H",8,8,6,3,14,8,5,7,1,3,0,0,0,0,0,2,16,9,22,12,4,0
"20240309STESPA",2024-03-09,"Scotland League Two","Stenhousemuir","Spartans",0,0,"D",5,6,2,1,10,12,7,2,0,1,0,0,0,0,0,0,11,3,22,9,1,0
"20240316BONCLY",2024-03-16,"Scotland League Two","Bonnyrigg Rose","Clyde",1,2,"A",11,14,4,5,8,12,2,7,0,0,0,0,0,0,0,3,25,9,20,9,0,0
"20240316FORSTE",2024-03-16,"Scotland League Two","Forfar","Stenhousemuir",1,1,"D",6,12,1,3,15,22,3,3,2,4,0,0,0,0,0,2,18,4,37,6,6,0
"20240316PETEAS",2024-03-16,"Scotland League Two","Peterhead","East Fife",1,1,"D",8,5,4,1,7,13,2,3,0,2,0,0,0,0,0,2,13,5,20,5,2,0
"20240316SPADUM",2024-03-16,"Scotland League Two","Spartans","Dumbarton",2,6,"A",5,15,3,8,11,9,9,6,0,2,0,0,0,0,0,8,20,11,20,15,2,0
"20240316STRELG",2024-03-16,"Scotland League Two","Stranraer","Elgin",1,2,"A",3,3,2,3,9,8,5,6,3,2,1,0,0,0,0,3,6,5,17,11,5,1
"20240323CLYSPA",2024-03-23,"Scotland League Two","Clyde","Spartans",0,0,"D",5,5,1,2,15,10,7,5,2,3,0,0,0,0,0,0,10,3,25,12,5,0
"20240323DUMBON",2024-03-23,"Scotland League Two","Dumbarton","Bonnyrigg Rose",2,0,"H",12,5,7,1,5,9,6,1,0,3,0,0,0,0,0,2,17,8,14,7,3,0
"20240323EASSTR",2024-03-23,"Scotland League Two","East Fife","Stranraer",2,1,"H",8,2,2,1,6,4,3,3,4,0,0,0,0,0,0,3,10,3,10,6,4,0
"20240323ELGFOR",2024-03-23,"Scotland League Two","Elgin","Forfar",1,1,"D",10,6,3,4,12,19,7,4,1,2,0,0,0,0,0,2,16,7,31,11,3,0
"20240323STEPET",2024-03-23,"Scotland League Two","Stenhousemuir","Peterhead",0,0,"D",9,6,2,3,21,7,6,5,3,1,0,0,0,0,0,0,15,5,28,11,4,0
"20240330DUMSTE",2024-03-30,"Scotland League Two","Dumbarton","Stenhousemuir",0,0,"D",13,9,6,1,11,8,6,3,1,2,0,0,0,0,0,0,22,7,19,9,3,0
"20240330EASELG",2024-03-30,"Scotland League Two","East Fife","Elgin",2,0,"H",10,6,6,2,18,9,3,4,0,2,0,0,0,0,0,2,16,8,27,7,2,0
"20240330PETCLY",2024-03-30,"Scotland League Two","Peterhead","Clyde",4,1,"H",10,7,6,4,9,14,4,3,1,3,0,1,0,0,0,5,17,10,23,7,4,1
"20240330SPAFOR",2024-03-30,"Scotland League Two","Spartans","Forfar",1,0,"H",4,5,2,1,9,16,4,6,1,1,0,1,0,0,0,1,9,3,25,10,2,1
"20240330STRBON",2024-03-30,"Scotland League Two","Stranraer","Bonnyrigg Rose",1,1,"D",7,16,4,4,7,11,1,4,1,1,0,0,0,0,0,2,23,8,18,5,2,0
"20240406BONPET",2024-04-06,"Scotland League Two","Bonnyrigg Rose","Peterhead",2,2,"D",12,11,3,5,17,13,10,4,4,6,0,0,0,0,0,4,23,8,30,14,10,0
"20240406CLYSTR",2024-04-06,"Scotland League Two","Clyde","Stranraer",1,0,"H",13,4,6,1,9,9,7,2,1,2,0,0,0,0,0,1,17,7,18,9,3,0
"20240406ELGSPA",2024-04-06,"Scotland League Two","Elgin","Spartans",2,2,"D",8,10,3,4,9,10,1,2,1,1,0,0,0,0,0,4,18,7,19,3,2,0
"20240406FORDUM",2024-04-06,"Scotland League Two","Forfar","Dumbarton",0,2,"A",5,9,1,5,14,8,4,4,1,1,0,0,0,0,0,2,14,6,22,8,2,0
"20240406STEEAS",2024-04-06,"Scotland League Two","Stenhousemuir","East Fife",0,0,"D",9,4,2,2,15,10,10,2,2,1,0,0,0,0,0,0,13,4,25,12,3,0
"20240413DUMCLY",2024-04-13,"Scotland League Two","Dumbarton","Clyde",1,0,"H",9,6,4,2,10,9,6,9,2,3,0,0,0,0,0,1,15,6,19,15,5,0
"20240413EASBON",2024-04-13,"Scotland League Two","East Fife","Bonnyrigg Rose",1,4,"A",2,8,1,6,5,9,5,5,0,1,0,0,0,0,0,5,10,7,14,10,1,0
"20240413PETFOR",2024-04-13,"Scotland League Two","Peterhead","Forfar",2,1,"H",7,9,2,3,7,14,3,2,4,2,0,0,0,0,0,3,16,5,21,5,6,0
"20240413SPASTR",2024-04-13,"Scotland League Two","Spartans","Stranraer",0,0,"D",2,5,1,2,12,6,3,5,2,1,0,0,0,0,0,0,7,3,18,8,3,0
"20240413STEELG",2024-04-13,"Scotland League Two","Stenhousemuir","Elgin",1,1,"D",15,9,7,4,14,16,2,4,4,4,0,1,0,0,0,2,24,11,30,6,8,1
"20240420BONSPA",2024-04-20,"Scotland League Two","Bonnyrigg Rose","Spartans",0,1,"A",10,10,2,4,16,14,8,3,1,2,0,0,0,0,0,1,20,6,30,11,3,0
"20240420CLYSTE",2024-04-20,"Scotland League Two","Clyde","Stenhousemuir",2,2,"D",12,15,6,5,6,13,3,6,0,1,0,0,0,0,0,4,27,11,19,9,1,0
"20240420ELGPET",2024-04-20,"Scotland League Two","Elgin","Peterhead",1,1,"D",6,9,5,2,9,15,4,8,0,3,1,0,0,0,0,2,15,7,24,12,3,1
"20240420FOREAS",2024-04-20,"Scotland League Two","Forfar","East Fife",2,1,"H",11,6,5,2,10,13,3,9,4,2,0,0,0,0,0,3,17,7,23,12,6,0
"20240420STRDUM",2024-04-20,"Scotland League Two","Stranraer","Dumbarton",0,0,"D",6,4,1,2,6,5,5,6,0,2,0,0,0,0,0,0,10,3,11,11,2,0
"20240427CLYEAS",2024-04-27,"Scotland League Two","Clyde","East Fife",1,0,"H",14,7,6,4,11,16,5,4,1,2,0,0,0,0,0,1,21,10,27,9,3,0
"20240427DUMELG",2024-04-27,"Scotland League Two","Dumbarton","Elgin",2,2,"D",13,6,4,3,9,8,5,3,2,2,0,0,0,0,0,4,19,7,17,8,4,0
"20240427FORSTR",2024-04-27,"Scotland League Two","Forfar","Stranraer",2,0,"H",13,1,6,0,11,10,7,7,1,1,0,0,0,0,0,2,14,6,21,14,2,0
"20240427SPAPET",2024-04-27,"Scotland League Two","Spartans","Peterhead",2,2,"D",8,10,5,3,8,11,4,6,0,2,0,0,0,0,0,4,18,8,19,10,2,0
"20240427STEBON",2024-04-27,"Scotland League Two","Stenhousemuir","Bonnyrigg Rose",1,1,"D",8,14,3,4,9,12,4,7,0,1,0,0,0,0,0,2,22,7,21,11,1,0
"20240504BONFOR",2024-05-04,"Scotland League Two","Bonnyrigg Rose","Forfar",4,0,"H",11,10,6,1,17,13,7,4,3,1,0,0,0,0,0,4,21,7,30,11,4,0
"20240504EASSPA",2024-05-04,"Scotland League Two","East Fife","Spartans",1,2,"A",3,7,2,3,12,7,9,2,1,1,0,0,0,0,0,3,10,5,19,11,2,0
"20240504ELGCLY",2024-05-04,"Scotland League Two","Elgin","Clyde",0,3,"A",11,11,1,6,13,16,6,1,2,0,0,0,0,0,0,3,22,7,29,7,2,0
"20240504PETDUM",2024-05-04,"Scotland League Two","Peterhead","Dumbarton",2,1,"H",9,7,3,3,11,8,4,2,3,0,1,0,0,0,0,3,16,6,19,6,3,1
"20240504STRSTE",2024-05-04,"Scotland League Two","Stranraer","Stenhousemuir",2,0,"H",16,6,7,3,8,12,5,4,1,3,0,0,0,0,0,2,22,10,20,9,4,0
"20240803BONPET",2024-08-03,"Scotland League Two","Bonnyrigg Rose","Peterhead",0,1,"A",8,6,1,4,15,10,6,5,2,1,1,0,0,0,0,1,14,5,25,11,3,1
"20240803EDISTI",2024-08-03,"Scotland League Two","Edinburgh City","Stirling",1,2,"A",9,17,4,6,9,19,2,5,0,3,0,0,0,0,0,3,26,10,28,7,3,0
"20240803ELGEAS",2024-08-03,"Scotland League Two","Elgin","East Fife",4,2,"H",16,6,10,3,12,9,6,6,3,2,0,0,0,0,0,6,22,13,21,12,5,0
"20240803FORCLY",2024-08-03,"Scotland League Two","Forfar","Clyde",0,0,"D",8,8,3,4,8,13,8,7,1,1,0,0,0,0,0,0,16,7,21,15,2,0
"20240803STRSPA",2024-08-03,"Scotland League Two","Stranraer","Spartans",2,2,"D",6,4,2,2,10,7,5,4,2,1,0,0,0,0,0,4,10,4,17,9,3,0
"20240810CLYSTR",2024-08-10,"Scotland League Two","Clyde","Stranraer",1,0,"H",15,8,8,4,7,12,9,6,0,1,0,0,0,0,0,1,23,12,19,15,1,0
"20240810EASEDI",2024-08-10,"Scotland League Two","East Fife","Edinburgh City",2,0,"H",10,1,5,1,9,6,13,1,3,1,0,0,0,0,0,2,11,6,15,14,4,0
"20240810PETFOR",2024-08-10,"Scotland League Two","Peterhead","Forfar",2,1,"H",6,7,5,2,16,15,4,4,1,4,0,0,0,0,0,3,13,7,31,8,5,0
"20240810SPABON",2024-08-10,"Scotland League Two","Spartans","Bonnyrigg Rose",2,0,"H",7,9,2,4,12,14,1,6,3,2,0,0,0,0,0,2,16,6,26,7,5,0
"20240810STIELG",2024-08-10,"Scotland League Two","Stirling","Elgin",0,1,"A",10,11,4,5,6,9,9,3,0,0,0,0,0,0,0,1,21,9,15,12,0,0
"20240817CLYSTI",2024-08-17,"Scotland League Two","Clyde","Stirling",0,2,"A",15,5,9,4,4,14,8,4,0,4,0,0,0,0,0,2,20,13,18,12,4,0
"20240817EASFOR",2024-08-17,"Scotland League Two","East Fife","Forfar",2,1,"H",5,2,3,1,6,16,0,4,1,5,0,0,0,0,0,3,7,4,22,4,6,0
"20240817EDIBON",2024-08-17,"Scotland League Two","Edinburgh City","Bonnyrigg Rose",2,2,"D",10,12,3,6,9,13,5,11,4,4,0,1,0,0,0,4,22,9,22,16,8,1
"20240817PETSTR",2024-08-17,"Scotland League Two","Peterhead","Stranraer",1,0,"H",6,5,3,2,8,13,6,6,1,3,0,0,0,0,0,1,11,5,21,12,4,0
"20240824BONCLY",2024-08-24,"Scotland League Two","Bonnyrigg Rose","Clyde",2,1,"H",11,11,5,5,10,9,5,3,4,2,0,1,0,0,0,3,22,10,19,8,6,1
"20240824FOREDI",2024-08-24,"Scotland League Two","Forfar","Edinburgh City",0,3,"A",9,9,3,5,20,12,6,1,2,3,0,0,0,0,0,3,18,8,32,7,5,0
"20240824SPAPET",2024-08-24,"Scotland League Two","Spartans","Peterhead",0,0,"D",7,5,2,0,6,12,1,3,0,0,0,0,0,0,0,0,12,2,18,4,0,0
"20240824STIEAS",2024-08-24,"Scotland League Two","Stirling","East Fife",0,4,"A",6,12,2,7,9,7,0,4,3,2,0,0,0,0,0,4,18,9,16,4,5,0
"20240824STRELG",2024-08-24,"Scotland League Two","Stranraer","Elgin",1,1,"D",7,12,2,4,11,14,5,2,1,1,0,0,0,0,0,2,19,6,25,7,2,0
"20240831BONSTR",2024-08-31,"Scotland League Two","Bonnyrigg Rose","Stranraer",2,0,"H",11,9,6,3,8,12,2,5,2,4,0,0,0,0,0,2,20,9,20,7,6,0
"20240831EASCLY",2024-08-31,"Scotland League Two","East Fife","Clyde",5,1,"H",9,4,7,1,13,12,4,8,3,4,0,0,0,0,0,6,13,8,25,12,7,0
"20240831EDIPET",2024-08-31,"Scotland League Two","Edinburgh City","Peterhead",0,4,"A",8,10,2,6,12,8,3,3,2,3,0,0,0,0,0,4,18,8,20,6,5,0
"20240831FORELG",2024-08-31,"Scotland League Two","Forfar","Elgin",1,1,"D",4,6,2,3,10,15,2,3,3,2,0,0,0,0,0,2,10,5,25,5,5,0
"20240831STISPA",2024-08-31,"Scotland League Two","Stirling","Spartans",1,0,"H",8,7,5,2,13,6,3,5,3,2,0,0,0,0,0,1,15,7,19,8,5,0
"20240914CLYEDI",2024-09-14,"Scotland League Two","Clyde","Edinburgh City",1,1,"D",13,11,6,3,15,9,3,4,1,2,0,0,0,0,0,2,24,9,24,7,3,0
"20240914ELGBON",2024-09-14,"Scotland League Two","Elgin","Bonnyrigg Rose",2,1,"H",13,4,4,2,11,16,7,0,2,2,0,0,0,0,0,3,17,6,27,7,4,0
"20240914PETSTI",2024-09-14,"Scotland League Two","Peterhead","Stirling",2,1,"H",12,6,5,3,10,16,7,1,1,1,0,1,0,0,0,3,18,8,26,8,2,1
"20240914SPAFOR",2024-09-14,"Scotland League Two","Spartans","Forfar",1,0,"H",10,10,3,6,8,15,8,9,1,3,0,0,0,0,0,1,20,9,23,17,4,0
"20240914STREAS",2024-09-14,"Scotland League Two","Stranraer","East Fife",2,1,"H",13,8,3,2,12,7,0,2,1,3,0,1,0,0,0,3,21,5,19,2,4,1
"20240917ELGSPA",2024-09-17,"Scotland League Two","Elgin","Spartans",1,1,"D",10,10,3,3,12,3,2,5,2,2,0,0,0,0,0,2,20,6,15,7,4,0
"20240921CLYELG",2024-09-21,"Scotland League Two","Clyde","Elgin",0,0,"D",10,3,1,1,16,15,8,1,2,2,0,1,0,0,0,0,13,2,31,9,4,1
"20240921EASPET",2024-09-21,"Scotland League Two","East Fife","Peterhead",2,0,"H",5,8,3,2,7,10,9,6,2,3,0,0,0,0,0,2,13,5,17,15,5,0
"20240921FORSTR",2024-09-21,"Scotland League Two","Forfar","Stranraer",2,1,"H",13,7,3,4,7,9,3,3,3,2,0,0,0,0,0,3,20,7,16,6,5,0
"20240921STIBON",2024-09-21,"Scotland League Two","Stirling","Bonnyrigg Rose",0,2,"A",9,14,1,7,12,20,7,7,4,6,0,0,0,0,0,2,23,8,32,14,10,0
"20240928BONFOR",2024-09-28,"Scotland League Two","Bonnyrigg Rose","Forfar",0,1,"A",3,6,1,3,13,11,3,4,2,1,0,0,0,0,0,1,9,4,24,7,3,0
"20240928ELGEDI",2024-09-28,"Scotland League Two","Elgin","Edinburgh City",3,3,"D",12,9,5,6,10,8,5,0,1,2,1,0,0,0,0,6,21,11,18,5,3,1
"20240928PETCLY",2024-09-28,"Scotland League Two","Peterhead","Clyde",2,2,"D",10,10,4,3,15,16,4,2,1,2,0,0,0,0,0,4,20,7,31,6,3,0
"20240928SPAEAS",2024-09-28,"Scotland League Two","Spartans","East Fife",0,1,"A",5,9,3,8,17,21,5,4,3,2,0,0,0,0,0,1,14,11,38,9,5,0
"20240928STRSTI",2024-09-28,"Scotland League Two","Stranraer","Stirling",0,2,"A",5,5,1,5,8,12,5,2,3,2,0,0,0,0,0,2,10,6,20,7,5,0
"20241005CLYSPA",2024-10-05,"Scotland League Two","Clyde","Spartans",1,1,"D",5,8,5,2,18,6,3,7,1,1,0,0,0,0,0,2,13,7,24,10,2,0
"20241005EASBON",2024-10-05,"Scotland League Two","East Fife","Bonnyrigg Rose",5,0,"H",12,5,10,3,16,11,11,3,2,2,0,1,0,0,0,5,17,13,27,14,4,1
"20241005EDISTR",2024-10-05,"Scotland League Two","Edinburgh City","Stranraer",1,2,"A",16,9,7,5,16,10,5,3,4,2,0,0,0,0,0,3,25,12,26,8,6,0
"20241005PETELG",2024-10-05,"Scotland League Two","Peterhead","Elgin",0,1,"A",14,5,7,1,15,19,6,5,4,5,0,0,0,0,0,1,19,8,34,11,9,0
"20241005STIFOR",2024-10-05,"Scotland League Two","Stirling","Forfar",2,1,"H",7,9,3,4,9,8,5,6,1,2,1,0,0,0,0,3,16,7,17,11,3,1
"20241012EDISPA",2024-10-12,"Scotland League Two","Edinburgh City","Spartans",2,0,"H",9,3,5,3,13,13,2,8,3,2,0,1,0,0,0,2,12,8,26,10,5,1
"20241019BONEDI",2024-10-19,"Scotland League Two","Bonnyrigg Rose","Edinburgh City",2,0,"H",12,7,7,3,15,6,8,3,2,2,0,0,0,0,0,2,19,10,21,11,4,0
"20241019FOREAS",2024-10-19,"Scotland League Two","Forfar","East Fife",0,0,"D",6,5,2,0,15,18,2,7,2,2,0,0,0,0,0,0,11,2,33,9,4,0
"20241019SPAELG",2024-10-19,"Scotland League Two","Spartans","Elgin",1,3,"A",10,8,4,3,17,13,10,2,3,2,0,0,0,0,0,4,18,7,30,12,5,0
"20241019STICLY",2024-10-19,"Scotland League Two","Stirling","Clyde",3,1,"H",13,7,6,3,10,13,9,4,0,3,0,0,0,0,0,4,20,9,23,13,3,0
"20241019STRPET",2024-10-19,"Scotland League Two","Stranraer","Peterhead",0,0,"D",8,12,3,5,10,7,2,5,3,4,0,0,0,0,0,0,20,8,17,7,7,0
"20241102CLYBON",2024-11-02,"Scotland League Two","Clyde","Bonnyrigg Rose",2,2,"D",13,6,6,2,15,14,8,0,5,5,0,1,0,0,0,4,19,8,29,8,10,1
"20241102EASSTI",2024-11-02,"Scotland League Two","East Fife","Stirling",1,1,"D",11,9,4,5,15,15,5,8,1,0,0,0,0,0,0,2,20,9,30,13,1,0
"20241102EDIFOR",2024-11-02,"Scotland League Two","Edinburgh City","Forfar",2,0,"H",5,13,4,6,15,17,1,14,4,3,0,0,1,1,0,2,18,10,32,15,7,0
"20241102ELGSTR",2024-11-02,"Scotland League Two","Elgin","Stranraer",1,0,"H",5,8,3,5,9,17,2,6,2,5,1,0,0,0,0,1,13,8,26,8,7,1
"20241102PETSPA",2024-11-02,"Scotland League Two","Peterhead","Spartans",2,1,"H",17,5,7,1,10,19,7,2,1,4,0,0,0,0,0,3,22,8,29,9,5,0
"20241109BONELG",2024-11-09,"Scotland League Two","Bonnyrigg Rose","Elgin",2,0,"H",9,4,4,2,19,9,6,4,4,2,0,0,0,0,0,2,13,6,28,10,6,0
"20241109EASSTR",2024-11-09,"Scotland League Two","East Fife","Stranraer",1,2,"A",12,9,7,5,6,9,12,6,1,1,0,0,0,0,0,3,21,12,15,18,2,0
"20241109EDICLY",2024-11-09,"Scotland League Two","Edinburgh City","Clyde",1,0,"H",8,4,5,2,10,16,2,4,2,3,0,0,0,0,0,1,12,7,26,6,5,0
"20241109FORSPA",2024-11-09,"Scotland League Two","Forfar","Spartans",0,3,"A",4,15,2,6,13,7,5,5,2,0,0,0,0,0,0,3,19,8,20,10,2,0
"20241109STIPET",2024-11-09,"Scotland League Two","Stirling","Peterhead",2,3,"A",4,12,3,6,13,12,2,8,5,6,1,0,0,0,0,5,16,9,25,10,11,1
"20241116CLYEAS",2024-11-16,"Scotland League Two","Clyde","East Fife",3,1,"H",8,14,4,4,13,10,5,6,2,1,0,0,0,0,0,4,22,8,23,11,3,0
"20241116ELGFOR",2024-11-16,"Scotland League Two","Elgin","Forfar",2,1,"H",9,8,6,3,12,18,6,5,1,6,0,0,0,0,0,3,17,9,30,11,7,0
"20241116PETEDI",2024-11-16,"Scotland League Two","Peterhead","Edinburgh City",2,3,"A",16,6,11,4,12,14,6,1,0,4,0,0,0,0,0,5,22,15,26,7,4,0
"20241116SPASTI",2024-11-16,"Scotland League Two","Spartans","Stirling",3,0,"H",8,6,3,2,12,12,4,3,3,1,0,0,0,0,0,3,14,5,24,7,4,0
"20241116STRBON",2024-11-16,"Scotland League Two","Stranraer","Bonnyrigg Rose",1,2,"A",9,9,3,3,9,12,3,2,0,4,1,0,0,0,0,3,18,6,21,5,4,1
"20241130BONEAS",2024-11-30,"Scotland League Two","Bonnyrigg Rose","East Fife",1,1,"D",11,13,3,8,14,17,1,5,3,1,0,0,0,0,0,2,24,11,31,6,4,0
"20241203BONSTI",2024-12-03,"Scotland League Two","Bonnyrigg Rose","Stirling",2,1,"H",10,5,5,1,6,10,6,8,0,1,0,0,0,0,0,3,15,6,16,14,1,0
"20241207CLYPET",2024-12-07,"Scotland League Two","Clyde","Peterhead",3,2,"H",9,15,6,6,19,9,1,2,4,4,0,0,0,0,0,5,24,12,28,3,8,0
"20241207EASELG",2024-12-07,"Scotland League Two","East Fife","Elgin",2,1,"H",5,8,4,4,11,10,1,7,3,3,0,0,0,0,0,3,13,8,21,8,6,0
"20241207STIEDI",2024-12-07,"Scotland League Two","Stirling","Edinburgh City",0,3,"A",8,11,2,6,12,8,6,6,5,0,0,0,1,0,1,3,19,8,20,12,5,0
"20241210SPASTR",2024-12-10,"Scotland League Two","Spartans","Stranraer",1,3,"A",8,8,3,5,9,9,4,2,2,2,1,0,0,0,0,4,16,8,18,6,4,1
"20241214ELGSTI",2024-12-14,"Scotland League Two","Elgin","Stirling",2,4,"A",9,10,4,5,9,18,5,6,0,5,0,0,0,0,0,6,19,9,27,11,5,0
"20241214FORBON",2024-12-14,"Scotland League Two","Forfar","Bonnyrigg Rose",5,1,"H",13,5,7,2,11,7,13,4,1,5,0,0,0,0,0,6,18,9,18,17,6,0
"20241214PETEAS",2024-12-14,"Scotland League Two","Peterhead","East Fife",1,0,"H",10,5,7,1,18,13,5,2,3,3,0,0,0,0,0,1,15,8,31,7,6,0
"20241214SPACLY",2024-12-14,"Scotland League Two","Spartans","Clyde",3,2,"H",12,10,7,3,5,15,6,8,1,1,0,1,0,0,0,5,22,10,20,14,2,1
"20241214STREDI",2024-12-14,"Scotland League Two","Stranraer","Edinburgh City",0,0,"D",7,7,2,3,12,11,9,4,0,1,0,0,0,0,0,0,14,5,23,13,1,0
"20241217ELGCLY",2024-12-17,"Scotland League Two","Elgin","Clyde",4,2,"H",12,6,7,3,6,8,4,5,1,3,0,0,0,0,0,6,18,10,14,9,4,0
"20241217FORPET",2024-12-17,"Scotland League Two","Forfar","Peterhead",1,1,"D",7,4,1,2,17,7,7,2,3,3,0,1,0,0,0,2,11,3,24,9,6,1
"20241221CLYFOR",2024-12-21,"Scotland League Two","Clyde","Forfar",2,0,"H",5,9,3,2,6,6,3,10,4,1,0,0,0,0,0,2,14,5,12,13,5,0
"20241221EASSPA",2024-12-21,"Scotland League Two","East Fife","Spartans",5,1,"H",10,6,8,4,8,8,5,0,0,1,0,0,0,0,0,6,16,12,16,5,1,0
"20241221EDIELG",2024-12-21,"Scotland League Two","Edinburgh City","Elgin",1,0,"H",13,9,7,5,18,11,4,9,4,0,0,0,0,0,0,1,22,12,29,13,4,0
"20241221PETBON",2024-12-21,"Scotland League Two","Peterhead","Bonnyrigg Rose",2,0,"H",7,2,5,1,6,16,7,1,0,4,0,1,0,0,0,2,9,6,22,8,4,1
"20241221STISTR",2024-12-21,"Scotland League Two","Stirling","Stranraer",1,1,"D",10,16,4,4,6,6,8,9,2,2,0,0,0,0,0,2,26,8,12,17,4,0
"20241228ELGPET",2024-12-28,"Scotland League Two","Elgin","Peterhead",2,0,"H",20,12,6,2,14,9,8,5,4,2,0,1,0,0,0,2,32,8,23,13,6,1
"20241228FORSTI",2024-12-28,"Scotland League Two","Forfar","Stirling",2,2,"D",14,6,5,5,10,14,7,7,1,4,0,0,0,0,0,4,20,10,24,14,5,0
"20241228SPAEDI",2024-12-28,"Scotland League Two","Spartans","Edinburgh City",1,0,"H",17,6,4,2,20,8,6,1,3,4,1,0,0,0,0,1,23,6,28,7,7,1
"20241228STRCLY",2024-12-28,"Scotland League Two","Stranraer","Clyde",1,1,"D",13,6,4,4,7,9,7,3,1,1,0,1,0,0,0,2,19,8,16,10,2,1
